Id,Name,Type,Rate,Total,Order
1,Liam,M,20502,20502,599
2,Noah,M,19048,39550,475
3,Emma,F,17102,56652,516
4,Ava,F,14440,71092,843
5,Oliver,M,13891,84983,798
6,Sophia,F,13714,98697,235
7,William,M,13542,112239,284
8,Isabella,F,13306,125545,14
9,Elijah,M,13300,138845,249
10,Charlotte,F,13138,151983,447
11,James,M,13087,165070,62
12,Benjamin,M,12942,178012,929
13,Amelia,F,12862,190874,523
14,Mia,F,12414,203288,794
15,Lucas,M,12412,215700,820
16,Mason,M,11408,227108,968
17,Ethan,M,11241,238349,178
18,Alexander,M,11230,249579,540
19,Henry,M,10704,260283,745
20,Jacob,M,10679,270962,279
21,Michael,M,10514,281476,408
22,Daniel,M,10504,291980,283
23,Logan,M,10490,302470,391
24,Harper,F,10442,312912,522
25,Evelyn,F,10392,323304,28
26,Jackson,M,10102,333406,793
27,Sebastian,M,9828,343234,435
28,Jack,M,9349,352583,833
29,Aiden,M,9326,361909,969
30,Owen,M,9302,371211,628
31,Samuel,M,9237,380448,348
32,Matthew,M,9199,389647,784
33,Abigail,F,9106,398753,74
34,Joseph,M,9058,407811,693
35,Levi,M,8973,416784,897
36,Mateo,M,8962,425746,397
37,David,M,8896,434642,937
38,John,M,8779,443421,896
39,Wyatt,M,8772,452193,117
40,Carter,M,8631,460824,515
41,Julian,M,8401,469225,321
42,Luke,M,8375,477600,800
43,Grayson,M,8237,485837,287
44,Emily,F,8213,494050,810
45,Isaac,M,8148,502198,210
46,Ella,F,8079,510277,687
47,Jayden,M,7903,518180,836
48,Elizabeth,F,7844,526024,537
49,Theodore,M,7839,533863,830
50,Camila,F,7809,541672,670
51,Luna,F,7755,549427,67
52,Gabriel,M,7678,557105,625
53,Anthony,M,7669,564774,641
54,Dylan,M,7514,572288,638
55,Leo,M,7454,579742,792
56,Lincoln,M,7432,587174,193
57,Sofia,F,7355,594529,185
58,Avery,F,7311,601840,247
59,Mila,F,7309,609149,828
60,Jaxon,M,7221,616370,758
61,Aria,F,7072,623442,683
62,Scarlett,F,7044,630486,993
63,Asher,M,6984,637470,951
64,Christopher,M,6960,644430,841
65,Josiah,M,6767,651197,168
66,Andrew,M,6757,657954,360
67,Penelope,F,6697,664651,630
68,Thomas,M,6612,671263,70
69,Joshua,M,6574,677837,198
70,Ezra,M,6489,684326,122
71,Layla,F,6478,690804,899
72,Hudson,M,6462,697266,403
73,Chloe,F,6361,703627,107
74,Charles,M,6348,709975,41
75,Caleb,M,6345,716320,17
76,Victoria,F,6344,722664,75
77,Madison,F,6269,728933,624
78,Eleanor,F,6164,735097,813
79,Isaiah,M,6150,741247,657
80,Ryan,M,6087,747334,795
81,Grace,F,6062,753396,837
82,Nathan,M,6049,759445,262
83,Nora,F,5899,765344,317
84,Adrian,M,5755,771099,963
85,Christian,M,5739,776838,677
86,Maverick,M,5729,782567,533
87,Colton,M,5710,788277,724
88,Elias,M,5690,793967,622
89,Riley,F,5676,799643,237
90,Zoey,F,5650,805293,201
91,Hannah,F,5586,810879,777
92,Aaron,M,5509,816388,643
93,Eli,M,5483,821871,999
94,Landon,M,5471,827342,233
95,Hazel,F,5431,832773,30
96,Lily,F,5419,838192,831
97,Jonathan,M,5418,843610,460
98,Ellie,F,5404,849014,485
99,Violet,F,5386,854400,104
100,Nolan,M,5384,859784,759
101,Hunter,M,5353,865137,610
102,Cameron,M,5226,870363,658
103,Connor,M,5140,875503,387
104,Lillian,F,5092,880595,465
105,Zoe,F,5034,885629,910
106,Santiago,M,5027,890656,732
107,Jeremiah,M,5026,895682,852
108,Stella,F,4965,900647,76
109,Aurora,F,4952,905599,466
110,Ezekiel,M,4890,910489,136
111,Angel,M,4883,915372,926
112,Roman,M,4877,920249,359
113,Easton,M,4862,925111,612
114,Miles,M,4840,929951,627
115,Robert,M,4813,934764,583
116,Natalie,F,4782,939546,720
117,Emilia,F,4751,944297,156
118,Everly,F,4751,949048,666
119,Leah,F,4739,953787,571
120,Jameson,M,4649,958436,225
121,Nicholas,M,4601,963037,216
122,Aubrey,F,4570,967607,388
123,Willow,F,4566,972173,494
124,Greyson,M,4553,976726,997
125,Cooper,M,4529,981255,311
126,Ian,M,4525,985780,103
127,Carson,M,4495,990275,878
128,Axel,M,4479,994754,71
129,Addison,F,4473,999227,112
130,Jaxson,M,4472,1003699,140
131,Lucy,F,4444,1008143,560
132,Audrey,F,4430,1012573,809
133,Dominic,M,4410,1016983,351
134,Leonardo,M,4408,1021391,496
135,Luca,M,4401,1025792,315
136,Austin,M,4369,1030161,753
137,Bella,F,4354,1034515,288
138,Jordan,M,4306,1038821,101
139,Nova,F,4294,1043115,77
140,Brooklyn,F,4270,1047385,556
141,Paisley,F,4242,1051627,281
142,Adam,M,4168,1055795,369
143,Xavier,M,4162,1059957,695
144,Savannah,F,4148,1064105,805
145,Claire,F,4111,1068216,176
146,Jose,M,4108,1072324,660
147,Jace,M,4067,1076391,444
148,Everett,M,4058,1080449,626
149,Skylar,F,4022,1084471,710
150,Isla,F,4021,1088492,357
151,Genesis,F,4009,1092501,867
152,Declan,M,3951,1096452,160
153,Evan,M,3942,1100394,189
154,Naomi,F,3929,1104323,936
155,Elena,F,3920,1108243,779
156,Caroline,F,3900,1112143,973
157,Kayden,M,3887,1116030,953
158,Parker,M,3878,1119908,415
159,Eliana,F,3868,1123776,913
160,Anna,F,3807,1127583,436
161,Maya,F,3782,1131365,789
162,Valentina,F,3782,1135147,876
163,Wesley,M,3731,1138878,528
164,Kai,M,3718,1142596,845
165,Ruby,F,3707,1146303,860
166,Kennedy,F,3670,1149973,994
167,Ivy,F,3664,1153637,616
168,Brayden,M,3656,1157293,948
169,Ariana,F,3652,1160945,173
170,Aaliyah,F,3636,1164581,512
171,Bryson,M,3606,1168187,39
172,Cora,F,3567,1171754,917
173,Weston,M,3563,1175317,783
174,Madelyn,F,3557,1178874,24
175,Jason,M,3555,1182429,706
176,Emmett,M,3541,1185970,723
177,Sawyer,M,3535,1189505,614
178,Silas,M,3531,1193036,373
179,Alice,F,3527,1196563,445
180,Bennett,M,3504,1200067,187
181,Brooks,M,3493,1203560,655
182,Kinsley,F,3493,1207053,548
183,Hailey,F,3469,1210522,883
184,Gabriella,F,3461,1213983,484
185,Micah,M,3461,1217444,553
186,Damian,M,3437,1220881,921
187,Harrison,M,3437,1224318,829
188,Waylon,M,3429,1227747,230
189,Allison,F,3424,1231171,943
190,Gianna,F,3408,1234579,774
191,Serenity,F,3405,1237984,172
192,Samantha,F,3351,1241335,491
193,Ayden,M,3345,1244680,426
194,Vincent,M,3336,1248016,440
195,Ryder,M,3295,1251311,668
196,Sarah,F,3287,1254598,454
197,Autumn,F,3261,1257859,355
198,Kingston,M,3246,1261105,469
199,Rowan,M,3204,1264309,394
200,Quinn,F,3191,1267500,900
201,George,M,3175,1270675,898
202,Luis,M,3174,1273849,468
203,Eva,F,3165,1277014,347
204,Piper,F,3164,1280178,404
205,Sophie,F,3159,1283337,671
206,Chase,M,3152,1286489,323
207,Sadie,F,3145,1289634,868
208,Delilah,F,3133,1292767,659
209,Josephine,F,3087,1295854,368
210,Nevaeh,F,3080,1298934,56
211,Cole,M,3077,1302011,346
212,Nathaniel,M,3072,1305083,217
213,Zachary,M,3064,1308147,995
214,Adeline,F,3058,1311205,128
215,Arya,F,3043,1314248,51
216,Ashton,M,3027,1317275,682
217,Braxton,M,3003,1320278,390
218,Gavin,M,3002,1323280,787
219,Emery,F,2997,1326277,273
220,Tyler,M,2995,1329272,815
221,Lydia,F,2985,1332257,467
222,Diego,M,2973,1335230,349
223,Bentley,M,2951,1338181,804
224,Amir,M,2948,1341129,806
225,Clara,F,2929,1344058,801
226,Beau,M,2912,1346970,36
227,Vivian,F,2911,1349881,532
228,Gael,M,2891,1352772,200
229,Madeline,F,2849,1355621,420
230,Peyton,F,2848,1358469,676
231,Carlos,M,2832,1361301,555
232,Ryker,M,2800,1364101,629
233,Julia,F,2775,1366876,923
234,Jasper,M,2774,1369650,766
235,Rylee,F,2766,1372416,462
236,Brielle,F,2755,1375171,455
237,Reagan,F,2744,1377915,709
238,Max,M,2735,1380650,334
239,Natalia,F,2721,1383371,135
240,Jade,F,2703,1386074,295
241,Athena,F,2702,1388776,344
242,Maria,F,2700,1391476,781
243,Juan,M,2691,1394167,520
244,Leilani,F,2685,1396852,97
245,Ivan,M,2680,1399532,457
246,Brandon,M,2671,1402203,974
247,Jonah,M,2666,1404869,978
248,Giovanni,M,2646,1407515,838
249,Kaiden,M,2635,1410150,501
250,Myles,M,2634,1412784,839
251,Calvin,M,2630,1415414,970
252,Lorenzo,M,2630,1418044,825
253,Maxwell,M,2617,1420661,847
254,Jayce,M,2611,1423272,13
255,Kevin,M,2610,1425882,754
256,Everleigh,F,2607,1428489,545
257,Liliana,F,2583,1431072,546
258,Melanie,F,2582,1433654,908
259,Mackenzie,F,2571,1436225,550
260,Hadley,F,2562,1438787,246
261,Legend,M,2556,1441343,385
262,Raelynn,F,2556,1443899,711
263,Tristan,M,2554,1446453,517
264,Jesus,M,2530,1448983,222
265,Kaylee,F,2528,1451511,713
266,Jude,M,2527,1454038,593
267,Zion,M,2524,1456562,853
268,Justin,M,2516,1459078,919
269,Rose,F,2507,1461585,634
270,Arianna,F,2495,1464080,141
271,Isabelle,F,2489,1466569,508
272,Maddox,M,2463,1469032,981
273,Abel,M,2453,1471485,927
274,King,M,2450,1473935,692
275,Melody,F,2444,1476379,85
276,Camden,M,2442,1478821,513
277,Eliza,F,2436,1481257,248
278,Elliott,M,2435,1483692,374
279,Lyla,F,2435,1486127,119
280,Katherine,F,2431,1488558,509
281,Malachi,M,2419,1490977,564
282,Milo,M,2416,1493393,782
283,Emmanuel,M,2410,1495803,775
284,Karter,M,2407,1498210,410
285,Rhett,M,2378,1500588,324
286,Alex,M,2376,1502964,585
287,August,M,2366,1505330,990
288,River,M,2349,1507679,654
289,Aubree,F,2326,1510005,738
290,Xander,M,2323,1512328,907
291,Adalynn,F,2318,1514646,690
292,Antonio,M,2279,1516925,471
293,Kylie,F,2244,1519169,459
294,Faith,F,2243,1521412,958
295,Brody,M,2234,1523646,680
296,Finn,M,2233,1525879,325
297,Elliot,M,2228,1528107,138
298,Dean,M,2211,1530318,674
299,Mary,F,2209,1532527,202
300,Emiliano,M,2200,1534727,196
301,Margaret,F,2199,1536926,163
302,Eric,M,2187,1539113,595
303,Ximena,F,2180,1541293,727
304,Iris,F,2179,1543472,697
305,Miguel,M,2176,1545648,797
306,Arthur,M,2173,1547821,497
307,Matteo,M,2148,1549969,328
308,Graham,M,2140,1552109,318
309,Alan,M,2136,1554245,158
310,Nicolas,M,2134,1556379,880
311,Blake,M,2132,1558511,240
312,Thiago,M,2131,1560642,707
313,Alexandra,F,2122,1562764,915
314,Adriel,M,2119,1564883,879
315,Jasmine,F,2092,1566975,480
316,Victor,M,2088,1569063,871
317,Joel,M,2079,1571142,743
318,Timothy,M,2069,1573211,64
319,Charlie,F,2067,1575278,935
320,Hayden,M,2053,1577331,761
321,Amaya,F,2045,1579376,211
322,Taylor,F,2042,1581418,37
323,Judah,M,2041,1583459,578
324,Abraham,M,2039,1585498,821
325,Isabel,F,2038,1587536,505
326,Edward,M,2037,1589573,602
327,Messiah,M,2021,1591594,731
328,Ashley,F,2019,1593613,918
329,Khloe,F,2015,1595628,796
330,Zayden,M,2009,1597637,715
331,Ryleigh,F,2005,1599642,377
332,Theo,M,2002,1601644,299
333,Tucker,M,2000,1603644,771
334,Alexa,F,1995,1605639,605
335,Amara,F,1982,1607621,376
336,Valeria,F,1976,1609597,223
337,Andrea,F,1975,1611572,34
338,Grant,M,1975,1613547,308
339,Richard,M,1969,1615516,392
340,Norah,F,1965,1617481,619
341,Alejandro,M,1963,1619444,425
342,Steven,M,1962,1621406,69
343,Jesse,M,1947,1623353,26
344,Dawson,M,1945,1625298,894
345,Eden,F,1943,1627241,113
346,Elliana,F,1943,1629184,678
347,Bryce,M,1936,1631120,109
348,Brianna,F,1918,1633038,607
349,Emersyn,F,1909,1634947,413
350,Valerie,F,1888,1636835,194
351,Anastasia,F,1886,1638721,618
352,Eloise,F,1883,1640604,250
353,Oscar,M,1882,1642486,650
354,Patrick,M,1870,1644356,19
355,Archer,M,1867,1646223,381
356,Barrett,M,1859,1648082,25
357,Emerson,F,1853,1649935,587
358,Leon,M,1853,1651788,802
359,Cecilia,F,1848,1653636,298
360,Remi,F,1848,1655484,4
361,Josie,F,1846,1657330,134
362,Colt,M,1826,1659156,322
363,Alina,F,1824,1660980,204
364,Reese,F,1811,1662791,110
365,Bailey,F,1810,1664601,389
366,Lucia,F,1804,1666405,716
367,Peter,M,1799,1668204,87
368,Adalyn,F,1793,1669997,461
369,Kaleb,M,1777,1671774,886
370,Lukas,M,1777,1673551,983
371,Beckett,M,1764,1675315,45
372,Jeremy,M,1754,1677069,635
373,Molly,F,1744,1678813,863
374,Ayla,F,1734,1680547,721
375,Preston,M,1734,1682281,646
376,Sara,F,1731,1684012,15
377,Daisy,F,1726,1685738,256
378,London,F,1716,1687454,129
379,Jordyn,F,1714,1689168,218
380,Enzo,M,1710,1690878,186
381,Esther,F,1708,1692586,474
382,Luka,M,1700,1694286,384
383,Genevieve,F,1699,1695985,282
384,Andres,M,1698,1697683,870
385,Marcus,M,1694,1699377,472
386,Harmony,F,1693,1701070,807
387,Annabelle,F,1688,1702758,478
388,Alyssa,F,1682,1704440,580
389,Felix,M,1680,1706120,245
390,Mark,M,1678,1707798,632
391,Ariel,F,1674,1709472,487
392,Ace,M,1666,1711138,824
393,Aliyah,F,1666,1712804,190
394,Brantley,M,1658,1714462,118
395,Londyn,F,1655,1716117,148
396,Atlas,M,1649,1717766,728
397,Juliana,F,1645,1719411,742
398,Remington,M,1645,1721056,739
399,Morgan,F,1642,1722698,511
400,Maximus,M,1637,1724335,159
401,Matias,M,1634,1725969,669
402,Summer,F,1630,1727599,47
403,Juliette,F,1627,1729226,121
404,Trinity,F,1627,1730853,864
405,Walker,M,1627,1732480,764
406,Callie,F,1622,1734102,652
407,Kyrie,M,1616,1735718,326
408,Sienna,F,1614,1737332,596
409,Griffin,M,1612,1738944,331
410,Kenneth,M,1611,1740555,244
411,Blakely,F,1607,1742162,645
412,Israel,M,1604,1743766,940
413,Javier,M,1601,1745367,529
414,Kyler,M,1599,1746966,717
415,Alaia,F,1597,1748563,681
416,Kayla,F,1597,1750160,492
417,Jax,M,1591,1751751,356
418,Teagan,F,1589,1753340,510
419,Amari,M,1584,1754924,446
420,Zane,M,1576,1756500,490
421,Alaina,F,1573,1758073,139
422,Brynlee,F,1570,1759643,662
423,Emilio,M,1570,1761213,584
424,Finley,F,1563,1762776,912
425,Catalina,F,1556,1764332,499
426,Knox,M,1552,1765884,463
427,Sloane,F,1543,1767427,258
428,Adonis,M,1537,1768964,108
429,Aidan,M,1535,1770499,856
430,Rachel,F,1529,1772028,267
431,Lilly,F,1528,1773556,335
432,Ember,F,1527,1775083,855
433,Kimberly,F,1527,1776610,132
434,Juniper,F,1526,1778136,579
435,Sydney,F,1525,1779661,842
436,Arabella,F,1522,1781183,38
437,Kaden,M,1522,1782705,33
438,Gemma,F,1519,1784224,786
439,Jocelyn,F,1515,1785739,427
440,Freya,F,1509,1787248,382
441,June,F,1505,1788753,57
442,Lauren,F,1505,1790258,40
443,Paul,M,1495,1791753,354
444,Omar,M,1479,1793232,637
445,Amy,F,1471,1794703,524
446,Presley,F,1470,1796173,336
447,Georgia,F,1467,1797640,274
448,Journee,F,1467,1799107,255
449,Brian,M,1465,1800572,942
450,Elise,F,1463,1802035,644
451,Louis,M,1463,1803498,539
452,Rosalie,F,1460,1804958,393
453,Ada,F,1459,1806417,961
454,Caden,M,1458,1807875,882
455,Maximiliano,M,1451,1809326,960
456,Holden,M,1450,1810776,407
457,Laila,F,1449,1812225,206
458,Paxton,M,1437,1813662,535
459,Nash,M,1434,1815096,114
460,Bradley,M,1431,1816527,617
461,Brooke,F,1431,1817958,572
462,Diana,F,1429,1819387,740
463,Olive,F,1423,1820810,925
464,Bryan,M,1418,1822228,5
465,Payton,F,1417,1823645,531
466,Ariella,F,1415,1825060,164
467,Daniela,F,1404,1826464,911
468,Simon,M,1404,1827868,872
469,Phoenix,M,1399,1829267,405
470,Lane,M,1398,1830665,23
471,Raegan,F,1398,1832063,976
472,Josue,M,1397,1833460,183
473,Alayna,F,1388,1834848,755
474,Gracie,F,1388,1836236,93
475,Mya,F,1388,1837624,144
476,Colin,M,1386,1839010,224
477,Noelle,F,1383,1840393,964
478,Ana,F,1381,1841774,96
479,Rafael,M,1381,1843155,712
480,Leila,F,1379,1844534,383
481,Kyle,M,1374,1845908,778
482,Paige,F,1364,1847272,558
483,Lila,F,1363,1848635,306
484,Jorge,M,1357,1849992,458
485,Beckham,M,1356,1851348,1
486,Cayden,M,1356,1852704,50
487,Nicole,F,1355,1854059,770
488,Jaden,M,1349,1855408,757
489,Hope,F,1340,1856748,816
490,Ruth,F,1335,1858083,817
491,Ronan,M,1334,1859417,63
492,Alana,F,1332,1860749,424
493,Selena,F,1325,1862074,887
494,Marley,F,1321,1863395,423
495,Kamila,F,1319,1864714,434
496,Alexis,F,1318,1866032,609
497,Karson,M,1317,1867349,694
498,Mckenzie,F,1317,1868666,552
499,Zara,F,1316,1869982,3
500,Arlo,M,1310,1871292,105
501,Millie,F,1307,1872599,889
502,Magnolia,F,1306,1873905,449
503,Tobias,M,1306,1875211,428
504,Kali,F,1305,1876516,343
505,Kehlani,F,1305,1877821,290
506,Brady,M,1300,1879121,264
507,Catherine,F,1299,1880420,443
508,Clayton,M,1297,1881717,701
509,Maeve,F,1292,1883009,514
510,Francisco,M,1290,1884299,890
511,Adelyn,F,1289,1885588,337
512,Elsie,F,1283,1886871,120
513,Lola,F,1283,1888154,314
514,Jayla,F,1281,1889435,212
515,Zander,M,1281,1890716,372
516,Erick,M,1279,1891995,502
517,Adriana,F,1277,1893272,603
518,Journey,F,1277,1894549,869
519,Vera,F,1276,1895825,232
520,Aspen,F,1275,1897100,748
521,Walter,M,1275,1898375,736
522,Joanna,F,1271,1899646,957
523,Daxton,M,1269,1900915,686
524,Alivia,F,1268,1902183,81
525,Angela,F,1266,1903449,395
526,Dakota,F,1264,1904713,61
527,Camille,F,1263,1905976,922
528,Nyla,F,1263,1907239,862
529,Tessa,F,1262,1908501,243
530,Brooklynn,F,1256,1909757,170
531,Malia,F,1256,1911013,304
532,Cash,M,1253,1912266,307
533,Makayla,F,1248,1913514,998
534,Rebecca,F,1246,1914760,54
535,Fiona,F,1245,1916005,631
536,Mariana,F,1244,1917249,788
537,Martin,M,1244,1918493,116
538,Lena,F,1236,1919729,350
539,Damien,M,1233,1920962,182
540,Julianna,F,1231,1922193,7
541,Dallas,M,1222,1923415,90
542,Vanessa,F,1221,1924636,473
543,Juliet,F,1220,1925856,488
544,Camilla,F,1216,1927072,944
545,Kendall,F,1212,1928284,688
546,Harley,F,1211,1929495,526
547,Cali,F,1208,1930703,286
548,Evangeline,F,1208,1931911,933
549,Cody,M,1203,1933114,768
550,Chance,M,1197,1934311,950
551,Jensen,M,1192,1935503,438
552,Jett,M,1188,1936691,259
553,Mariah,F,1180,1937871,309
554,Jane,F,1179,1939050,541
555,Zuri,F,1179,1940229,191
556,Corbin,M,1178,1941407,205
557,Kash,M,1176,1942583,689
558,Reid,M,1176,1943759,310
559,Kameron,M,1173,1944932,613
560,Andre,M,1171,1946103,924
561,Elaina,F,1167,1947270,826
562,Gunner,M,1166,1948436,10
563,Jake,M,1166,1949602,498
564,Sage,F,1164,1950766,932
565,Amira,F,1160,1951926,544
566,Adaline,F,1159,1953085,95
567,Hayes,M,1158,1954243,98
568,Lia,F,1157,1955400,708
569,Charlee,F,1156,1956556,773
570,Delaney,F,1152,1957708,858
571,Lilah,F,1150,1958858,289
572,Miriam,F,1150,1960008,470
573,Angelina,F,1145,1961153,73
574,Mckenna,F,1144,1962297,133
575,Manuel,M,1142,1963439,9
576,Prince,M,1141,1964580,316
577,Aniyah,F,1140,1965720,971
578,Phoebe,F,1139,1966859,675
579,Michelle,F,1137,1967996,239
580,Thea,F,1137,1969133,931
581,Bodhi,M,1126,1970259,814
582,Cohen,M,1124,1971383,760
583,Maggie,F,1124,1972507,741
584,Sean,M,1120,1973627,236
585,Khalil,M,1118,1974745,161
586,Lucille,F,1118,1975863,319
587,Hendrix,M,1117,1976980,588
588,Derek,M,1108,1978088,615
589,Cristian,M,1105,1979193,691
590,Amiyah,F,1104,1980297,220
591,Cruz,M,1104,1981401,594
592,Kairo,M,1104,1982505,166
593,Annie,F,1098,1983603,620
594,Alexandria,F,1096,1984699,82
595,Dante,M,1091,1985790,179
596,Myla,F,1089,1986879,569
597,Vivienne,F,1087,1987966,684
598,Atticus,M,1086,1989052,127
599,Killian,M,1086,1990138,137
600,Stephen,M,1084,1991222,608
601,Kiara,F,1083,1992305,685
602,Orion,M,1072,1993377,547
603,Alani,F,1069,1994446,965
604,Malakai,M,1068,1995514,42
605,Ali,M,1065,1996579,203
606,Margot,F,1061,1997640,875
607,Eduardo,M,1060,1998700,78
608,Fernando,M,1060,1999760,530
609,Adelaide,F,1057,2000817,477
610,Briella,F,1054,2001871,985
611,Brynn,F,1054,2002925,48
612,Anderson,M,1052,2003977,941
613,Angelo,M,1048,2005025,696
614,Saylor,F,1048,2006073,679
615,Destiny,F,1037,2007110,291
616,Spencer,M,1031,2008141,479
617,Gideon,M,1027,2009168,418
618,Mario,M,1024,2010192,835
619,Titus,M,1024,2011216,197
620,Travis,M,1024,2012240,844
621,Evelynn,F,1023,2013263,767
622,Haven,F,1017,2014280,361
623,Rylan,M,1017,2015297,80
624,Kayson,M,1015,2016312,327
625,Izabella,F,1014,2017326,157
626,Ricardo,M,1014,2018340,967
627,Tanner,M,1013,2019353,901
628,Malcolm,M,1011,2020364,749
629,Raymond,M,1011,2021375,400
630,Kaia,F,1007,2022382,353
631,Odin,M,1007,2023389,123
632,Lilliana,F,1004,2024393,94
633,Cesar,M,1003,2025396,229
634,Lennox,M,1002,2026398,209
635,Harlow,F,1001,2027399,213
636,Alessandra,F,1000,2028399,577
637,Joaquin,M,999,2029398,260
638,Kane,M,997,2030395,895
639,Madilyn,F,997,2031392,234
640,Nina,F,995,2032387,700
641,Wade,M,993,2033380,850
642,Muhammad,M,992,2034372,208
643,Iker,M,991,2035363,992
644,Jaylen,M,991,2036354,441
645,Adelynn,F,989,2037343,165
646,Crew,M,988,2038331,2
647,Zayn,M,985,2039316,155
648,Amina,F,984,2040300,482
649,Hector,M,982,2041282,162
650,Kate,F,982,2042264,566
651,Fatima,F,979,2043243,215
652,Samara,F,978,2044221,661
653,Winter,F,977,2045198,698
654,Giselle,F,975,2046173,952
655,Ellis,M,970,2047143,702
656,Leonel,M,970,2048113,270
657,Cairo,M,969,2049082,752
658,Evie,F,968,2050050,601
659,Garrett,M,966,2051016,598
660,Arielle,F,964,2051980,294
661,Romeo,M,963,2052943,11
662,Jessica,F,962,2053905,409
663,Talia,F,962,2054867,269
664,Edwin,M,955,2055822,150
665,Leia,F,953,2056775,100
666,Gabriela,F,952,2057727,345
667,Warren,M,951,2058678,639
668,Gracelyn,F,949,2059627,439
669,Lexi,F,949,2060576,305
670,Laura,F,944,2061520,893
671,Julius,M,942,2062462,263
672,Major,M,942,2063404,873
673,Donovan,M,941,2064345,673
674,Makenzie,F,941,2065286,195
675,Melissa,F,930,2066216,640
676,Caiden,M,928,2067144,966
677,Royalty,F,926,2068070,99
678,Tyson,M,926,2068996,18
679,Nico,M,922,2069918,44
680,Sergio,M,922,2070840,604
681,Nasir,M,921,2071761,557
682,Rory,M,921,2072682,653
683,Rylie,F,921,2073603,301
684,Raelyn,F,914,2074517,399
685,Gabrielle,F,911,2075428,956
686,Devin,M,910,2076338,6
687,Paris,F,909,2077247,431
688,Jaiden,M,908,2078155,699
689,Jared,M,908,2079063,278
690,Daleyza,F,906,2079969,32
691,Joy,F,906,2080875,27
692,Maisie,F,902,2081777,417
693,Oakley,F,902,2082679,341
694,Ariyah,F,901,2083580,254
695,Kailani,F,898,2084478,984
696,Alayah,F,892,2085370,416
697,Stephanie,F,891,2086261,486
698,Kason,M,890,2087151,726
699,Amora,F,887,2088038,506
700,Willa,F,885,2088923,493
701,Gracelynn,F,884,2089807,402
702,Elle,F,883,2090690,988
703,Keira,F,882,2091572,450
704,Tatum,F,880,2092452,747
705,Malik,M,879,2093331,549
706,Jeffrey,M,876,2094207,586
707,Veronica,F,875,2095082,536
708,Milani,F,872,2095954,977
709,Ismael,M,871,2096825,207
710,Elian,M,869,2097694,982
711,Marshall,M,866,2098560,570
712,Felicity,F,865,2099425,904
713,Lawson,M,865,2100290,636
714,Paislee,F,864,2101154,582
715,Allie,F,860,2102014,313
716,Nylah,F,858,2102872,227
717,Ariah,F,857,2103729,124
718,Cassidy,F,857,2104586,962
719,Lyric,F,857,2105443,947
720,Desmond,M,856,2106299,253
721,Madeleine,F,856,2107155,920
722,Winston,M,856,2108011,769
723,Miracle,F,854,2108865,989
724,Nehemiah,M,852,2109717,303
725,Ari,M,851,2110568,352
726,Gwendolyn,F,845,2111413,292
727,Octavia,F,844,2112257,430
728,Conner,M,843,2113100,581
729,Dahlia,F,843,2113943,68
730,Heidi,F,839,2114782,296
731,Jay,M,837,2115619,60
732,Celeste,F,835,2116454,663
733,Kade,M,835,2117289,980
734,Andy,M,831,2118120,174
735,Johnny,M,831,2118951,489
736,Makenna,F,828,2119779,664
737,Jayceon,M,827,2120606,909
738,Marco,M,827,2121433,714
739,Everlee,F,826,2122259,65
740,Scarlet,F,825,2123084,866
741,Seth,M,824,2123908,333
742,Esmeralda,F,820,2124728,448
743,Maci,F,820,2125548,125
744,Ibrahim,M,819,2126367,592
745,Raiden,M,818,2127185,568
746,Collin,M,816,2128001,551
747,Lainey,F,816,2128817,188
748,Jacqueline,F,815,2129632,799
749,Kira,F,812,2130444,733
750,Lana,F,811,2131255,597
751,Edgar,M,810,2132065,180
752,Erik,M,810,2132875,442
753,Brinley,F,806,2133681,979
754,Demi,F,806,2134487,861
755,Ophelia,F,804,2135291,293
756,Troy,M,804,2136095,949
757,Clark,M,801,2136896,401
758,Jaxton,M,800,2137696,818
759,Johnathan,M,800,2138496,79
760,Gregory,M,798,2139294,340
761,Russell,M,797,2140091,456
762,Royce,M,795,2140886,83
763,Fabian,M,793,2141679,86
764,Lennon,F,793,2142472,565
765,Ezequiel,M,792,2143264,827
766,Noel,M,790,2144054,656
767,Pablo,M,787,2144841,46
768,Reign,F,787,2145628,729
769,Bristol,F,786,2146414,31
770,Cade,M,784,2147198,600
771,Sabrina,F,782,2147980,329
772,Pedro,M,781,2148761,877
773,Alaya,F,780,2149541,744
774,Jennifer,F,780,2150321,859
775,Kenzie,F,779,2151100,297
776,Luciana,F,777,2151877,432
777,Sullivan,M,776,2152653,102
778,Anaya,F,775,2153428,414
779,Trevor,M,775,2154203,930
780,Hallie,F,774,2154977,89
781,Reed,M,774,2155751,481
782,Camryn,F,771,2156522,874
783,Frank,M,768,2157290,573
784,Kinley,F,767,2158057,22
785,Daniella,F,766,2158823,589
786,Lilith,F,766,2159589,527
787,Blair,F,765,2160354,43
788,Amanda,F,763,2161117,991
789,Collins,F,763,2161880,563
790,Harvey,M,762,2162642,238
791,Maliyah,F,762,2163404,939
792,Rosemary,F,760,2164164,902
793,Cataleya,F,758,2164922,412
794,Kaylani,F,758,2165680,938
795,Princeton,M,758,2166438,265
796,Zayne,M,756,2167194,271
797,Gia,F,755,2167949,53
798,Alison,F,753,2168702,591
799,Leighton,F,752,2169454,464
800,Nadia,F,752,2170206,705
801,Sutton,F,750,2170956,812
802,Carolina,F,749,2171705,945
803,Matthias,M,749,2172454,406
804,Skye,F,749,2173203,226
805,Alicia,F,748,2173951,633
806,Regina,F,748,2174699,228
807,Viviana,F,748,2175447,177
808,Yaretzi,F,748,2176195,730
809,Conor,M,747,2176942,959
810,Sterling,M,746,2177688,986
811,Dax,M,745,2178433,865
812,Grady,M,745,2179178,130
813,Cyrus,M,744,2179922,972
814,Heaven,F,743,2180665,453
815,Serena,F,743,2181408,52
816,Gage,M,742,2182150,849
817,Raven,F,740,2182890,975
818,Emely,F,739,2183629,330
819,Carmen,F,738,2184367,277
820,Leland,M,738,2185105,672
821,Wren,F,738,2185843,411
822,Helen,F,737,2186580,276
823,Solomon,M,737,2187317,320
824,Emanuel,M,736,2188053,58
825,Niko,M,736,2188789,153
826,Charleigh,F,735,2189524,854
827,Ruben,M,735,2190259,452
828,Kasen,M,734,2190993,419
829,Mathias,M,734,2191727,811
830,Danielle,F,733,2192460,500
831,Daphne,F,733,2193193,503
832,Esme,F,733,2193926,312
833,Kashton,M,733,2194659,846
834,Nayeli,F,733,2195392,888
835,Franklin,M,732,2196124,649
836,Maddison,F,732,2196856,848
837,Remy,M,732,2197588,184
838,Sarai,F,725,2198313,241
839,Shane,M,725,2199038,145
840,Kendrick,M,716,2199754,834
841,Frances,F,715,2200469,574
842,Shawn,M,714,2201183,891
843,Otto,M,713,2201896,72
844,Armani,M,712,2202608,892
845,Keegan,M,711,2203319,147
846,Elisa,F,710,2204029,803
847,Finnegan,M,709,2204738,987
848,Mabel,F,709,2205447,519
849,Skyler,F,709,2206156,576
850,Memphis,M,707,2206863,648
851,Bowen,M,706,2207569,651
852,Dominick,M,705,2208274,756
853,Kolton,M,704,2208978,534
854,Jenna,F,703,2209681,175
855,Emelia,F,699,2210380,375
856,Jamison,M,698,2211078,590
857,Kaitlyn,F,696,2211774,719
858,Miranda,F,696,2212470,561
859,Allen,M,695,2213165,131
860,Marlee,F,694,2213859,364
861,Philip,M,693,2214552,851
862,Tate,M,693,2215245,169
863,Matilda,F,690,2215935,954
864,Selah,F,690,2216625,832
865,Jolene,F,688,2217313,332
866,Wynter,F,688,2218001,199
867,Hattie,F,687,2218688,746
868,Jase,M,686,2219374,370
869,Rhys,M,686,2220060,437
870,Kyson,M,685,2220745,379
871,Adan,M,684,2221429,762
872,Bianca,F,682,2222111,66
873,Esteban,M,682,2222793,780
874,Haley,F,681,2223474,955
875,Dalton,M,679,2224153,735
876,Gianni,M,679,2224832,737
877,Lorelei,F,679,2225511,451
878,Mira,F,679,2226190,366
879,Braelynn,F,677,2226867,611
880,Annalise,F,676,2227543,257
881,Madelynn,F,676,2228219,142
882,Katie,F,674,2228893,703
883,Palmer,F,672,2229565,790
884,Aylin,F,671,2230236,750
885,Kyla,F,669,2230905,791
886,Avianna,F,668,2231573,146
887,Callum,M,668,2232241,554
888,Liana,F,665,2232906,143
889,Shiloh,F,665,2233571,192
890,Kalani,F,664,2234235,905
891,Jada,F,663,2234898,623
892,Kelsey,F,661,2235559,154
893,Elianna,F,659,2236218,562
894,Jimena,F,659,2236877,538
895,Milan,M,659,2237536,819
896,Moises,M,659,2238195,722
897,Kora,F,658,2238853,483
898,Jonas,M,655,2239508,251
899,Kamryn,F,655,2240163,422
900,Uriel,M,655,2240818,152
901,Ainsley,F,654,2241472,266
902,Colson,M,654,2242126,49
903,Marcos,M,654,2242780,29
904,Averie,F,652,2243432,8
905,Kensley,F,652,2244084,808
906,Helena,F,651,2244735,365
907,Zaiden,M,651,2245386,231
908,Hank,M,649,2246035,106
909,Holly,F,649,2246684,171
910,Emory,F,648,2247332,285
911,Macie,F,648,2247980,903
912,Amber,F,647,2248627,92
913,Damon,M,647,2249274,126
914,Zariah,F,646,2249920,928
915,Erin,F,644,2250564,704
916,Eve,F,644,2251208,429
917,Hugo,M,644,2251852,996
918,Kathryn,F,644,2252496,647
919,Ronin,M,644,2253140,751
920,Royal,M,644,2253784,371
921,Renata,F,643,2254427,521
922,Kayleigh,F,641,2255068,149
923,Emmy,F,639,2255707,606
924,Celine,F,638,2256345,358
925,Francesca,F,636,2256981,934
926,Kamden,M,636,2257617,914
927,Fernanda,F,634,2258251,84
928,April,F,633,2258884,476
929,Dexter,M,633,2259517,575
930,Luciano,M,632,2260149,386
931,Alonzo,M,631,2260780,776
932,Augustus,M,631,2261411,543
933,Kamari,M,631,2262042,363
934,Roberto,M,629,2262671,59
935,Shelby,F,629,2263300,35
936,Poppy,F,628,2263928,785
937,Colette,F,626,2264554,822
938,Meadow,F,626,2265180,88
939,Nia,F,626,2265806,380
940,Sierra,F,626,2266432,302
941,Cheyenne,F,624,2267056,151
942,Edith,F,623,2267679,20
943,Oaklynn,F,620,2268299,219
944,Kennedi,F,619,2268918,857
945,Abby,F,618,2269536,567
946,Baker,M,618,2270154,433
947,Danna,F,618,2270772,55
948,Jazlyn,F,618,2271390,667
949,Alessia,F,617,2272007,396
950,Mikayla,F,617,2272624,378
951,Alondra,F,616,2273240,772
952,Bruce,M,616,2273856,339
953,Kian,M,616,2274472,763
954,Addilyn,F,614,2275086,16
955,Albert,M,614,2275700,884
956,Frederick,M,613,2276313,504
957,Leona,F,612,2276925,275
958,Mckinley,F,612,2277537,12
959,Mohamed,M,611,2278148,367
960,Abram,M,608,2278756,840
961,Maren,F,608,2279364,823
962,Omari,M,608,2279972,718
963,Porter,M,608,2280580,167
964,Enrique,M,605,2281185,881
965,Sylvia,F,605,2281790,21
966,Alijah,M,603,2282393,621
967,Francis,M,603,2282996,559
968,Leonidas,M,603,2283599,261
969,Zachariah,M,603,2284202,221
970,Alejandra,F,598,2284800,734
971,Ariya,F,597,2285397,111
972,Astrid,F,597,2285994,525
973,Adrianna,F,596,2286590,542
974,Charli,F,593,2287183,362
975,Landen,M,593,2287776,300
976,Imani,F,592,2288368,495
977,Maryam,F,592,2288960,338
978,Christina,F,590,2289550,181
979,Wilder,M,590,2290140,272
980,Apollo,M,589,2290729,946
981,Santino,M,588,2291317,398
982,Pierce,M,587,2291904,906
983,Stevie,F,585,2292489,91
984,Maia,F,584,2293073,268
985,Adelina,F,582,2293655,642
986,Forrest,M,582,2294237,214
987,Dream,F,581,2294818,665
988,Corey,M,579,2295397,421
989,Derrick,M,578,2295975,518
990,Isaias,M,578,2296553,252
991,Kaison,M,575,2297128,765
992,Kieran,M,575,2297703,280
993,Aisha,F,574,2298277,885
994,Alanna,F,574,2298851,916
995,Itzel,F,574,2299425,342
996,Arjun,M,573,2299998,242
997,Gunnar,M,572,2300570,507
998,Rocco,M,572,2301142,725
999,Azalea,F,571,2301713,115
1000,Katelyn,F,571,2302284,1537
1001,Kylee,F,570,2302854,1032
1002,Leslie,F,570,2303424,1121
1003,Emmitt,M,569,2303993,1538
1004,Madilynn,F,569,2304562,1289
1005,Myra,F,568,2305130,1959
1006,Abdiel,M,567,2305697,1867
1007,Virginia,F,567,2306264,1186
1008,Braylen,M,566,2306830,1603
1009,Hanna,F,565,2307395,1437
1010,Maximilian,M,565,2307960,1018
1011,Aleah,F,564,2308524,1469
1012,Jaliyah,F,564,2309088,1390
1013,Antonella,F,563,2309651,1161
1014,Aviana,F,561,2310212,1703
1015,Phillip,M,561,2310773,1129
1016,Benson,M,560,2311333,1039
1017,Cannon,M,557,2311890,1016
1018,Deacon,M,557,2312447,1299
1019,Dorian,M,557,2313004,1213
1020,Chelsea,F,556,2313560,1776
1021,Asa,M,555,2314115,1447
1022,Cecelia,F,555,2314670,1233
1023,Alia,F,554,2315224,1258
1024,Mae,F,554,2315778,1287
1025,Cadence,F,553,2316331,1041
1026,Moses,M,553,2316884,1684
1027,Emberly,F,552,2317436,1796
1028,Ayaan,M,551,2317987,1631
1029,Jayson,M,551,2318538,1868
1030,Raul,M,550,2319088,1961
1031,Briggs,M,549,2319637,1574
1032,Armando,M,548,2320185,1495
1033,Charley,F,548,2320733,1919
1034,Janelle,F,548,2321281,1290
1035,Nikolai,M,548,2321829,1976
1036,Cassius,M,547,2322376,1407
1037,Drew,M,547,2322923,1727
1038,Mallory,F,546,2323469,1774
1039,Rodrigo,M,546,2324015,1189
1040,Kaliyah,F,545,2324560,1055
1041,Elaine,F,544,2325104,1001
1042,Gloria,F,544,2325648,1215
1043,Jayleen,F,543,2326191,1896
1044,Lorelai,F,543,2326734,1065
1045,Malaysia,F,543,2327277,1475
1046,Bethany,F,542,2327819,1274
1047,Briana,F,542,2328361,1270
1048,Raphael,M,542,2328903,1103
1049,Beatrice,F,541,2329444,1314
1050,Danny,M,541,2329985,1286
1051,Dorothy,F,540,2330525,1904
1052,Rosie,F,540,2331065,1730
1053,Conrad,M,539,2331604,1573
1054,Moshe,M,539,2332143,1020
1055,Zyaire,M,539,2332682,1022
1056,Jemma,F,538,2333220,1465
1057,Julio,M,537,2333757,1499
1058,Casey,M,536,2334293,1008
1059,Noa,F,536,2334829,1750
1060,Ronald,M,536,2335365,1965
1061,Scott,M,536,2335901,1003
1062,Callan,M,535,2336436,1370
1063,Carly,F,535,2336971,1940
1064,Roland,M,535,2337506,1973
1065,Saul,M,535,2338041,1212
1066,Jalen,M,533,2338574,1801
1067,Brycen,M,531,2339105,1591
1068,Mariam,F,531,2339636,1429
1069,Anne,F,530,2340166,1754
1070,Karina,F,529,2340695,1772
1071,Ryland,M,529,2341224,1529
1072,Emmalyn,F,528,2341752,1307
1073,Ivory,F,528,2342280,1594
1074,Ivanna,F,527,2342807,1130
1075,Jamie,F,527,2343334,1645
1076,Lawrence,M,527,2343861,1040
1077,Davis,M,526,2344387,1106
1078,Kara,F,526,2344913,1905
1079,Aitana,F,525,2345438,1087
1080,Rowen,M,525,2345963,1671
1081,Jayda,F,524,2346487,1426
1082,Justice,F,524,2347011,1677
1083,Meredith,F,524,2347535,1540
1084,Zain,M,524,2348059,1899
1085,Briar,F,523,2348582,1804
1086,Skyla,F,523,2349105,1399
1087,Khaleesi,F,522,2349627,1329
1088,Dayana,F,520,2350147,1823
1089,Julieta,F,520,2350667,1167
1090,Ermias,M,519,2351186,1281
1091,Katalina,F,519,2351705,1623
1092,Jaime,M,518,2352223,1938
1093,Kendra,F,518,2352741,1680
1094,Oaklyn,F,518,2353259,1831
1095,Ashlyn,F,516,2353775,1025
1096,Duke,M,516,2354291,1122
1097,Stetson,M,515,2354806,1999
1098,Alec,M,514,2355320,1939
1099,Yusuf,M,514,2355834,1825
1100,Case,M,513,2356347,1094
1101,Jazmin,F,513,2356860,1012
1102,Trenton,M,512,2357372,1865
1103,Kyra,F,511,2357883,1555
1104,Callen,M,509,2358392,1766
1105,Angelica,F,508,2358900,1312
1106,Jasiah,M,508,2359408,1364
1107,Zahra,F,508,2359916,1414
1108,Johanna,F,507,2360423,1225
1109,Soren,M,507,2360930,1859
1110,Dennis,M,506,2361436,1449
1111,Donald,M,506,2361942,1320
1112,Keith,M,506,2362448,1279
1113,Macy,F,506,2362954,1197
1114,Izaiah,M,505,2363459,1408
1115,Monroe,F,505,2363964,1534
1116,Kimber,F,503,2364467,1915
1117,Henley,F,501,2364968,1373
1118,Lewis,M,501,2365469,1326
1119,Karsyn,F,500,2365969,1070
1120,Kylan,M,500,2366469,1482
1121,Kobe,M,499,2366968,1273
1122,Lyanna,F,499,2367467,1960
1123,Lilian,F,498,2367965,1827
1124,Makai,M,498,2368463,1297
1125,Amalia,F,497,2368960,1587
1126,Nola,F,497,2369457,1038
1127,Rayan,M,497,2369954,1539
1128,Dior,F,496,2370450,1651
1129,Ford,M,496,2370946,1075
1130,Aleena,F,495,2371441,1650
1131,Zaire,M,494,2371935,1280
1132,Landyn,M,493,2372428,1228
1133,Megan,F,493,2372921,1372
1134,Roy,M,493,2373414,1428
1135,Michaela,F,492,2373906,1519
1136,Amirah,F,490,2374396,1706
1137,Cassandra,F,490,2374886,1852
1138,Melany,F,490,2375376,1131
1139,Bo,M,489,2375865,1109
1140,Chris,M,489,2376354,1793
1141,Jamari,M,489,2376843,1711
1142,Legacy,F,489,2377332,1610
1143,Reyna,F,488,2377820,1441
1144,Alma,F,487,2378307,1910
1145,Ares,M,486,2378793,1059
1146,Mohammad,M,486,2379279,1455
1147,Darius,M,485,2379764,1845
1148,Emmie,F,485,2380249,1185
1149,Melina,F,484,2380733,1808
1150,Siena,F,484,2381217,1720
1151,Drake,M,483,2381700,1332
1152,Tripp,M,483,2382183,1950
1153,Marcelo,M,482,2382665,1705
1154,Samson,M,482,2383147,1105
1155,Dustin,M,481,2383628,1775
1156,Layton,M,480,2384108,1472
1157,Priscilla,F,480,2384588,1786
1158,Gerardo,M,479,2385067,1822
1159,Johan,M,479,2385546,1563
1160,Kaysen,M,479,2386025,1067
1161,Keaton,M,479,2386504,1450
1162,Ashlynn,F,478,2386982,1981
1163,Savanna,F,478,2387460,1944
1164,Sloan,F,478,2387938,1743
1165,Reece,M,477,2388415,1453
1166,Tiana,F,477,2388892,1554
1167,Aubrie,F,476,2389368,1098
1168,Coraline,F,476,2389844,1108
1169,Reina,F,476,2390320,1100
1170,Chandler,M,475,2390795,1988
1171,Lucca,M,475,2391270,1409
1172,Mack,M,474,2391744,1060
1173,Allyson,F,473,2392217,1516
1174,Baylor,M,473,2392690,1367
1175,Kannon,M,473,2393163,1966
1176,Kaydence,F,472,2393635,1120
1177,Sasha,F,472,2394107,1745
1178,Julie,F,471,2394578,1231
1179,Marvin,M,470,2395048,1941
1180,Huxley,M,469,2395517,1460
1181,Nixon,M,469,2395986,1145
1182,Alexia,F,466,2396452,1588
1183,Tony,M,466,2396918,1389
1184,Cason,M,465,2397383,1413
1185,Mauricio,M,465,2397848,1541
1186,Quentin,M,465,2398313,1113
1187,Irene,F,464,2398777,1681
1188,Edison,M,463,2399240,1191
1189,Quincy,M,463,2399703,1768
1190,Marilyn,F,462,2400165,1577
1191,Ahmed,M,461,2400626,1164
1192,Finnley,M,460,2401086,1514
1193,Greta,F,459,2401545,1381
1194,Braelyn,F,458,2402003,1956
1195,Emerie,F,457,2402460,1369
1196,Gustavo,M,457,2402917,1226
1197,Lylah,F,455,2403372,1378
1198,Nalani,F,454,2403826,1770
1199,Brock,M,453,2404279,1869
1200,Monica,F,453,2404732,1007
1201,Ahmad,M,452,2405184,1327
1202,Aileen,F,451,2405635,1713
1203,Kyree,M,451,2406086,1943
1204,Lauryn,F,451,2406537,1147
1205,Arturo,M,450,2406987,1710
1206,Anahi,F,449,2407436,1761
1207,Aurelia,F,449,2407885,1333
1208,Nikolas,M,449,2408334,1510
1209,Boston,M,448,2408782,1814
1210,Kassidy,F,448,2409230,1293
1211,Rayna,F,448,2409678,1922
1212,Sincere,M,448,2410126,1029
1213,Alessandro,M,447,2410573,1350
1214,Romina,F,447,2411020,1037
1215,Lillie,F,446,2411466,1091
1216,Marie,F,446,2411912,1507
1217,Rosa,F,446,2412358,1259
1218,Saige,F,446,2412804,1597
1219,Bonnie,F,445,2413249,1557
1220,Kelly,F,445,2413694,1163
1221,Xiomara,F,445,2414139,1648
1222,Annabella,F,444,2414583,1168
1223,Braylon,M,443,2415026,1071
1224,Colby,M,443,2415469,1112
1225,Leonard,M,442,2415911,1288
1226,Ridge,M,442,2416353,1444
1227,Avah,F,441,2416794,1442
1228,Lacey,F,441,2417235,1398
1229,Trey,M,441,2417676,1466
1230,Aden,M,440,2418116,1219
1231,Anya,F,440,2418556,1593
1232,Leandro,M,440,2418996,1856
1233,Liberty,F,440,2419436,1339
1234,Sam,M,440,2419876,1575
1235,Uriah,M,440,2420316,1608
1236,Ty,M,439,2420755,1689
1237,Karen,F,438,2421193,1264
1238,Mercy,F,437,2421630,1924
1239,Sylas,M,437,2422067,1058
1240,Axton,M,436,2422503,1698
1241,Issac,M,435,2422938,1295
1242,Zelda,F,434,2423372,1765
1243,Baylee,F,433,2423805,1250
1244,Chaya,F,433,2424238,1800
1245,Fletcher,M,433,2424671,1732
1246,Julien,M,433,2425104,1830
1247,Kenna,F,432,2425536,1068
1248,Roselyn,F,432,2425968,1184
1249,Wells,M,432,2426400,1256
1250,Alden,M,431,2426831,1881
1251,Liv,F,431,2427262,1604
1252,Mara,F,431,2427693,1082
1253,Vihaan,M,431,2428124,1647
1254,Ensley,F,430,2428554,1478
1255,Jamir,M,430,2428984,1851
1256,Malani,F,430,2429414,1422
1257,Malaya,F,430,2429844,1302
1258,Valentino,M,429,2430273,1045
1259,Hadassah,F,428,2430701,1549
1260,Lyra,F,428,2431129,1954
1261,Adley,F,427,2431556,1010
1262,Galilea,F,427,2431983,1318
1263,Jaylah,F,427,2432410,1697
1264,Shepherd,M,427,2432837,1740
1265,Keanu,M,426,2433263,1397
1266,Hezekiah,M,425,2433688,1612
1267,Karla,F,425,2434113,1272
1268,Lionel,M,425,2434538,1858
1269,Nala,F,425,2434963,1073
1270,Opal,F,424,2435387,1785
1271,Aliza,F,423,2435810,1781
1272,Kohen,M,423,2436233,1451
1273,Milena,F,423,2436656,1891
1274,Zaid,M,423,2437079,1313
1275,Ailani,F,422,2437501,1331
1276,Alberto,M,422,2437923,1635
1277,Louisa,F,422,2438345,1566
1278,Mina,F,422,2438767,1953
1279,Neil,M,422,2439189,1655
1280,Kairi,F,421,2439610,1722
1281,Clementine,F,420,2440030,1654
1282,Louise,F,420,2440450,1718
1283,Maleah,F,420,2440870,1433
1284,Denver,M,419,2441289,1582
1285,Aarav,M,418,2441707,1062
1286,Brendan,M,418,2442125,1301
1287,Dillon,M,418,2442543,1049
1288,Janiyah,F,418,2442961,1187
1289,Koda,M,418,2443379,1253
1290,Marina,F,417,2443796,1135
1291,Anika,F,416,2444212,1784
1292,Kingsley,M,416,2444628,1847
1293,Julissa,F,415,2445043,1354
1294,Sonny,M,415,2445458,1093
1295,Alfredo,M,414,2445872,1239
1296,Bailee,F,414,2446286,1298
1297,Hayley,F,414,2446700,1729
1298,Jessie,F,414,2447114,1317
1299,Laney,F,414,2447528,1292
1300,Wilson,M,414,2447942,1234
1301,Eileen,F,413,2448355,1836
1302,Faye,F,413,2448768,1819
1303,Harry,M,413,2449181,1963
1304,Jaziel,M,413,2449594,1663
1305,Kynlee,F,413,2450007,1443
1306,Tiffany,F,413,2450420,1128
1307,Lara,F,412,2450832,1316
1308,Angie,F,411,2451243,1124
1309,Salvador,M,411,2451654,1411
1310,Joelle,F,410,2452064,1708
1311,Rhea,F,409,2452473,1227
1312,Cullen,M,408,2452881,1985
1313,Hamza,M,407,2453288,1686
1314,Calliope,F,406,2453694,1739
1315,Dariel,M,406,2454100,1097
1316,Rex,M,406,2454506,1691
1317,Jazmine,F,405,2454911,1561
1318,Zeke,M,403,2455314,1792
1319,Amani,F,401,2455715,1171
1320,Haylee,F,401,2456116,1338
1321,Aliana,F,400,2456516,1456
1322,Mohammed,M,400,2456916,1276
1323,Nelson,M,400,2457316,1795
1324,Boone,M,399,2457715,1470
1325,Ricky,M,399,2458114,1763
1326,Santana,M,399,2458513,1214
1327,Cayson,M,398,2458911,1518
1328,Lance,M,398,2459309,1246
1329,Leyla,F,398,2459707,1530
1330,Raylan,M,398,2460105,1308
1331,Jolie,F,397,2460502,1620
1332,Kinslee,F,397,2460899,1445
1333,Lucian,M,397,2461296,1057
1334,Ryann,F,397,2461693,1178
1335,Simone,F,397,2462090,1820
1336,Eliel,M,396,2462486,1081
1337,Alvin,M,395,2462881,1828
1338,Treasure,F,395,2463276,1893
1339,Alora,F,394,2463670,1077
1340,Olivia,F,394,2464064,1368
1341,Rebekah,F,394,2464458,1933
1342,Mikaela,F,392,2464850,1355
1343,Jagger,M,391,2465241,1034
1344,Lina,F,391,2465632,1118
1345,Harmoni,F,390,2466022,1886
1346,Yareli,F,390,2466412,1266
1347,Giuliana,F,389,2466801,1391
1348,Lea,F,388,2467189,1930
1349,Braden,M,387,2467576,1180
1350,Harlee,F,387,2467963,1004
1351,Curtis,M,385,2468348,1787
1352,Elyse,F,385,2468733,1736
1353,Frida,F,385,2469118,1296
1354,Mathew,M,385,2469503,1980
1355,Blaire,F,384,2469887,1439
1356,Aya,F,383,2470270,1311
1357,Laurel,F,383,2470653,1568
1358,Meghan,F,383,2471036,1882
1359,Pearl,F,383,2471419,1668
1360,Zaylee,F,383,2471802,1704
1361,Alena,F,382,2472184,1083
1362,Holland,F,382,2472566,1489
1363,Jimmy,M,382,2472948,1353
1364,Kareem,M,382,2473330,1199
1365,Archie,M,381,2473711,1964
1366,Bria,F,381,2474092,1931
1367,Rayne,F,381,2474473,1480
1368,Amos,M,380,2474853,1341
1369,Bridget,F,380,2475233,1030
1370,Quinton,M,380,2475613,1773
1371,Zariyah,F,380,2475993,1026
1372,Kori,F,379,2476372,1386
1373,Frankie,F,378,2476750,1601
1374,Yosef,M,378,2477128,1432
1375,Bodie,M,377,2477505,1182
1376,Clarissa,F,377,2477882,1345
1377,Jerry,M,377,2478259,1562
1378,Langston,M,377,2478636,1700
1379,Axl,M,375,2479011,1952
1380,Brylee,F,375,2479386,1236
1381,Davina,F,375,2479761,1626
1382,Rivka,F,375,2480136,1325
1383,Stanley,M,375,2480511,1139
1384,Clay,M,374,2480885,1957
1385,Cynthia,F,373,2481258,1179
1386,Zaria,F,373,2481631,1694
1387,Douglas,M,372,2482003,1576
1388,Layne,M,372,2482375,1028
1389,Madalyn,F,372,2482747,1111
1390,Paula,F,372,2483119,1508
1391,Salem,F,372,2483491,1977
1392,Titan,M,372,2483863,1870
1393,Tomas,M,372,2484235,1996
1394,Houston,M,371,2484606,1900
1395,Amelie,F,370,2484976,1474
1396,Darren,M,370,2485346,1255
1397,Madisyn,F,370,2485716,1935
1398,Vienna,F,370,2486086,1252
1399,Haisley,F,369,2486455,1323
1400,Lachlan,M,369,2486824,1906
1401,Ainhoa,F,367,2487191,1513
1402,Journi,F,367,2487558,1137
1403,Kase,M,367,2487925,1159
1404,Oaklee,F,367,2488292,1440
1405,Korbin,M,366,2488658,1872
1406,Livia,F,366,2489024,1838
1407,Miley,F,365,2489389,1485
1408,Adele,F,364,2489753,1571
1409,Amaia,F,364,2490117,1984
1410,Yara,F,362,2490479,1183
1411,Averi,F,361,2490840,1644
1412,Joziah,M,361,2491201,1484
1413,Samir,M,360,2491561,1982
1414,Watson,M,360,2491921,1583
1415,Colten,M,359,2492280,1997
1416,Emmeline,F,359,2492639,1210
1417,Kyleigh,F,359,2492998,1558
1418,Princess,F,359,2493357,1050
1419,Roger,M,359,2493716,1174
1420,Penny,F,358,2494074,1967
1421,Tommy,M,358,2494432,1726
1422,Sariyah,F,357,2494789,1978
1423,Amayah,F,356,2495145,1777
1424,Crystal,F,356,2495501,1023
1425,Mitchell,M,356,2495857,1417
1426,Keyla,F,355,2496212,1157
1427,Lilyana,F,355,2496567,1991
1428,Linda,F,355,2496922,1721
1429,Aniya,F,354,2497276,1509
1430,Azariah,M,354,2497630,1344
1431,Marianna,F,354,2497984,1528
1432,Noe,M,354,2498338,1421
1433,Talon,M,354,2498692,1244
1434,Alaiya,F,353,2499045,1949
1435,Deandre,M,353,2499398,1138
1436,Lochlan,M,353,2499751,1861
1437,Noemi,F,353,2500104,1114
1438,Chanel,F,352,2500456,1328
1439,Estella,F,352,2500808,1230
1440,Isabela,F,352,2501160,1158
1441,Jillian,F,352,2501512,1883
1442,Kallie,F,352,2501864,1043
1443,Ellianna,F,350,2502214,1632
1444,Elsa,F,350,2502564,1423
1445,Itzayana,F,350,2502914,1778
1446,Joe,M,350,2503264,1556
1447,Carmelo,M,349,2503613,1643
1448,Otis,M,349,2503962,1347
1449,Zora,F,349,2504311,1709
1450,Estelle,F,348,2504659,1857
1451,Randy,M,348,2505007,1117
1452,Chana,F,347,2505354,1812
1453,Raina,F,347,2505701,1653
1454,Sunny,F,347,2506048,1599
1455,Estrella,F,346,2506394,1321
1456,Martha,F,346,2506740,1356
1457,Byron,M,345,2507085,1206
1458,Ellen,F,345,2507430,1818
1459,Kailey,F,345,2507775,1580
1460,Maxine,F,345,2508120,1994
1461,Chaim,M,344,2508464,1459
1462,Clare,F,342,2508806,1805
1463,Devon,M,342,2509148,1336
1464,Nathanael,M,342,2509490,1810
1465,Teresa,F,342,2509832,1802
1466,Annika,F,341,2510173,1565
1467,Bruno,M,341,2510514,1902
1468,Aryan,M,340,2510854,1127
1469,Flynn,M,340,2511194,1975
1470,Kamilah,F,340,2511534,1160
1471,Vicente,M,340,2511874,1543
1472,Brixton,M,339,2512213,1560
1473,Della,F,339,2512552,1753
1474,Kyro,M,339,2512891,1834
1475,Addyson,F,338,2513229,1435
1476,Brennan,M,338,2513567,1403
1477,Lilianna,F,338,2513905,1080
1478,Casen,M,337,2514242,1211
1479,Tinsley,F,336,2514578,1277
1480,Yaritza,F,336,2514914,1395
1481,Navy,F,335,2515249,1535
1482,Winnie,F,335,2515584,1088
1483,Kenzo,M,334,2515918,1268
1484,Orlando,M,334,2516252,1569
1485,Andi,F,333,2516585,1717
1486,Castiel,M,333,2516918,1887
1487,Kamiyah,F,333,2517251,1002
1488,Rayden,M,333,2517584,1392
1489,Waverly,F,333,2517917,1520
1490,Ben,M,332,2518249,1735
1491,Grey,M,332,2518581,1500
1492,Jedidiah,M,332,2518913,1548
1493,Sky,F,332,2519245,1716
1494,Amaris,F,331,2519576,1502
1495,Ramona,F,331,2519907,1401
1496,Saoirse,F,331,2520238,1360
1497,Hana,F,330,2520568,1393
1498,Judith,F,330,2520898,1013
1499,Tadeo,M,330,2521228,1616
1500,Halle,F,329,2521557,1702
1501,Laylah,F,329,2521886,1342
1502,Novalee,F,329,2522215,1894
1503,Augustine,M,328,2522543,1749
1504,Jaycee,F,328,2522871,1072
1505,Mekhi,M,328,2523199,1908
1506,Zaniyah,F,328,2523527,1687
1507,Alianna,F,327,2523854,1285
1508,Paulina,F,327,2524181,1695
1509,Abdullah,M,326,2524507,1463
1510,Jayde,F,326,2524833,1402
1511,Ramon,M,326,2525159,1376
1512,Saint,M,326,2525485,1839
1513,Thalia,F,326,2525811,1885
1514,Giovanna,F,325,2526136,1458
1515,Gwen,F,325,2526461,1027
1516,Maurice,M,325,2526786,1483
1517,Iliana,F,324,2527110,1622
1518,Jefferson,M,324,2527434,1788
1519,Maximo,M,324,2527758,1192
1520,Elora,F,323,2528081,1923
1521,Koa,M,323,2528404,1358
1522,Ray,M,323,2528727,1913
1523,Kaylie,F,322,2529049,1481
1524,Braylee,F,321,2529370,1553
1525,Mavis,F,319,2529689,1901
1526,Eddie,M,318,2530007,1310
1527,Ellison,F,318,2530325,1260
1528,Guillermo,M,318,2530643,1209
1529,Margo,F,318,2530961,1570
1530,Mylah,F,318,2531279,1728
1531,Onyx,M,318,2531597,1425
1532,Paisleigh,F,318,2531915,1217
1533,Thaddeus,M,318,2532233,1491
1534,Wayne,M,318,2532551,1630
1535,Analia,F,317,2532868,1676
1536,Hassan,M,317,2533185,1914
1537,Alonso,M,316,2533501,1609
1538,Brittany,F,316,2533817,1992
1539,Dash,M,316,2534133,1110
1540,Elisha,M,316,2534449,1987
1541,Kaisley,F,316,2534765,1278
1542,Belen,F,315,2535080,1876
1543,Jaxxon,M,315,2535395,1633
1544,Promise,F,315,2535710,1789
1545,Rohan,M,315,2536025,1958
1546,Amiya,F,314,2536339,1624
1547,Carl,M,314,2536653,1036
1548,Dalary,F,314,2536967,1656
1549,Kelvin,M,314,2537281,1383
1550,Veda,F,314,2537595,1916
1551,Alisson,F,313,2537908,1349
1552,Keilani,F,313,2538221,1946
1553,Oakleigh,F,313,2538534,1166
1554,Guadalupe,F,312,2538846,1046
1555,Jon,M,312,2539158,1177
1556,Larry,M,311,2539469,1986
1557,Leanna,F,311,2539780,1737
1558,Rosalyn,F,311,2540091,1685
1559,Selene,F,311,2540402,1343
1560,Theodora,F,311,2540713,1918
1561,Aldo,M,310,2541023,1035
1562,Marcel,M,310,2541333,1454
1563,Melvin,M,310,2541643,1783
1564,Yousef,M,310,2541953,1218
1565,Anais,F,309,2542262,1764
1566,Aron,M,309,2542571,1176
1567,Kace,M,309,2542880,1641
1568,Vincenzo,M,309,2543189,1701
1569,Elodie,F,308,2543497,1490
1570,Kellan,M,308,2543805,1747
1571,Miller,M,308,2544113,1811
1572,Celia,F,307,2544420,1627
1573,Dani,F,307,2544727,1920
1574,Indie,F,307,2545034,1928
1575,Jakob,M,307,2545341,1133
1576,Kenia,F,307,2545648,1201
1577,Nellie,F,307,2545955,1488
1578,Belle,F,306,2546261,1995
1579,Kataleya,F,306,2546567,1848
1580,Lexie,F,306,2546873,1319
1581,Miah,F,306,2547179,1202
1582,Sylvie,F,306,2547485,1420
1583,Valery,F,306,2547791,1150
1584,Addilynn,F,305,2548096,1419
1585,Dulce,F,305,2548401,1205
1586,Marissa,F,305,2548706,1748
1587,Meilani,F,305,2549011,1009
1588,Natasha,F,305,2549316,1993
1589,Harris,M,304,2549620,1404
1590,Jaylee,F,304,2549924,1365
1591,Kellen,M,304,2550228,1864
1592,Kimora,F,304,2550532,1846
1593,Kristopher,M,304,2550836,1734
1594,Raquel,F,304,2551140,1149
1595,Scarlette,F,304,2551444,1947
1596,Aliya,F,303,2551747,1410
1597,Ernesto,M,303,2552050,1675
1598,Nataly,F,303,2552353,1640
1599,Whitney,F,303,2552656,1143
1600,Gary,M,302,2552958,1242
1601,Trace,M,302,2553260,1467
1602,Joey,M,301,2553561,1921
1603,Corinne,F,300,2553861,1767
1604,Clyde,M,298,2554159,1011
1605,Enoch,M,298,2554457,1237
1606,Nathalie,F,298,2554755,1263
1607,Jaxx,M,297,2555052,1522
1608,Kiera,F,297,2555349,1639
1609,Milana,F,297,2555646,1247
1610,Vada,F,297,2555943,1917
1611,Violeta,F,297,2556240,1873
1612,Crosby,M,296,2556536,1382
1613,Luz,F,296,2556832,1090
1614,Magnus,M,296,2557128,1596
1615,Addisyn,F,295,2557423,1550
1616,Fisher,M,295,2557718,1678
1617,Jadiel,M,295,2558013,1165
1618,Bronson,M,294,2558307,1714
1619,Eugene,M,294,2558601,1151
1620,Lee,M,294,2558895,1607
1621,Deborah,F,293,2559188,1611
1622,Tori,F,293,2559481,1464
1623,Zainab,F,293,2559774,1525
1624,Brecken,M,292,2560066,1760
1625,Erika,F,292,2560358,1866
1626,Jenesis,F,292,2560650,1741
1627,Atreus,M,291,2560941,1044
1628,Avalynn,F,291,2561232,1079
1629,Madden,M,291,2561523,1015
1630,Nancy,F,291,2561814,1759
1631,Emmalynn,F,290,2562104,1849
1632,Hadlee,F,290,2562394,1462
1633,Heavenly,F,290,2562684,1667
1634,Khari,M,290,2562974,1434
1635,Aubrielle,F,289,2563263,1936
1636,Caspian,M,289,2563552,1871
1637,Elisabeth,F,289,2563841,1275
1638,Ishaan,M,289,2564130,1497
1639,Salma,F,289,2564419,1798
1640,Adalee,F,288,2564707,1099
1641,Kristian,M,288,2564995,1890
1642,Landry,F,288,2565283,1660
1643,Malayah,F,288,2565571,1646
1644,Novah,F,288,2565859,1476
1645,Westley,M,288,2566147,1173
1646,Egypt,F,287,2566434,1461
1647,Hugh,M,287,2566721,1771
1648,Musa,M,287,2567008,1617
1649,Ayleen,F,286,2567294,1595
1650,Blessing,F,286,2567580,1757
1651,Elina,F,286,2567866,1816
1652,Joyce,F,286,2568152,1146
1653,Myah,F,286,2568438,1031
1654,Rey,M,286,2568724,1937
1655,Thatcher,M,286,2569010,1335
1656,Zoie,F,286,2569296,1196
1657,Alfred,M,285,2569581,1000
1658,Christine,F,285,2569866,1388
1659,Jaelynn,F,285,2570151,1533
1660,Kye,M,285,2570436,1249
1661,Persephone,F,285,2570721,1821
1662,Reyansh,M,285,2571006,1791
1663,Emmaline,F,284,2571290,1769
1664,Paloma,F,284,2571574,1799
1665,Yahir,M,284,2571858,1216
1666,Cain,M,283,2572141,1156
1667,Harleigh,F,283,2572424,1850
1668,Mordechai,M,283,2572707,1351
1669,Noor,F,283,2572990,1628
1670,Paola,F,283,2573273,1782
1671,Zayd,M,283,2573556,1207
1672,Demetrius,M,282,2573838,1141
1673,India,F,282,2574120,1794
1674,Madalynn,F,282,2574402,1303
1675,Rosalee,F,282,2574684,1589
1676,Felipe,M,281,2574965,1245
1677,Florence,F,281,2575246,1602
1678,Louie,M,281,2575527,1807
1679,Maliah,F,281,2575808,1874
1680,Branson,M,280,2576088,1614
1681,Flora,F,280,2576368,1878
1682,Luella,F,280,2576648,1208
1683,Patricia,F,280,2576928,1136
1684,Whitley,F,280,2577208,1855
1685,Carolyn,F,279,2577487,1405
1686,Graysen,M,279,2577766,1521
1687,Kathleen,F,279,2578045,1504
1688,Keily,F,279,2578324,1107
1689,Kiana,F,279,2578603,1241
1690,Tenley,F,279,2578882,1085
1691,Allan,M,278,2579160,1144
1692,Alyson,F,278,2579438,1076
1693,Barbara,F,278,2579716,1945
1694,Dana,F,278,2579994,1363
1695,Kole,M,278,2580272,1552
1696,Yasmin,F,278,2580550,1162
1697,Bexley,F,277,2580827,1377
1698,Harold,M,277,2581104,1340
1699,Tatiana,F,277,2581381,1086
1700,Arden,F,276,2581657,1898
1701,Aubriella,F,276,2581933,1014
1702,Lindsey,F,276,2582209,1304
1703,Alvaro,M,274,2582483,1330
1704,Emani,F,274,2582757,1416
1705,Hailee,F,274,2583031,1672
1706,Harlan,M,274,2583305,1125
1707,Lisa,F,274,2583579,1615
1708,Sevyn,F,274,2583853,1629
1709,Amias,M,273,2584126,1578
1710,Brett,M,273,2584399,1387
1711,Fallon,F,273,2584672,1309
1712,Khalid,M,273,2584945,1719
1713,Magdalena,F,273,2585218,1418
1714,Misael,M,273,2585491,1282
1715,Tinley,F,273,2585764,1324
1716,Westin,M,273,2586037,1613
1717,Zechariah,M,273,2586310,1833
1718,Aydin,M,272,2586582,1473
1719,Halo,F,272,2586854,1584
1720,Kaiser,M,272,2587126,1738
1721,Lailah,F,272,2587398,1501
1722,Lian,M,272,2587670,1096
1723,Arlette,F,271,2587941,1780
1724,Bryant,M,271,2588212,1238
1725,Junior,M,271,2588483,1200
1726,Ansley,F,270,2588753,1054
1727,Esperanza,F,270,2589023,1863
1728,Ulises,M,270,2589293,1803
1729,Bellamy,M,269,2589562,1101
1730,Cleo,F,269,2589831,1352
1731,Aila,F,268,2590099,1262
1732,Brayan,M,268,2590367,1148
1733,Emerald,F,268,2590635,1306
1734,Jaelyn,F,268,2590903,1066
1735,Kody,M,268,2591171,1860
1736,Ledger,M,268,2591439,1832
1737,Eliseo,M,267,2591706,1515
1738,Gordon,M,267,2591973,1693
1739,Karlee,F,267,2592240,1448
1740,Kaya,F,267,2592507,1621
1741,Rocky,M,267,2592774,1181
1742,Valentin,M,267,2593041,1431
1743,Ingrid,F,266,2593307,1042
1744,Jewel,F,266,2593573,1322
1745,Terry,M,266,2593839,1634
1746,Damari,M,265,2594104,1642
1747,Trent,M,265,2594369,1396
1748,Emilee,F,264,2594633,1283
1749,Bentlee,M,263,2594896,1889
1750,Canaan,M,263,2595159,1665
1751,Gatlin,M,263,2595422,1590
1752,Giana,F,263,2595685,1334
1753,Paityn,F,263,2595948,1544
1754,Zola,F,263,2596211,1752
1755,Amoura,F,262,2596473,1471
1756,Kiaan,M,262,2596735,1971
1757,Renee,F,262,2596997,1948
1758,Alfie,M,261,2597258,1636
1759,Ann,F,261,2597519,1063
1760,Berkley,F,261,2597780,1605
1761,Franco,M,261,2598041,1572
1762,Harriet,F,261,2598302,1998
1763,Queen,F,261,2598563,1942
1764,Sariah,F,261,2598824,1006
1765,Beatrix,F,260,2599084,1911
1766,Eithan,M,260,2599344,1673
1767,Idris,M,260,2599604,1220
1768,Krew,M,260,2599864,1586
1769,Sandra,F,260,2600124,1925
1770,Alannah,F,259,2600383,1662
1771,Austyn,F,259,2600642,1048
1772,Freyja,F,259,2600901,1479
1773,Kaylin,F,259,2601160,1990
1774,Samira,F,259,2601419,1033
1775,Taliyah,F,259,2601678,1731
1776,Yehuda,M,259,2601937,1664
1777,Hadleigh,F,258,2602195,1248
1778,Kaiya,F,258,2602453,1374
1779,Marlon,M,258,2602711,1895
1780,Robin,F,258,2602969,1669
1781,Rodney,M,258,2603227,1723
1782,Creed,M,257,2603484,1970
1783,Luisa,F,257,2603741,1486
1784,Salvatore,M,257,2603998,1523
1785,Stefan,M,257,2604255,1688
1786,Tristen,M,257,2604512,1056
1787,Zendaya,F,257,2604769,1115
1788,Ariadne,F,256,2605025,1457
1789,Dixie,F,256,2605281,1436
1790,Naya,F,256,2605537,1503
1791,Adrien,M,255,2605792,1406
1792,Adrienne,F,255,2606047,1625
1793,Jamal,M,255,2606302,1755
1794,Judson,M,255,2606557,1581
1795,Rilynn,F,255,2606812,1267
1796,Camilo,M,254,2607066,1400
1797,Kenny,M,254,2607320,1021
1798,Nyomi,F,254,2607574,1652
1799,Rudy,M,254,2607828,1229
1800,Seraphina,F,254,2608082,1051
1801,Van,M,254,2608336,1505
1802,Artemis,F,253,2608589,1069
1803,Bjorn,M,253,2608842,1132
1804,Kadence,F,253,2609095,1379
1805,Leena,F,253,2609348,1585
1806,Libby,F,253,2609601,1756
1807,Marcella,F,253,2609854,1725
1808,Marisol,F,253,2610107,1683
1809,Tara,F,253,2610360,1983
1810,Aspyn,F,252,2610612,1837
1811,Brodie,M,252,2610864,1257
1812,Loretta,F,252,2611116,1542
1813,Mac,M,252,2611368,1194
1814,Azaria,F,251,2611619,1559
1815,Cara,F,251,2611870,1477
1816,Carla,F,251,2612121,1817
1817,Etta,F,251,2612372,1712
1818,Jacoby,M,251,2612623,1813
1819,Majesty,F,251,2612874,1746
1820,Sekani,M,251,2613125,1188
1821,Vivaan,M,251,2613376,1527
1822,Blaine,M,250,2613626,1551
1823,Honesty,F,250,2613876,1170
1824,Ira,M,250,2614126,1666
1825,Jaylene,F,250,2614376,1265
1826,Joselyn,F,250,2614626,1742
1827,Lillianna,F,250,2614876,1659
1828,Violette,F,250,2615126,1744
1829,Aadhya,F,249,2615375,1932
1830,Ameer,M,249,2615624,1251
1831,Cherish,F,249,2615873,1912
1832,Dominik,M,249,2616122,1493
1833,Alaric,M,248,2616370,1879
1834,Arely,F,248,2616618,1751
1835,Ayva,F,248,2616866,1927
1836,Dane,M,248,2617114,1696
1837,Emilie,F,248,2617362,1835
1838,Jeremias,M,248,2617610,1815
1839,Kyng,M,248,2617858,1019
1840,Reginald,M,248,2618106,1221
1841,Yamileth,F,248,2618354,1446
1842,Bobby,M,247,2618601,1888
1843,Ila,F,247,2618848,1853
1844,Kabir,M,247,2619095,1154
1845,Kailyn,F,247,2619342,1153
1846,Karlie,F,247,2619589,1089
1847,Marleigh,F,247,2619836,1116
1848,Micaela,F,247,2620083,1492
1849,Nori,F,247,2620330,1532
1850,Saanvi,F,247,2620577,1222
1851,Abril,F,246,2620823,1969
1852,Jairo,M,246,2621069,1884
1853,Scout,F,246,2621315,1064
1854,Alexzander,M,245,2621560,1361
1855,Benicio,M,245,2621805,1294
1856,Dalia,F,245,2622050,1452
1857,Lizbeth,F,245,2622295,1052
1858,Vance,M,245,2622540,1824
1859,Wallace,M,245,2622785,1806
1860,Zavier,M,245,2623030,1047
1861,Billy,M,244,2623274,1095
1862,Callahan,M,244,2623518,1974
1863,Dakari,M,244,2623762,1284
1864,Evalyn,F,244,2624006,1412
1865,Iyla,F,244,2624250,1169
1866,Kaelyn,F,244,2624494,1415
1867,Gerald,M,243,2624737,1531
1868,Kenley,F,243,2624980,1061
1869,Khalani,F,243,2625223,1394
1870,Turner,M,243,2625466,1733
1871,Angelique,F,242,2625708,1224
1872,Bear,M,242,2625950,1840
1873,Claudia,F,242,2626192,1661
1874,Jabari,M,242,2626434,1142
1875,Kassandra,F,242,2626676,1175
1876,Kaylynn,F,242,2626918,1005
1877,Cory,M,241,2627159,1619
1878,Erica,F,241,2627400,1511
1879,Fox,M,241,2627641,1892
1880,Harlem,M,241,2627882,1017
1881,Jakari,M,241,2628123,1223
1882,Jeffery,M,241,2628364,1291
1883,Marlowe,F,241,2628605,1699
1884,Maxton,M,241,2628846,1427
1885,Ronnie,M,241,2629087,1934
1886,Sarahi,F,241,2629328,1337
1887,Yisroel,M,241,2629569,1053
1888,Zakai,M,241,2629810,1972
1889,Bridger,M,240,2630050,1790
1890,Susan,F,240,2630290,1172
1891,Arian,M,239,2630529,1829
1892,Blaze,M,239,2630768,1517
1893,Everley,F,239,2631007,1271
1894,Forest,M,239,2631246,1092
1895,Jerome,M,239,2631485,1536
1896,Reuben,M,239,2631724,1512
1897,Wesson,M,239,2631963,1357
1898,Anders,M,238,2632201,1564
1899,Banks,M,238,2632439,1261
1900,Carina,F,238,2632677,1024
1901,Raya,F,238,2632915,1724
1902,Aminah,F,237,2633152,1826
1903,Brynleigh,F,237,2633389,1546
1904,Calum,M,237,2633626,1968
1905,Dayton,M,237,2633863,1269
1906,Jana,F,237,2634100,1204
1907,Jazlynn,F,237,2634337,1496
1908,Kylen,M,237,2634574,1638
1909,Dangelo,M,236,2634810,1526
1910,Desiree,F,236,2635046,1955
1911,Emir,M,236,2635282,1235
1912,Loyalty,F,236,2635518,1649
1913,Malakhi,M,236,2635754,1305
1914,Marceline,F,236,2635990,1658
1915,Perla,F,236,2636226,1195
1916,Brenda,F,235,2636461,1618
1917,Mollie,F,235,2636696,1880
1918,Patience,F,235,2636931,1875
1919,Blaise,M,234,2637165,1362
1920,Tru,M,234,2637399,1579
1921,Ayah,F,233,2637632,1897
1922,Boden,M,233,2637865,1193
1923,Kolten,M,233,2638098,1877
1924,Kylo,M,233,2638331,1907
1925,Melani,F,233,2638564,1240
1926,Viola,F,233,2638797,1232
1927,Aries,M,232,2639029,1862
1928,Elia,F,232,2639261,1430
1929,Henrik,M,232,2639493,1524
1930,Jovie,F,232,2639725,1567
1931,Jurnee,F,232,2639957,1198
1932,Kalel,M,232,2640189,1682
1933,Robyn,F,232,2640421,1348
1934,Chevelle,F,231,2640652,1909
1935,Marcellus,M,231,2640883,1359
1936,Naila,F,231,2641114,1979
1937,Zahir,M,231,2641345,1762
1938,Lyle,M,230,2641575,1375
1939,Neveah,F,230,2641805,1254
1940,Rhylee,F,230,2642035,1797
1941,Rosalina,F,230,2642265,1102
1942,Dario,M,229,2642494,1506
1943,Nailah,F,229,2642723,1152
1944,Raylee,F,229,2642952,1962
1945,Rene,M,229,2643181,1600
1946,Terrance,M,229,2643410,1126
1947,Xzavier,M,229,2643639,1926
1948,Alfonso,M,228,2643867,1084
1949,Alisha,F,228,2644095,1951
1950,Cordelia,F,228,2644323,1371
1951,Emiliana,F,228,2644551,1598
1952,Aliah,F,227,2644778,1670
1953,Antonia,F,227,2645005,1843
1954,Darian,M,227,2645232,1438
1955,Kylian,M,227,2645459,1487
1956,Leilany,F,227,2645686,1190
1957,Maison,M,227,2645913,1903
1958,Dara,F,226,2646139,1842
1959,Kenya,F,226,2646365,1385
1960,Annalee,F,225,2646590,1078
1961,Foster,M,225,2646815,1494
1962,Keenan,M,225,2647040,1424
1963,Lianna,F,225,2647265,1123
1964,Yahya,M,225,2647490,1155
1965,Danica,F,224,2647714,1119
1966,Heath,M,224,2647938,1758
1967,Janessa,F,224,2648162,1637
1968,Javion,M,224,2648386,1692
1969,Jericho,M,224,2648610,1074
1970,Aziel,M,223,2648833,1366
1971,Darwin,M,223,2649056,1779
1972,Joslyn,F,223,2649279,1989
1973,Layan,F,223,2649502,1674
1974,Marquis,M,223,2649725,1104
1975,Mylo,M,223,2649948,1841
1976,Ambrose,M,222,2650170,1707
1977,Anakin,M,222,2650392,1545
1978,Eleanora,F,222,2650614,1592
1979,Jordy,M,222,2650836,1468
1980,Juelz,M,222,2651058,1809
1981,Lenora,F,222,2651280,1384
1982,Toby,M,222,2651502,1547
1983,Wendy,F,222,2651724,1690
1984,Yael,M,222,2651946,1134
1985,Amia,F,221,2652167,1606
1986,Azrael,M,221,2652388,1854
1987,Birdie,F,221,2652609,1844
1988,Brentley,M,221,2652830,1346
1989,Lilia,F,221,2653051,1315
1990,Tristian,M,221,2653272,1243
1991,Aislinn,F,220,2653492,1203
1992,Bode,M,220,2653712,1657
1993,Jovanni,M,220,2653932,1300
1994,Santos,M,220,2654152,1715
1995,Zoya,F,220,2654372,1679
1996,Alistair,M,219,2654591,1380
1997,Braydon,M,219,2654810,1498
1998,Darcy,F,219,2655029,1140
1999,Kamdyn,M,219,2655248,1929
2000,Marc,M,219,2655467,2906
2001,Mattie,F,219,2655686,2359
2002,Mayson,M,219,2655905,2837
2003,Monserrat,F,219,2656124,2041
2004,Niklaus,M,219,2656343,2824
2005,Simeon,M,219,2656562,2679
2006,Vayda,F,219,2656781,2092
2007,Annabel,F,218,2656999,2903
2008,Arleth,F,218,2657217,2592
2009,Colter,M,218,2657435,2609
2010,Davion,M,218,2657653,2809
2011,Leroy,M,218,2657871,2733
2012,Ayan,M,217,2658088,2278
2013,Dilan,M,217,2658305,2283
2014,Ephraim,M,217,2658522,2004
2015,Farrah,F,217,2658739,2885
2016,Zhavia,F,217,2658956,2652
2017,Anson,M,216,2659172,2281
2018,Jaida,F,216,2659388,2780
2019,Kamora,F,216,2659604,2379
2020,Merrick,M,216,2659820,2994
2021,Sonia,F,216,2660036,2421
2022,Wes,M,216,2660252,2972
2023,Will,M,216,2660468,2740
2024,Jaxen,M,215,2660683,2289
2025,Kaleah,F,215,2660898,2448
2026,Maxim,M,215,2661113,2586
2027,Nuri,F,215,2661328,2894
2028,Celina,F,214,2661542,2724
2029,Evalynn,F,214,2661756,2372
2030,Howard,M,214,2661970,2618
2031,Jad,M,214,2662184,2030
2032,Jesiah,M,214,2662398,2781
2033,Maisy,F,214,2662612,2731
2034,Zayla,F,214,2662826,2150
2035,Agnes,F,213,2663039,2997
2036,Billie,F,213,2663252,2425
2037,Elissa,F,213,2663465,2486
2038,Ignacio,M,213,2663678,2996
2039,Maddie,F,213,2663891,2662
2040,Soraya,F,213,2664104,2752
2041,Zyon,M,213,2664317,2961
2042,Ahmir,M,212,2664529,2036
2043,Alyvia,F,212,2664741,2813
2044,Annette,F,212,2664953,2326
2045,Aryanna,F,212,2665165,2370
2046,Audrina,F,212,2665377,2363
2047,Giavanna,F,212,2665589,2257
2048,Jair,M,212,2665801,2209
2049,Moriah,F,212,2666013,2087
2050,Nathalia,F,212,2666225,2035
2051,Aranza,F,211,2666436,2014
2052,Kristina,F,211,2666647,2839
2053,Mustafa,M,211,2666858,2686
2054,Avalyn,F,210,2667068,2142
2055,Jermaine,M,210,2667278,2977
2056,Khadija,F,210,2667488,2343
2057,Meera,F,210,2667698,2571
2058,Yadiel,M,210,2667908,2475
2059,Aayan,M,209,2668117,2795
2060,Akira,F,209,2668326,2365
2061,Clover,F,209,2668535,2305
2062,Dhruv,M,209,2668744,2615
2063,Ivana,F,209,2668953,2863
2064,Kamilla,F,209,2669162,2411
2065,Raylynn,F,209,2669371,2241
2066,Seven,M,209,2669580,2466
2067,Stone,M,209,2669789,2384
2068,Araceli,F,208,2669997,2926
2069,Breanna,F,208,2670205,2514
2070,Melania,F,208,2670413,2664
2071,Rome,M,208,2670621,2561
2072,Rowyn,F,208,2670829,2399
2073,Achilles,M,207,2671036,2003
2074,Dimitri,M,207,2671243,2622
2075,Nickolas,M,207,2671450,2044
2076,Rylynn,F,207,2671657,2148
2077,Sailor,F,207,2671864,2416
2078,Soleil,F,207,2672071,2893
2079,Carsyn,F,206,2672277,2560
2080,Caylee,F,206,2672483,2659
2081,Cedric,M,206,2672689,2521
2082,Damir,M,206,2672895,2935
2083,Isai,M,206,2673101,2143
2084,Kacen,M,206,2673307,2772
2085,Kailee,F,206,2673513,2355
2086,Mikael,M,206,2673719,2849
2087,Willie,M,206,2673925,2234
2088,Amarah,F,205,2674130,2194
2089,Cayde,M,205,2674335,2093
2090,Craig,M,205,2674540,2905
2091,Jordynn,F,205,2674745,2154
2092,Lev,M,205,2674950,2246
2093,Sapphire,F,205,2675155,2653
2094,Alisa,F,204,2675359,2771
2095,Ciara,F,204,2675563,2909
2096,Davian,M,204,2675767,2529
2097,Devyn,F,204,2675971,2936
2098,Lakelyn,F,204,2676175,2852
2099,Mccoy,M,204,2676379,2743
2100,Miya,F,204,2676583,2658
2101,Selina,F,204,2676787,2730
2102,Tegan,F,204,2676991,2568
2103,Yasir,M,204,2677195,2031
2104,Duncan,M,203,2677398,2158
2105,Eason,M,203,2677601,2176
2106,Leif,M,203,2677804,2745
2107,Marjorie,F,203,2678007,2595
2108,Osiris,M,203,2678210,2538
2109,Shea,F,203,2678413,2876
2110,Stormi,F,203,2678616,2638
2111,Ulysses,M,203,2678819,2107
2112,Ralph,M,202,2679021,2318
2113,Rashad,M,202,2679223,2415
2114,Cristiano,M,201,2679424,2671
2115,Draven,M,201,2679625,2693
2116,Finlay,M,201,2679826,2406
2117,Immanuel,M,201,2680027,2819
2118,Ireland,F,201,2680228,2939
2119,Laylani,F,201,2680429,2870
2120,Maylee,F,201,2680630,2573
2121,Milah,F,201,2680831,2589
2122,Zamir,M,201,2681032,2076
2123,Ayana,F,200,2681232,2709
2124,Shepard,M,200,2681432,2496
2125,Shmuel,M,200,2681632,2988
2126,Coen,M,199,2681831,2151
2127,Greysen,M,199,2682030,2296
2128,Kahlani,F,198,2682228,2508
2129,Kolt,M,198,2682426,2230
2130,Nathaly,F,198,2682624,2028
2131,Pharaoh,M,198,2682822,2350
2132,Rae,F,198,2683020,2895
2133,Shay,F,198,2683218,2307
2134,Caitlyn,F,197,2683415,2277
2135,Cassie,F,197,2683612,2276
2136,Decker,M,197,2683809,2555
2137,Dwayne,M,197,2684006,2998
2138,Eliezer,M,197,2684203,2497
2139,Jaylin,F,197,2684400,2488
2140,Londynn,F,197,2684597,2899
2141,Rogelio,M,197,2684794,2478
2142,Roxanne,F,197,2684991,2720
2143,Seamus,M,197,2685188,2073
2144,Sharon,F,197,2685385,2417
2145,Avi,M,196,2685581,2802
2146,Hensley,F,196,2685777,2356
2147,Mireya,F,196,2685973,2291
2148,Torin,M,196,2686169,2140
2149,Ellery,F,195,2686364,2535
2150,Gus,M,195,2686559,2487
2151,Meir,M,195,2686754,2534
2152,Tabitha,F,195,2686949,2141
2153,Amya,F,194,2687143,2046
2154,Anniston,F,194,2687337,2381
2155,Blayke,F,194,2687531,2434
2156,Everest,M,194,2687725,2563
2157,Jenny,F,194,2687919,2721
2158,Riya,F,194,2688113,2967
2159,Aarna,F,193,2688306,2237
2160,Adler,M,193,2688499,2907
2161,Agustin,M,193,2688692,2866
2162,Aiyana,F,193,2688885,2300
2163,Bishop,M,193,2689078,2037
2164,Bryleigh,F,193,2689271,2605
2165,Kaisen,M,193,2689464,2490
2166,Kinzley,F,193,2689657,2551
2167,Mercedes,F,193,2689850,2409
2168,Ramiro,M,193,2690043,2705
2169,Rio,M,193,2690236,2620
2170,Roselynn,F,193,2690429,2235
2171,Shayla,F,193,2690622,2163
2172,Xena,F,193,2690815,2282
2173,Adela,F,192,2691007,2446
2174,Asha,F,192,2691199,2938
2175,Elayna,F,192,2691391,2136
2176,Karim,M,192,2691583,2828
2177,Maelynn,F,192,2691775,2182
2178,Ocean,F,192,2691967,2320
2179,Vivianna,F,192,2692159,2800
2180,Vivien,F,192,2692351,2650
2181,Wrenley,F,192,2692543,2373
2182,Aarya,F,191,2692734,2858
2183,Andie,F,191,2692925,2855
2184,Elouise,F,191,2693116,2583
2185,Montserrat,F,191,2693307,2101
2186,Vida,F,191,2693498,2672
2187,Winifred,F,191,2693689,2971
2188,Brayson,M,190,2693879,2678
2189,Emberlynn,F,190,2694069,2742
2190,Indigo,F,190,2694259,2121
2191,Justus,M,190,2694449,2611
2192,Kyzer,M,190,2694639,2711
2193,Lamar,M,190,2694829,2759
2194,Maryjane,F,190,2695019,2061
2195,Shaun,M,190,2695209,2336
2196,Zackary,M,190,2695399,2985
2197,Anita,F,189,2695588,2884
2198,Campbell,F,189,2695777,2530
2199,Emmet,M,189,2695966,2360
2200,Ernest,M,189,2696155,2695
2201,Gannon,M,189,2696344,2916
2202,Janae,F,189,2696533,2238
2203,Jaylynn,F,189,2696722,2877
2204,Karma,F,189,2696911,2953
2205,Leela,F,189,2697100,2382
2206,Shlomo,M,189,2697289,2498
2207,Terrell,M,189,2697478,2172
2208,Adilene,F,188,2697666,2225
2209,Courtney,F,188,2697854,2429
2210,Dalilah,F,188,2698042,2253
2211,Diamond,F,188,2698230,2528
2212,Guinevere,F,188,2698418,2728
2213,Hakeem,M,188,2698606,2881
2214,Kamille,F,188,2698794,2862
2215,Keren,F,188,2698982,2146
2216,Roslyn,F,188,2699170,2957
2217,Zev,M,188,2699358,2077
2218,Addie,F,187,2699545,2223
2219,Ailyn,F,187,2699732,2974
2220,Amethyst,F,187,2699919,2432
2221,Marian,F,187,2700106,2489
2222,Mariyah,F,187,2700293,2625
2223,Vaughn,M,187,2700480,2683
2224,Zia,F,187,2700667,2460
2225,Bayleigh,F,186,2700853,2170
2226,Cillian,M,186,2701039,2162
2227,Giancarlo,M,186,2701225,2185
2228,Kaira,F,186,2701411,2479
2229,Rayleigh,F,186,2701597,2054
2230,Rhiannon,F,186,2701783,2803
2231,Rubi,F,186,2701969,2774
2232,Tallulah,F,186,2702155,2747
2233,Boaz,M,185,2702340,2080
2234,Jessa,F,185,2702525,2510
2235,Laith,M,185,2702710,2857
2236,Maelyn,F,185,2702895,2208
2237,Semaj,M,185,2703080,2069
2238,Benton,M,184,2703264,2504
2239,Dania,F,184,2703448,2513
2240,Karsen,M,184,2703632,2085
2241,Maddux,M,184,2703816,2783
2242,Murphy,M,184,2704000,2968
2243,Nayla,F,184,2704184,2932
2244,Noble,M,184,2704368,2976
2245,Rosalind,F,184,2704552,2956
2246,Samiyah,F,184,2704736,2273
2247,Terrence,M,184,2704920,2637
2248,Aida,F,183,2705103,2919
2249,Ander,M,183,2705286,2760
2250,Annelise,F,183,2705469,2509
2251,Ayanna,F,183,2705652,2962
2252,Charity,F,183,2705835,2199
2253,Kyndall,F,183,2706018,2517
2254,Montgomery,M,183,2706201,2673
2255,Pierre,M,183,2706384,2229
2256,Abner,M,182,2706566,2400
2257,Aimee,F,182,2706748,2692
2258,Brent,M,182,2706930,2427
2259,Brynley,F,182,2707112,2826
2260,Dina,F,182,2707294,2378
2261,Theresa,F,182,2707476,2274
2262,Carlee,F,181,2707657,2794
2263,Coral,F,181,2707838,2933
2264,Emberlee,F,181,2708019,2021
2265,Hollis,M,181,2708200,2351
2266,Jasmin,F,181,2708381,2070
2267,Katelynn,F,181,2708562,2249
2268,Yitzchok,M,181,2708743,2231
2269,Coleman,M,180,2708923,2722
2270,Ean,M,180,2709103,2726
2271,Ida,F,180,2709283,2627
2272,Keziah,F,180,2709463,2557
2273,Kinsleigh,F,180,2709643,2990
2274,Kooper,M,180,2709823,2239
2275,Lorena,F,180,2710003,2342
2276,Silvia,F,180,2710183,2660
2277,Amal,F,179,2710362,2778
2278,Cristina,F,179,2710541,2045
2279,Eliam,M,179,2710720,2074
2280,Konnor,M,179,2710899,2252
2281,Malka,F,179,2711078,2591
2282,Margaux,F,179,2711257,2128
2283,Raheem,M,179,2711436,2493
2284,Alaysia,F,178,2711614,2392
2285,Amyra,F,178,2711792,2685
2286,Benedict,M,178,2711970,2888
2287,Cambria,F,178,2712148,2806
2288,Camdyn,M,178,2712326,2288
2289,Khalia,F,178,2712504,2773
2290,Korbyn,M,178,2712682,2756
2291,Markus,M,178,2712860,2942
2292,Rosalia,F,178,2713038,2385
2293,Slade,M,178,2713216,2775
2294,Susanna,F,178,2713394,2548
2295,Ally,F,177,2713571,2064
2296,Azael,M,177,2713748,2344
2297,Capri,F,177,2713925,2596
2298,Evander,M,177,2714102,2540
2299,Ezrah,M,177,2714279,2391
2300,Journei,F,177,2714456,2056
2301,Kaycee,F,177,2714633,2177
2302,Randall,M,177,2714810,2137
2303,Taytum,F,177,2714987,2882
2304,Brysen,M,176,2715163,2610
2305,Elin,F,176,2715339,2854
2306,Keagan,M,176,2715515,2569
2307,Mazikeen,F,176,2715691,2738
2308,Mike,M,176,2715867,2215
2309,Sidney,F,176,2716043,2572
2310,Adilynn,F,175,2716218,2212
2311,Alaiyah,F,175,2716393,2258
2312,Brenna,F,175,2716568,2690
2313,Deshawn,M,175,2716743,2009
2314,Kylah,F,175,2716918,2164
2315,Mazie,F,175,2717093,2310
2316,Viaan,M,175,2717268,2412
2317,Zakari,M,175,2717443,2130
2318,Adiel,M,174,2717617,2991
2319,Anabella,F,174,2717791,2833
2320,Elmer,M,174,2717965,2533
2321,Elon,M,174,2718139,2444
2322,Evelina,F,174,2718313,2338
2323,Gilbert,M,174,2718487,2420
2324,Jaylani,F,174,2718661,2799
2325,Kristen,F,174,2718835,2734
2326,Lilyanna,F,174,2719009,2279
2327,Maleni,F,174,2719183,2471
2328,Marigold,F,174,2719357,2265
2329,Rolando,M,174,2719531,2256
2330,Saniyah,F,174,2719705,2751
2331,Yoel,M,174,2719879,2099
2332,Zeus,M,174,2720053,2564
2333,Adira,F,173,2720226,2820
2334,Carmella,F,173,2720399,2707
2335,Chad,M,173,2720572,2651
2336,Elowyn,F,173,2720745,2531
2337,Garrison,M,173,2720918,2943
2338,Jenson,M,173,2721091,2648
2339,Lesly,F,173,2721264,2454
2340,Mika,F,173,2721437,2626
2341,Shimon,M,173,2721610,2808
2342,Addalyn,F,172,2721782,2868
2343,Anton,M,172,2721954,2431
2344,Araya,F,172,2722126,2280
2345,Cindy,F,172,2722298,2388
2346,Colbie,F,172,2722470,2587
2347,Gibson,M,172,2722642,2889
2348,Kaine,M,172,2722814,2262
2349,Petra,F,172,2722986,2322
2350,Valencia,F,172,2723158,2181
2351,Ziva,F,172,2723330,2011
2352,Addalynn,F,171,2723501,2323
2353,Elowen,F,171,2723672,2791
2354,Gianluca,M,171,2723843,2377
2355,Giovani,M,171,2724014,2438
2356,Guy,M,171,2724185,2565
2357,Julianne,F,171,2724356,2505
2358,Kacey,F,171,2724527,2317
2359,Kensington,F,171,2724698,2811
2360,Liah,F,171,2724869,2612
2361,Maisyn,F,171,2725040,2049
2362,Prisha,F,171,2725211,2986
2363,Alita,F,170,2725381,2816
2364,Coleson,M,170,2725551,2853
2365,Deangelo,M,170,2725721,2574
2366,Dominique,M,170,2725891,2160
2367,Eliyanah,F,170,2726061,2542
2368,Javon,M,170,2726231,2597
2369,Jones,M,170,2726401,2859
2370,Jovani,M,170,2726571,2169
2371,Kalina,F,170,2726741,2254
2372,Litzy,F,170,2726911,2630
2373,Micheal,M,170,2727081,2352
2374,Nazir,M,170,2727251,2367
2375,Ripley,F,170,2727421,2817
2376,Syncere,M,170,2727591,2669
2377,Tilly,F,170,2727761,2947
2378,Andreas,M,169,2727930,2699
2379,Angeline,F,169,2728099,2193
2380,Asia,F,169,2728268,2798
2381,Brayleigh,F,169,2728437,2188
2382,Imran,M,169,2728606,2053
2383,Kalia,F,169,2728775,2880
2384,Macklin,M,169,2728944,2577
2385,Rebeca,F,169,2729113,2847
2386,Rita,F,169,2729282,2312
2387,Rylen,M,169,2729451,2346
2388,Westyn,M,169,2729620,2117
2389,Zephaniah,M,169,2729789,2525
2390,Beverly,F,168,2729957,2451
2391,Jet,M,168,2730125,2584
2392,Ryatt,M,168,2730293,2746
2393,Amar,M,167,2730460,2835
2394,Annaleigh,F,167,2730627,2269
2395,Bastian,M,167,2730794,2768
2396,Bronx,M,167,2730961,2149
2397,Clarence,M,167,2731128,2582
2398,Elliette,F,167,2731295,2298
2399,Elvis,M,167,2731462,2204
2400,Jaxtyn,M,167,2731629,2089
2401,Jazzlyn,F,167,2731796,2689
2402,Jonathon,M,167,2731963,2062
2403,Lucien,M,167,2732130,2861
2404,Madyson,F,167,2732297,2590
2405,Malaki,M,167,2732464,2222
2406,Tzvi,M,167,2732631,2821
2407,Dailyn,F,166,2732797,2097
2408,Darrell,M,166,2732963,2248
2409,Gwyneth,F,166,2733129,2647
2410,Kaius,M,166,2733295,2913
2411,Kamron,M,166,2733461,2984
2412,Katerina,F,166,2733627,2951
2413,Kenan,M,166,2733793,2428
2414,Leilah,F,166,2733959,2286
2415,Menachem,M,166,2734125,2361
2416,Aarush,M,165,2734290,2851
2417,Amiah,F,165,2734455,2114
2418,Anyla,F,165,2734620,2875
2419,Camron,M,165,2734785,2754
2420,Carlie,F,165,2734950,2515
2421,Cashton,M,165,2735115,2240
2422,Emi,F,165,2735280,2133
2423,Joan,M,165,2735445,2174
2424,Jubilee,F,165,2735610,2032
2425,Nyra,F,165,2735775,2983
2426,Serafina,F,165,2735940,2394
2427,Skylah,F,165,2736105,2796
2428,Aleia,F,164,2736269,2079
2429,Amare,M,164,2736433,2060
2430,Ariela,F,164,2736597,2776
2431,Aryana,F,164,2736761,2598
2432,Belinda,F,164,2736925,2424
2433,Bernardo,M,164,2737089,2134
2434,Cal,M,164,2737253,2435
2435,Carsen,M,164,2737417,2314
2436,Channing,M,164,2737581,2139
2437,Deklan,M,164,2737745,2702
2438,Denzel,M,164,2737909,2698
2439,Isha,F,164,2738073,2039
2440,Karleigh,F,164,2738237,2407
2441,Kentrell,M,164,2738401,2217
2442,Darla,F,163,2738564,2126
2443,Deon,M,163,2738727,2369
2444,Eleni,F,163,2738890,2655
2445,Jai,M,163,2739053,2992
2446,Jakai,M,163,2739216,2924
2447,Krish,M,163,2739379,2100
2448,Kynslee,F,163,2739542,2657
2449,Zahara,F,163,2739705,2980
2450,Althea,F,162,2739867,2501
2451,Anabelle,F,162,2740029,2007
2452,Audriana,F,162,2740191,2784
2453,Aydan,M,162,2740353,2440
2454,Calista,F,162,2740515,2878
2455,Diya,F,162,2740677,2156
2456,Eilidh,F,162,2740839,2347
2457,Heather,F,162,2741001,2883
2458,Jayvion,M,162,2741163,2270
2459,Karmen,F,162,2741325,2168
2460,Marlie,F,162,2741487,2969
2461,Zella,F,162,2741649,2656
2462,Zhuri,F,162,2741811,2639
2463,Amberly,F,161,2741972,2494
2464,Aryah,F,161,2742133,2723
2465,Ashtyn,F,161,2742294,2153
2466,Avraham,M,161,2742455,2328
2467,Denise,F,161,2742616,2308
2468,Elinor,F,161,2742777,2025
2469,Goldie,F,161,2742938,2203
2470,Inaaya,F,161,2743099,2330
2471,Maizie,F,161,2743260,2387
2472,Quintin,M,161,2743421,2602
2473,Rosalynn,F,161,2743582,2043
2474,Tala,F,161,2743743,2022
2475,Yair,M,161,2743904,2480
2476,Benny,M,160,2744064,2186
2477,Betty,F,160,2744224,2912
2478,Edmund,M,160,2744384,2562
2479,Eliot,M,160,2744544,2321
2480,Geneva,F,160,2744704,2553
2481,Granger,M,160,2744864,2173
2482,Kalea,F,160,2745024,2469
2483,Kyren,M,160,2745184,2175
2484,Macey,F,160,2745344,2928
2485,Nadine,F,160,2745504,2701
2486,Raleigh,F,160,2745664,2418
2487,Ashanti,F,159,2745823,2815
2488,Cecily,F,159,2745982,2301
2489,Gadiel,M,159,2746141,2931
2490,Imogen,F,159,2746300,2027
2491,Knowledge,M,159,2746459,2353
2492,Kolson,M,159,2746618,2088
2493,Norman,M,159,2746777,2067
2494,Ruthie,F,159,2746936,2456
2495,Sally,F,159,2747095,2879
2496,Steve,M,159,2747254,2511
2497,Stormy,F,159,2747413,2567
2498,Taj,M,159,2747572,2642
2499,Tia,F,159,2747731,2458
2500,Tyrone,M,159,2747890,2187
2501,Yalitza,F,159,2748049,2981
2502,Alba,F,158,2748207,2012
2503,Arrow,M,158,2748365,2106
2504,Azriel,M,158,2748523,2921
2505,Casper,M,158,2748681,2461
2506,Dion,M,158,2748839,2403
2507,Ever,M,158,2748997,2623
2508,Grecia,F,158,2749155,2066
2509,Journie,F,158,2749313,2841
2510,Lenox,M,158,2749471,2873
2511,Lorraine,F,158,2749629,2812
2512,Ozzy,M,158,2749787,2468
2513,Sherlyn,F,158,2749945,2313
2514,Stacy,F,158,2750103,2688
2515,Tess,F,158,2750261,2271
2516,Veer,M,158,2750419,2081
2517,Ariadna,F,157,2750576,2896
2518,Beck,M,157,2750733,2086
2519,Bowie,M,157,2750890,2632
2520,Brynnlee,F,157,2751047,2897
2521,Cedar,M,157,2751204,2503
2522,Daylen,M,157,2751361,2311
2523,Freddie,M,157,2751518,2871
2524,Jersey,F,157,2751675,2337
2525,Marlene,F,157,2751832,2125
2526,Wiley,M,157,2751989,2244
2527,Yaakov,M,157,2752146,2670
2528,America,F,156,2752302,2911
2529,Benaiah,M,156,2752458,2398
2530,Bryanna,F,156,2752614,2015
2531,Inaya,F,156,2752770,2999
2532,Isiah,M,156,2752926,2908
2533,Kaidyn,M,156,2753082,2550
2534,Marin,F,156,2753238,2946
2535,Riggs,M,156,2753394,2472
2536,Todd,M,156,2753550,2005
2537,Yuna,F,156,2753706,2545
2538,Anayah,F,155,2753861,2051
2539,Aubri,F,155,2754016,2447
2540,Elara,F,155,2754171,2457
2541,Emil,M,155,2754326,2316
2542,Gray,M,155,2754481,2019
2543,Isadora,F,155,2754636,2579
2544,Janiya,F,155,2754791,2180
2545,Kalvin,M,155,2754946,2663
2546,Kasey,F,155,2755101,2915
2547,Kenji,M,155,2755256,2923
2548,Mariano,M,155,2755411,2294
2549,Shanaya,F,155,2755566,2831
2550,Yuliana,F,155,2755721,2057
2551,Zaya,F,155,2755876,2549
2552,Aadya,F,154,2756030,2484
2553,Aurelio,M,154,2756184,2633
2554,Danilo,M,154,2756338,2960
2555,Jael,F,154,2756492,2000
2556,Makhi,M,154,2756646,2594
2557,Matheo,M,154,2756800,2207
2558,Rodolfo,M,154,2756954,2251
2559,Tahj,M,154,2757108,2757
2560,Taya,F,154,2757262,2570
2561,Zephyr,M,154,2757416,2236
2562,Ameera,F,153,2757569,2293
2563,Cartier,M,153,2757722,2949
2564,Clifford,M,153,2757875,2118
2565,Emmalee,F,153,2758028,2026
2566,Khai,M,153,2758181,2575
2567,Kolby,M,153,2758334,2058
2568,Kruz,M,153,2758487,2644
2569,Krystal,F,153,2758640,2785
2570,Kymani,M,153,2758793,2096
2571,Leylani,F,153,2758946,2661
2572,Ollie,M,153,2759099,2335
2573,Temperance,F,153,2759252,2955
2574,Yasmine,F,153,2759405,2214
2575,Yusra,F,153,2759558,2603
2576,Bilal,M,152,2759710,2397
2577,Eamon,M,152,2759862,2443
2578,Empress,F,152,2760014,2492
2579,Klara,F,152,2760166,2864
2580,Lyam,M,152,2760318,2267
2581,Mariella,F,152,2760470,2008
2582,Natalee,F,152,2760622,2646
2583,Viktor,M,152,2760774,2979
2584,Alissa,F,151,2760925,2020
2585,Arie,F,151,2761076,2390
2586,Cristopher,M,151,2761227,2210
2587,Emmarie,F,151,2761378,2945
2588,Jaylon,M,151,2761529,2950
2589,Jethro,M,151,2761680,2965
2590,Kaleigh,F,151,2761831,2527
2591,Link,M,151,2761982,2814
2592,Skylynn,F,151,2762133,2029
2593,Truman,M,151,2762284,2758
2594,Yarely,F,151,2762435,2850
2595,Zaira,F,151,2762586,2299
2596,Aleyna,F,150,2762736,2192
2597,Amilia,F,150,2762886,2613
2598,Ayvah,F,150,2763036,2769
2599,Brenton,M,150,2763186,2098
2600,Briley,F,150,2763336,2206
2601,Gino,M,150,2763486,2810
2602,Karis,F,150,2763636,2927
2603,Maite,F,150,2763786,2628
2604,Taryn,F,150,2763936,2155
2605,Youssef,M,150,2764086,2303
2606,Zayan,M,150,2764236,2445
2607,Ayesha,F,149,2764385,2697
2608,Carmela,F,149,2764534,2334
2609,Chiara,F,149,2764683,2213
2610,Dariana,F,149,2764832,2024
2611,Ema,F,149,2764981,2825
2612,Gentry,M,149,2765130,2401
2613,Giada,F,149,2765279,2704
2614,Gisselle,F,149,2765428,2770
2615,Kelsie,F,149,2765577,2075
2616,Khaza,M,149,2765726,2266
2617,Loki,M,149,2765875,2216
2618,Annistyn,F,148,2766023,2665
2619,Bryn,F,148,2766171,2836
2620,Carlo,M,148,2766319,2874
2621,Delia,F,148,2766467,2666
2622,Finnian,M,148,2766615,2094
2623,Gitty,F,148,2766763,2617
2624,Kaycen,M,148,2766911,2691
2625,Milton,M,148,2767059,2243
2626,Preslee,F,148,2767207,2763
2627,Smith,M,148,2767355,2624
2628,True,M,148,2767503,2978
2629,Aura,F,147,2767650,2113
2630,Bernard,M,147,2767797,2918
2631,Darien,M,147,2767944,2105
2632,Essence,F,147,2768091,2285
2633,Georgina,F,147,2768238,2110
2634,Jahmir,M,147,2768385,2844
2635,Koen,M,147,2768532,2436
2636,Letty,F,147,2768679,2635
2637,Makena,F,147,2768826,2585
2638,Regan,F,147,2768973,2433
2639,Sia,F,147,2769120,2604
2640,Stephan,M,147,2769267,2753
2641,Cielo,F,146,2769413,2084
2642,Cortez,M,146,2769559,2455
2643,Elio,M,146,2769705,2922
2644,Geraldine,F,146,2769851,2755
2645,Haddie,F,146,2769997,2376
2646,Khamari,M,146,2770143,2891
2647,Laikyn,F,146,2770289,2838
2648,Laine,M,146,2770435,2184
2649,Nelly,F,146,2770581,2970
2650,Rayyan,M,146,2770727,2975
2651,Ruger,M,146,2770873,2845
2652,Sana,F,146,2771019,2766
2653,Shannon,F,146,2771165,2901
2654,Shirley,F,146,2771311,2518
2655,Sofie,F,146,2771457,2748
2656,Waylen,M,146,2771603,2792
2657,Wolfgang,M,146,2771749,2040
2658,Aleksander,M,145,2771894,2354
2659,Beaux,M,145,2772039,2453
2660,Gilberto,M,145,2772184,2736
2661,Ivey,F,145,2772329,2937
2662,Jazelle,F,145,2772474,2111
2663,Pamela,F,145,2772619,2842
2664,Pierson,M,145,2772764,2404
2665,Ryden,M,145,2772909,2157
2666,Tamia,F,145,2773054,2506
2667,Aksel,M,144,2773198,2636
2668,Arwen,F,144,2773342,2016
2669,Ash,M,144,2773486,2718
2670,Axle,M,144,2773630,2129
2671,Barry,M,144,2773774,2621
2672,Jamila,F,144,2773918,2502
2673,Judy,F,144,2774062,2948
2674,Osman,M,144,2774206,2325
2675,Pepper,F,144,2774350,2832
2676,Rain,F,144,2774494,2544
2677,Reya,F,144,2774638,2426
2678,Rori,F,144,2774782,2631
2679,Siya,F,144,2774926,2500
2680,Tyree,M,144,2775070,2189
2681,Charlize,F,143,2775213,2964
2682,Destin,M,143,2775356,2588
2683,Hasan,M,143,2775499,2413
2684,Larissa,F,143,2775642,2226
2685,Lindsay,F,143,2775785,2641
2686,Lucius,M,143,2775928,2476
2687,Vladimir,M,143,2776071,2449
2688,Brinlee,F,142,2776213,2993
2689,Chevy,M,142,2776355,2090
2690,Daenerys,F,142,2776497,2898
2691,Danika,F,142,2776639,2441
2692,Efrain,M,142,2776781,2135
2693,Eleazar,M,142,2776923,2537
2694,Emry,F,142,2777065,2643
2695,Giannis,M,142,2777207,2606
2696,Jean,M,142,2777349,2345
2697,Katrina,F,142,2777491,2830
2698,Natalya,F,142,2777633,2393
2699,Nikko,M,142,2777775,2167
2700,Renesmee,F,142,2777917,2247
2701,Sahara,F,142,2778059,2827
2702,Sol,F,142,2778201,2221
2703,Symphony,F,142,2778343,2071
2704,Tania,F,142,2778485,2065
2705,Aanya,F,141,2778626,2059
2706,Arham,M,141,2778767,2732
2707,Blythe,F,141,2778908,2749
2708,Caitlin,F,141,2779049,2904
2709,Cormac,M,141,2779190,2546
2710,Freddy,M,141,2779331,2380
2711,Janie,F,141,2779472,2566
2712,Kari,F,141,2779613,2559
2713,Karl,M,141,2779754,2261
2714,Laken,F,141,2779895,2255
2715,Marcela,F,141,2780036,2095
2716,Abbigail,F,140,2780176,2232
2717,Ishmael,M,140,2780316,2558
2718,Janice,F,140,2780456,2805
2719,Juana,F,140,2780596,2848
2720,Kamiya,F,140,2780736,2018
2721,Katarina,F,140,2780876,2524
2722,Kayleen,F,140,2781016,2104
2723,Lailani,F,140,2781156,2063
2724,Martina,F,140,2781296,2268
2725,Saniya,F,140,2781436,2668
2726,Teigan,F,140,2781576,2727
2727,Antoine,M,139,2781715,2366
2728,Asiya,F,139,2781854,2710
2729,Atharv,M,139,2781993,2423
2730,Audra,F,139,2782132,2358
2731,Bernadette,F,139,2782271,2198
2732,Emme,F,139,2782410,2846
2733,Janyla,F,139,2782549,2422
2734,Josias,M,139,2782688,2867
2735,Marion,F,139,2782827,2491
2736,Mayra,F,139,2782966,2050
2737,Ramsey,M,139,2783105,2995
2738,Reynaldo,M,139,2783244,2694
2739,Yaseen,M,139,2783383,2481
2740,Zarah,F,139,2783522,2297
2741,Zavian,M,139,2783661,2474
2742,Ananya,F,138,2783799,2987
2743,Brantlee,M,138,2783937,2674
2744,Caysen,M,138,2784075,2608
2745,Dayanna,F,138,2784213,2042
2746,Esmae,F,138,2784351,2340
2747,Faigy,F,138,2784489,2797
2748,Jahseh,M,138,2784627,2925
2749,Jalayah,F,138,2784765,2171
2750,Lazarus,M,138,2784903,2123
2751,Lizeth,F,138,2785041,2166
2752,Nick,M,138,2785179,2869
2753,Tayden,M,138,2785317,2315
2754,Tylan,M,138,2785455,2700
2755,Yuvaan,M,138,2785593,2872
2756,Addelyn,F,137,2785730,2554
2757,Baron,M,137,2785867,2405
2758,Beatriz,F,137,2786004,2963
2759,Evangelina,F,137,2786141,2302
2760,Kaci,F,137,2786278,2887
2761,Kaila,F,137,2786415,2750
2762,Lettie,F,137,2786552,2124
2763,Linkin,M,137,2786689,2989
2764,Marcello,M,137,2786826,2483
2765,Shivansh,M,137,2786963,2941
2766,Shoshana,F,137,2787100,2473
2767,Akeem,M,136,2787236,2890
2768,Alara,F,136,2787372,2006
2769,Ansel,M,136,2787508,2374
2770,Azul,F,136,2787644,2482
2771,Caius,M,136,2787780,2306
2772,Corbyn,M,136,2787916,2536
2773,Derick,M,136,2788052,2552
2774,Elly,F,136,2788188,2191
2775,Emberlyn,F,136,2788324,2052
2776,Gaia,F,136,2788460,2017
2777,Harlie,F,136,2788596,2331
2778,Konner,M,136,2788732,2741
2779,Lucie,F,136,2788868,2600
2780,Rico,M,136,2789004,2516
2781,Starr,F,136,2789140,2010
2782,Coby,M,135,2789275,2159
2783,Delta,F,135,2789410,2178
2784,Ela,F,135,2789545,2687
2785,Giulia,F,135,2789680,2127
2786,Kaeden,M,135,2789815,2419
2787,Kenzley,F,135,2789950,2914
2788,Rhyan,F,135,2790085,2712
2789,Sanaa,F,135,2790220,2383
2790,Tiago,M,135,2790355,2439
2791,Toni,F,135,2790490,2804
2792,Amariah,F,134,2790624,2190
2793,Annabeth,F,134,2790758,2787
2794,Aryeh,M,134,2790892,2450
2795,Carleigh,F,134,2791026,2782
2796,Edie,F,134,2791160,2132
2797,Eunice,F,134,2791294,2034
2798,Irie,F,134,2791428,2539
2799,Jaclyn,F,134,2791562,2713
2800,Nikola,M,134,2791696,2958
2801,Roderick,M,134,2791830,2275
2802,Sanai,F,134,2791964,2408
2803,Teo,M,134,2792098,2116
2804,Aston,M,133,2792231,2055
2805,Darryl,M,133,2792364,2607
2806,Dov,M,133,2792497,2414
2807,Heidy,F,133,2792630,2982
2808,Jarrett,M,133,2792763,2119
2809,Keon,M,133,2792896,2437
2810,Leeland,M,133,2793029,2556
2811,Lillyanna,F,133,2793162,2715
2812,May,F,133,2793295,2716
2813,Mckayla,F,133,2793428,2677
2814,Merritt,F,133,2793561,2593
2815,Nya,F,133,2793694,2729
2816,Safa,F,133,2793827,2205
2817,Zinnia,F,133,2793960,2680
2818,Avalon,F,132,2794092,2264
2819,Baila,F,132,2794224,2777
2820,German,M,132,2794356,2196
2821,Haleigh,F,132,2794488,2499
2822,Jaleah,F,132,2794620,2161
2823,Jocelynn,F,132,2794752,2629
2824,Kilian,M,132,2794884,2930
2825,Kya,F,132,2795016,2197
2826,Kyrin,M,132,2795148,2959
2827,Maura,F,132,2795280,2002
2828,Riaan,M,132,2795412,2764
2829,Ross,M,132,2795544,2619
2830,Violetta,F,132,2795676,2944
2831,Wylder,M,132,2795808,2202
2832,Ziya,F,132,2795940,2219
2833,Zyla,F,132,2796072,2952
2834,Alton,M,131,2796203,2072
2835,Brenden,M,131,2796334,2790
2836,Carley,F,131,2796465,2364
2837,Cassian,M,131,2796596,2332
2838,Crue,M,131,2796727,2272
2839,Devorah,F,131,2796858,2464
2840,Eisley,F,131,2796989,2195
2841,Georgiana,F,131,2797120,2507
2842,Harlyn,F,131,2797251,2218
2843,Jamarion,M,131,2797382,2902
2844,Jolee,F,131,2797513,2259
2845,Kartier,M,131,2797644,2362
2846,Kysen,M,131,2797775,2676
2847,Malikai,M,131,2797906,2807
2848,Ozias,M,131,2798037,2083
2849,Paulette,F,131,2798168,2934
2850,Roan,M,131,2798299,2396
2851,Truett,M,131,2798430,2843
2852,Yesenia,F,131,2798561,2348
2853,Annaliese,F,130,2798691,2614
2854,Aracely,F,130,2798821,2165
2855,Ayman,M,130,2798951,2442
2856,Davon,M,130,2799081,2263
2857,Demarcus,M,130,2799211,2341
2858,Denim,M,130,2799341,2319
2859,Henri,M,130,2799471,2576
2860,Hollyn,F,130,2799601,2145
2861,Izabelle,F,130,2799731,2108
2862,Khadijah,F,130,2799861,2389
2863,Kynleigh,F,130,2799991,2762
2864,Liza,F,130,2800121,2013
2865,Malek,M,130,2800251,2295
2866,Mariela,F,130,2800381,2940
2867,Oskar,M,130,2800511,2224
2868,Osvaldo,M,130,2800641,2654
2869,Priya,F,130,2800771,2082
2870,Renzo,M,130,2800901,2708
2871,Vivianne,F,130,2801031,2865
2872,Zack,M,130,2801161,2001
2873,Alessa,F,129,2801290,2327
2874,Armaan,M,129,2801419,2682
2875,Atreyu,M,129,2801548,2767
2876,Bree,F,129,2801677,2667
2877,Damaris,F,129,2801806,2541
2878,Gian,M,129,2801935,2519
2879,Graciela,F,129,2802064,2954
2880,Italy,F,129,2802193,2823
2881,Jakobe,M,129,2802322,2739
2882,Jakobi,M,129,2802451,2371
2883,Jazmyn,F,129,2802580,2744
2884,Kaelynn,F,129,2802709,2120
2885,Kenzi,F,129,2802838,2788
2886,Lottie,F,129,2802967,2386
2887,Perry,M,129,2803096,2290
2888,Rishi,M,129,2803225,2860
2889,Rochel,F,129,2803354,2703
2890,Star,F,129,2803483,2115
2891,Alessio,M,128,2803611,2233
2892,Amarion,M,128,2803739,2410
2893,Aubrianna,F,128,2803867,2179
2894,Canon,M,128,2803995,2522
2895,Christiana,F,128,2804123,2138
2896,Inara,F,128,2804251,2801
2897,Jamar,M,128,2804379,2462
2898,Jaydon,M,128,2804507,2038
2899,Kanan,M,128,2804635,2152
2900,Korra,F,128,2804763,2786
2901,Lidia,F,128,2804891,2103
2902,Luther,M,128,2805019,2512
2903,Milania,F,128,2805147,2242
2904,Saphira,F,128,2805275,2714
2905,Avril,F,127,2805402,2581
2906,Cian,M,127,2805529,2829
2907,Coy,M,127,2805656,2375
2908,Damion,M,127,2805783,2211
2909,Darnell,M,127,2805910,2543
2910,Glenn,M,127,2806037,2526
2911,Jhene,F,127,2806164,2227
2912,Kain,M,127,2806291,2200
2913,Keila,F,127,2806418,2068
2914,Nahla,F,127,2806545,2047
2915,Naima,F,127,2806672,2467
2916,Niam,M,127,2806799,2649
2917,Orla,F,127,2806926,2735
2918,Rihanna,F,127,2807053,2789
2919,Wilhelmina,F,127,2807180,2078
2920,Yamilet,F,127,2807307,2706
2921,Zen,M,127,2807434,2395
2922,Anylah,F,126,2807560,2122
2923,Arlet,F,126,2807686,2430
2924,Jacquelyn,F,126,2807812,2793
2925,Jasiel,M,126,2807938,2470
2926,Jiraiya,M,126,2808064,2840
2927,Love,F,126,2808190,2725
2928,Miyah,F,126,2808316,2228
2929,Sahana,F,126,2808442,2102
2930,Tyrell,M,126,2808568,2201
2931,Winona,F,126,2808694,2765
2932,Aleyah,F,125,2808819,2144
2933,Arizona,F,125,2808944,2357
2934,Deanna,F,125,2809069,2684
2935,Deegan,M,125,2809194,2601
2936,Elyas,M,125,2809319,2547
2937,Irina,F,125,2809444,2681
2938,Jianna,F,125,2809569,2520
2939,Jovi,F,125,2809694,2292
2940,Linnea,F,125,2809819,2966
2941,Lori,F,125,2809944,2634
2942,Lucinda,F,125,2810069,2580
2943,Nila,F,125,2810194,2284
2944,Noelani,F,125,2810319,2675
2945,Pyper,F,125,2810444,2856
2946,Suri,F,125,2810569,2886
2947,Syed,M,125,2810694,2131
2948,Zaina,F,125,2810819,2779
2949,Adaleigh,F,124,2810943,2463
2950,Carver,M,124,2811067,2929
2951,Clinton,M,124,2811191,2920
2952,Dovid,M,124,2811315,2892
2953,Hartley,F,124,2811439,2477
2954,Kallen,M,124,2811563,2523
2955,Kelani,F,124,2811687,2349
2956,Kenton,M,124,2811811,2696
2957,Lakelynn,F,124,2811935,2717
2958,Maple,F,124,2812059,2495
2959,Millicent,F,124,2812183,2260
2960,Noelia,F,124,2812307,2737
2961,Oren,M,124,2812431,2183
2962,Tamara,F,124,2812555,2818
2963,Adolfo,M,123,2812678,2048
2964,Avyaan,M,123,2812801,2112
2965,Emrie,F,123,2812924,2900
2966,Estela,F,123,2813047,2329
2967,Ester,F,123,2813170,2324
2968,Geovanni,M,123,2813293,2645
2969,Huntleigh,F,123,2813416,2033
2970,Karely,F,123,2813539,2245
2971,Kyron,M,123,2813662,2822
2972,Novaleigh,F,123,2813785,2532
2973,Salome,F,123,2813908,2616
2974,Taelynn,F,123,2814031,2339
2975,Thorin,M,123,2814154,2761
2976,Yasin,M,123,2814277,2109
2977,Adina,F,122,2814399,2287
2978,Ayra,F,122,2814521,2485
2979,Azai,M,122,2814643,2834
2980,Darlene,F,122,2814765,2147
2981,Denis,M,122,2814887,2459
2982,Gionni,M,122,2815009,2640
2983,Gonzalo,M,122,2815131,2465
2984,Hans,M,122,2815253,2368
2985,Huck,M,122,2815375,2599
2986,Ilan,M,122,2815497,2250
2987,Janet,F,122,2815619,2719
2988,Jiovanni,M,122,2815741,2910
2989,Kailynn,F,122,2815863,2973
2990,Kinlee,F,122,2815985,2309
2991,Kodi,M,122,2816107,2091
2992,Kross,M,122,2816229,2917
2993,Marlow,F,122,2816351,2304
2994,Neo,M,122,2816473,2023
2995,Nyah,F,122,2816595,2578
2996,Raine,F,122,2816717,2402
2997,Rami,M,122,2816839,2452
2998,Reem,F,122,2816961,2333
2999,Rian,M,122,2817083,2220
3000,Romy,F,122,2817205,3575
3001,Sami,M,122,2817327,3466
3002,Yvette,F,122,2817449,3068
3003,Zaylen,M,122,2817571,3676
3004,Anaiah,F,121,2817692,3475
3005,Braxtyn,M,121,2817813,3515
3006,Brighton,F,121,2817934,3766
3007,Cori,F,121,2818055,3584
3008,Destinee,F,121,2818176,3858
3009,Edson,M,121,2818297,3869
3010,Estefania,F,121,2818418,3934
3011,Jahir,M,121,2818539,3886
3012,Johnathon,M,121,2818660,3719
3013,Keelan,M,121,2818781,3227
3014,Kenai,M,121,2818902,3962
3015,Kent,M,121,2819023,3853
3016,Klayton,M,121,2819144,3230
3017,Kyan,M,121,2819265,3147
3018,Mikah,M,121,2819386,3870
3019,Mikel,M,121,2819507,3824
3020,Quinten,M,121,2819628,3223
3021,Tianna,F,121,2819749,3688
3022,Abrielle,F,120,2819869,3280
3023,Adalie,F,120,2819989,3942
3024,Ammar,M,120,2820109,3652
3025,Angely,F,120,2820229,3419
3026,Arlene,F,120,2820349,3738
3027,Armoni,F,120,2820469,3470
3028,Delanie,F,120,2820589,3207
3029,Elana,F,120,2820709,3372
3030,Elyana,F,120,2820829,3244
3031,Farah,F,120,2820949,3050
3032,Fredrick,M,120,2821069,3016
3033,Irving,M,120,2821189,3150
3034,Jacobi,M,120,2821309,3560
3035,Jamiyah,F,120,2821429,3890
3036,Kaley,F,120,2821549,3067
3037,Levon,M,120,2821669,3224
3038,Lois,F,120,2821789,3821
3039,Montana,F,120,2821909,3335
3040,Samiya,F,120,2822029,3402
3041,Shreya,F,120,2822149,3401
3042,Sire,M,120,2822269,3480
3043,Sybil,F,120,2822389,3206
3044,Aaryan,M,119,2822508,3233
3045,Atarah,F,119,2822627,3186
3046,Cristobal,M,119,2822746,3774
3047,Demari,M,119,2822865,3389
3048,Jacari,M,119,2822984,3019
3049,Jordi,M,119,2823103,3035
3050,Kyah,F,119,2823222,3078
3051,Leticia,F,119,2823341,3547
3052,Lucero,F,119,2823460,3513
3053,Mickey,M,119,2823579,3318
3054,Tariq,M,119,2823698,3536
3055,Teddy,M,119,2823817,3166
3056,Aleigha,F,118,2823935,3282
3057,Amaria,F,118,2824053,3906
3058,Amiracle,F,118,2824171,3684
3059,Aven,M,118,2824289,3585
3060,Blakelee,F,118,2824407,3066
3061,Blakelyn,F,118,2824525,3509
3062,Braylin,M,118,2824643,3321
3063,Brexton,M,118,2824761,3805
3064,Dale,M,118,2824879,3357
3065,Doris,F,118,2824997,3899
3066,Elani,F,118,2825115,3678
3067,Gina,F,118,2825233,3984
3068,Gracyn,F,118,2825351,3752
3069,Ines,F,118,2825469,3370
3070,Isa,M,118,2825587,3115
3071,Karoline,F,118,2825705,3673
3072,Nicolette,F,118,2825823,3237
3073,Rosemarie,F,118,2825941,3927
3074,Samaira,F,118,2826059,3655
3075,Yuri,F,118,2826177,3649
3076,Akshara,F,117,2826294,3348
3077,Alaiah,F,117,2826411,3687
3078,Brice,M,117,2826528,3157
3079,Cattleya,F,117,2826645,3258
3080,Izayah,M,117,2826762,3531
3081,Jaycob,M,117,2826879,3139
3082,Keller,M,117,2826996,3970
3083,Layna,F,117,2827113,3014
3084,Mattias,M,117,2827230,3601
3085,Neal,M,117,2827347,3524
3086,Octavio,M,117,2827464,3749
3087,Odessa,F,117,2827581,3284
3088,Presleigh,F,117,2827698,3057
3089,Rogan,M,117,2827815,3586
3090,Rowdy,M,117,2827932,3895
3091,Auden,M,116,2828048,3939
3092,Lula,F,116,2828164,3985
3093,Malak,F,116,2828280,3254
3094,Marlo,F,116,2828396,3540
3095,Monte,M,116,2828512,3182
3096,Urijah,M,116,2828628,3473
3097,Yazmin,F,116,2828744,3929
3098,Arnold,M,115,2828859,3231
3099,Avion,M,115,2828974,3189
3100,Cambrie,F,115,2829089,3211
3101,Elvin,M,115,2829204,3234
3102,Emmi,F,115,2829319,3500
3103,Gerard,M,115,2829434,3968
3104,Kassius,M,115,2829549,3238
3105,Maliya,F,115,2829664,3208
3106,Nell,F,115,2829779,3964
3107,Niyah,F,115,2829894,3191
3108,Vince,M,115,2830009,3722
3109,Xaiden,M,115,2830124,3887
3110,Zakariya,M,115,2830239,3725
3111,Zayvion,M,115,2830354,3380
3112,Adalina,F,114,2830468,3126
3113,Aditya,M,114,2830582,3131
3114,Aidyn,M,114,2830696,3755
3115,Anneliese,F,114,2830810,3030
3116,Camren,M,114,2830924,3565
3117,Clarke,F,114,2831038,3944
3118,Dev,M,114,2831152,3411
3119,Eliyahu,M,114,2831266,3431
3120,Indy,F,114,2831380,3856
3121,Isabell,F,114,2831494,3913
3122,Ismail,M,114,2831608,3025
3123,Jessiah,M,114,2831722,3353
3124,Julietta,F,114,2831836,3991
3125,Karolina,F,114,2831950,3790
3126,Kenzlee,F,114,2832064,3415
3127,Kylin,M,114,2832178,3875
3128,Lavender,F,114,2832292,3690
3129,Maritza,F,114,2832406,3343
3130,Massimo,M,114,2832520,3364
3131,Nariah,F,114,2832634,3608
3132,Odette,F,114,2832748,3106
3133,Sarina,F,114,2832862,3200
3134,Story,F,114,2832976,3925
3135,Vaeda,F,114,2833090,3196
3136,Zaynab,F,114,2833204,3559
3137,Alek,M,113,2833317,3085
3138,Alya,F,113,2833430,3265
3139,Ashly,F,113,2833543,3388
3140,Blanca,F,113,2833656,3120
3141,Canyon,M,113,2833769,3804
3142,Clint,M,113,2833882,3033
3143,Daria,F,113,2833995,3149
3144,Denisse,F,113,2834108,3443
3145,Devonte,M,113,2834221,3256
3146,Fynn,M,113,2834334,3707
3147,Jakayla,F,113,2834447,3680
3148,Lakyn,F,113,2834560,3285
3149,Lillith,F,113,2834673,3681
3150,Lyndon,M,113,2834786,3729
3151,Mari,F,113,2834899,3243
3152,Moira,F,113,2835012,3864
3153,Phineas,M,113,2835125,3360
3154,Theia,F,113,2835238,3797
3155,Tillie,F,113,2835351,3439
3156,Verity,F,113,2835464,3240
3157,Xyla,F,113,2835577,3434
3158,Yeshua,M,113,2835690,3750
3159,Abdulrahman,M,112,2835802,3331
3160,Amauri,M,112,2835914,3958
3161,Asaiah,M,112,2836026,3920
3162,Braeden,M,112,2836138,3799
3163,Braiden,M,112,2836250,3031
3164,Carol,F,112,2836362,3571
3165,Claira,F,112,2836474,3833
3166,Daylin,F,112,2836586,3668
3167,Donna,F,112,2836698,3101
3168,Elan,M,112,2836810,3155
3169,Emeri,F,112,2836922,3992
3170,Havana,F,112,2837034,3527
3171,Jadon,M,112,2837146,3278
3172,Jaslyn,F,112,2837258,3989
3173,Katia,F,112,2837370,3780
3174,Lela,F,112,2837482,3596
3175,Lillyana,F,112,2837594,3165
3176,Maryn,F,112,2837706,3907
3177,Vernon,M,112,2837818,3123
3178,Yvonne,F,112,2837930,3467
3179,Aizen,M,111,2838041,3436
3180,Anaisha,F,111,2838152,3549
3181,Calla,F,111,2838263,3863
3182,Carmine,M,111,2838374,3595
3183,Glory,F,111,2838485,3222
3184,Harmonie,F,111,2838596,3376
3185,Ilyas,M,111,2838707,3493
3186,Ivaan,M,111,2838818,3794
3187,Jiya,F,111,2838929,3451
3188,Jovan,M,111,2839040,3054
3189,Kacie,F,111,2839151,3055
3190,Kaidence,F,111,2839262,3306
3191,Kiley,F,111,2839373,3993
3192,Liz,F,111,2839484,3216
3193,Lynlee,F,111,2839595,3303
3194,Massiah,M,111,2839706,3897
3195,Raeleigh,F,111,2839817,3098
3196,Ridley,F,111,2839928,3174
3197,Shyla,F,111,2840039,3631
3198,Umar,M,111,2840150,3696
3199,Venus,F,111,2840261,3188
3200,Xochitl,F,111,2840372,3981
3201,Brendon,M,110,2840482,3788
3202,Charlene,F,110,2840592,3259
3203,Cru,M,110,2840702,3325
3204,Dalila,F,110,2840812,3192
3205,Donte,M,110,2840922,3973
3206,Humberto,M,110,2841032,3065
3207,Jarvis,M,110,2841142,3512
3208,Myron,M,110,2841252,3832
3209,Ramses,M,110,2841362,3965
3210,Rosaleigh,F,110,2841472,3816
3211,Scottie,F,110,2841582,3551
3212,Sheldon,M,110,2841692,3048
3213,Siddharth,M,110,2841802,3225
3214,Sir,M,110,2841912,3347
3215,Yerik,M,110,2842022,3034
3216,Anas,M,109,2842131,3781
3217,Danae,F,109,2842240,3593
3218,Eiden,M,109,2842349,3221
3219,Ewan,M,109,2842458,3309
3220,Fatimah,F,109,2842567,3801
3221,Hawa,F,109,2842676,3847
3222,Jannah,F,109,2842785,3400
3223,Jariel,M,109,2842894,3730
3224,Jhett,M,109,2843003,3043
3225,Kaitlynn,F,109,2843112,3702
3226,Kaizer,M,109,2843221,3811
3227,Kynzlee,F,109,2843330,3793
3228,Linus,M,109,2843439,3368
3229,Lux,M,109,2843548,3366
3230,Margarita,F,109,2843657,3562
3231,Ranger,M,109,2843766,3753
3232,Roxana,F,109,2843875,3949
3233,Skylee,F,109,2843984,3718
3234,Yaretzy,F,109,2844093,3003
3235,Zadie,F,109,2844202,3732
3236,Zelie,F,109,2844311,3478
3237,Abdul,M,108,2844419,3290
3238,Amor,F,108,2844527,3413
3239,Analise,F,108,2844635,3773
3240,Austen,M,108,2844743,3393
3241,Blessyn,F,108,2844851,3257
3242,Eitan,M,108,2844959,3172
3243,Iman,F,108,2845067,3862
3244,Izan,M,108,2845175,3311
3245,Jupiter,F,108,2845283,3977
3246,Kaleo,M,108,2845391,3127
3247,Kamren,M,108,2845499,3979
3248,Nariyah,F,108,2845607,3350
3249,Nestor,M,108,2845715,3381
3250,Olin,M,108,2845823,3643
3251,Prudence,F,108,2845931,3255
3252,Shaya,M,108,2846039,3454
3253,Valkyrie,F,108,2846147,3534
3254,Zakaria,M,108,2846255,3609
3255,Ziggy,M,108,2846363,3405
3256,Cienna,F,107,2846470,3771
3257,Cornelius,M,107,2846577,3776
3258,Damarion,M,107,2846684,3097
3259,Daxon,M,107,2846791,3351
3260,Evalina,F,107,2846898,3371
3261,Giovanny,M,107,2847005,3374
3262,Haiden,M,107,2847112,3943
3263,Jaleel,M,107,2847219,3806
3264,Kynnedi,F,107,2847326,3800
3265,Lanie,F,107,2847433,3959
3266,Neriah,F,107,2847540,3422
3267,Nigel,M,107,2847647,3686
3268,Noella,F,107,2847754,3145
3269,Tahlia,F,107,2847861,3570
3270,Unique,F,107,2847968,3846
3271,Viraj,M,107,2848075,3994
3272,Zyair,M,107,2848182,3001
3273,Areli,F,106,2848288,3394
3274,Aylah,F,106,2848394,3506
3275,Barron,M,106,2848500,3135
3276,Emelyn,F,106,2848606,3914
3277,Eros,M,106,2848712,3566
3278,Faris,M,106,2848818,3885
3279,Fern,F,106,2848924,3639
3280,Huxton,M,106,2849030,3328
3281,Johana,F,106,2849136,3040
3282,Kaliah,F,106,2849242,3577
3283,Kamya,F,106,2849348,3428
3284,Kenleigh,F,106,2849454,3867
3285,Kourtney,F,106,2849560,3275
3286,Kyngston,M,106,2849666,3918
3287,Laniyah,F,106,2849772,3142
3288,Laya,F,106,2849878,3710
3289,Leanne,F,106,2849984,3888
3290,Lilyann,F,106,2850090,3514
3291,Loyal,M,106,2850196,3260
3292,Milagros,F,106,2850302,3893
3293,Mona,F,106,2850408,3171
3294,Rhodes,M,106,2850514,3703
3295,Yakov,M,106,2850620,3683
3296,Adah,F,105,2850725,3468
3297,Dezmond,M,105,2850830,3081
3298,Estefany,F,105,2850935,3140
3299,Francesco,M,105,2851040,3272
3300,Gwenyth,F,105,2851145,3879
3301,Honor,F,105,2851250,3077
3302,Jaina,F,105,2851355,3951
3303,Jaxsen,M,105,2851460,3698
3304,Jaya,F,105,2851565,3094
3305,Kaylen,F,105,2851670,3839
3306,Khaled,M,105,2851775,3704
3307,Leigha,F,105,2851880,3792
3308,Lenny,M,105,2851985,3591
3309,Marquise,M,105,2852090,3124
3310,Melodie,F,105,2852195,3960
3311,Navya,F,105,2852300,3338
3312,Orson,M,105,2852405,3769
3313,Pippa,F,105,2852510,3747
3314,Safiya,F,105,2852615,3362
3315,Yariel,M,105,2852720,3589
3316,Angus,M,104,2852824,3323
3317,Ayansh,M,104,2852928,3112
3318,Bellarose,F,104,2853032,3304
3319,Benito,M,104,2853136,3530
3320,Cheyanne,F,104,2853240,3919
3321,Dashiell,M,104,2853344,3146
3322,Davin,M,104,2853448,3615
3323,Eddy,M,104,2853552,3005
3324,Fidel,M,104,2853656,3056
3325,Indiana,F,104,2853760,3075
3326,Iva,F,104,2853864,3176
3327,Izzabella,F,104,2853968,3675
3328,Jalani,F,104,2854072,3297
3329,Karissa,F,104,2854176,3896
3330,Kashmir,M,104,2854280,3251
3331,Kinleigh,F,104,2854384,3070
3332,Kyran,M,104,2854488,3694
3333,Naveah,F,104,2854592,3613
3334,Navi,F,104,2854696,3387
3335,Rilee,F,104,2854800,3779
3336,Rishaan,M,104,2854904,3999
3337,Aislynn,F,103,2855007,3777
3338,Anjali,F,103,2855110,3711
3339,Broderick,M,103,2855213,3505
3340,Clifton,M,103,2855316,3489
3341,Constance,F,103,2855419,3341
3342,Dereck,M,103,2855522,3074
3343,Ender,M,103,2855625,3041
3344,Ervin,M,103,2855728,3632
3345,Josh,M,103,2855831,3448
3346,Juno,F,103,2855934,3803
3347,Kael,M,103,2856037,3132
3348,Kamarion,M,103,2856140,3739
3349,Korben,M,103,2856243,3600
3350,Leni,F,103,2856346,3045
3351,Leopold,M,103,2856449,3544
3352,Malky,F,103,2856552,3865
3353,Milly,F,103,2856655,3508
3354,Naia,F,103,2856758,3641
3355,Noam,M,103,2856861,3305
3356,Perseus,M,103,2856964,3933
3357,Rivky,F,103,2857067,3677
3358,Rudra,M,103,2857170,3941
3359,Storm,F,103,2857273,3786
3360,Yoselin,F,103,2857376,3095
3361,Adalia,F,102,2857478,3215
3362,Adilyn,F,102,2857580,3276
3363,Amila,F,102,2857682,3469
3364,Avalee,F,102,2857784,3061
3365,Dan,M,102,2857886,3607
3366,Emmerson,F,102,2857988,3625
3367,Karly,F,102,2858090,3679
3368,Kelton,M,102,2858192,3263
3369,Kyndal,F,102,2858294,3892
3370,Lucio,M,102,2858396,3092
3371,Marli,F,102,2858498,3510
3372,Mileena,F,102,2858600,3741
3373,Nechama,F,102,2858702,3049
3374,Nehemias,M,102,2858804,3528
3375,Ryley,F,102,2858906,3828
3376,Sammy,M,102,2859008,3472
3377,Steele,M,102,2859110,3938
3378,Sultan,M,102,2859212,3983
3379,Taelyn,F,102,2859314,3882
3380,Taliah,F,102,2859416,3058
3381,Warner,M,102,2859518,3581
3382,Advik,M,101,2859619,3064
3383,Alanis,F,101,2859720,3421
3384,Aram,M,101,2859821,3917
3385,Audree,F,101,2859922,3449
3386,Avani,F,101,2860023,3997
3387,Dora,F,101,2860124,3073
3388,Finnick,M,101,2860225,3954
3389,Kaylyn,F,101,2860326,3598
3390,Kiyan,M,101,2860427,3059
3391,Lloyd,M,101,2860528,3523
3392,Makiyah,F,101,2860629,3634
3393,Maksim,M,101,2860730,3567
3394,Misha,F,101,2860831,3850
3395,Mylee,F,101,2860932,3079
3396,Ren,M,101,2861033,3526
3397,Taylen,M,101,2861134,3219
3398,Aamir,M,100,2861234,3966
3399,Finleigh,F,100,2861334,3798
3400,Hadi,M,100,2861434,3407
3401,Irvin,M,100,2861534,3642
3402,Linden,M,100,2861634,3267
3403,Liya,F,100,2861734,3482
3404,Mayah,F,100,2861834,3213
3405,Mckinlee,F,100,2861934,3986
3406,Riverlyn,F,100,2862034,3873
3407,Stellan,M,100,2862134,3721
3408,Tevin,M,100,2862234,3194
3409,Tina,F,100,2862334,3082
3410,Truth,M,100,2862434,3088
3411,Valor,M,100,2862534,3819
3412,Arman,M,99,2862633,3096
3413,Axell,M,99,2862732,3354
3414,Bridgette,F,99,2862831,3063
3415,Draco,M,99,2862930,3291
3416,Elam,M,99,2863029,3606
3417,Eleanore,F,99,2863128,3250
3418,Joanne,F,99,2863227,3336
3419,Kinzlee,F,99,2863326,3553
3420,Maxon,M,99,2863425,3312
3421,Peighton,F,99,2863524,3060
3422,Salman,M,99,2863623,3198
3423,Sama,F,99,2863722,3759
3424,Samia,F,99,2863821,3446
3425,Shaylee,F,99,2863920,3789
3426,Sonya,F,99,2864019,3937
3427,Amin,M,98,2864117,3477
3428,Anissa,F,98,2864215,3859
3429,Emrys,M,98,2864313,3834
3430,Isaak,M,98,2864411,3152
3431,Jacey,F,98,2864509,3004
3432,Jacklyn,F,98,2864607,3367
3433,Kailany,F,98,2864705,3742
3434,Laynie,F,98,2864803,3002
3435,Liyana,F,98,2864901,3358
3436,Maryann,F,98,2864999,3785
3437,Saif,M,98,2865097,3727
3438,Shai,M,98,2865195,3894
3439,West,M,98,2865293,3891
3440,Zaniya,F,98,2865391,3881
3441,Alanah,F,97,2865488,3252
3442,Arayah,F,97,2865585,3579
3443,Armon,M,97,2865682,3116
3444,Berkeley,F,97,2865779,3838
3445,Boyd,M,97,2865876,3980
3446,Braxten,M,97,2865973,3662
3447,Brisa,F,97,2866070,3716
3448,Bryer,M,97,2866167,3783
3449,Caleigh,F,97,2866264,3660
3450,Cam,M,97,2866361,3740
3451,Chace,M,97,2866458,3118
3452,Hailie,F,97,2866555,3164
3453,Hamish,M,97,2866652,3564
3454,Iyanna,F,97,2866749,3705
3455,Izabel,F,97,2866846,3921
3456,Janiah,F,97,2866943,3664
3457,Johnpaul,M,97,2867040,3546
3458,Jream,F,97,2867137,3685
3459,Jules,M,97,2867234,3517
3460,Karley,F,97,2867331,3931
3461,Karli,F,97,2867428,3614
3462,Kenslee,F,97,2867525,3731
3463,Kurt,M,97,2867622,3408
3464,Lester,M,97,2867719,3814
3465,Trevon,M,97,2867816,3161
3466,Yaneli,F,97,2867913,3130
3467,Zeppelin,M,97,2868010,3488
3468,Aiyanna,F,96,2868106,3857
3469,Ameerah,F,96,2868202,3295
3470,Caliyah,F,96,2868298,3138
3471,Cecil,M,96,2868394,3062
3472,Earl,M,96,2868490,3674
3473,Emmersyn,F,96,2868586,3069
3474,Gryffin,M,96,2868682,3901
3475,Irelynn,F,96,2868778,3583
3476,Jahzara,F,96,2868874,3644
3477,Jailyn,F,96,2868970,3384
3478,Kianna,F,96,2869066,3763
3479,Kip,M,96,2869162,3010
3480,Kit,M,96,2869258,3406
3481,Lynn,F,96,2869354,3214
3482,Maxx,M,96,2869450,3281
3483,Mikhail,M,96,2869546,3498
3484,Neymar,M,96,2869642,3748
3485,Rania,F,96,2869738,3946
3486,Ved,M,96,2869834,3932
3487,Aedan,M,95,2869929,3373
3488,Aiza,F,95,2870024,3117
3489,Alayla,F,95,2870119,3516
3490,Aminata,F,95,2870214,3209
3491,Aoife,F,95,2870309,3795
3492,Arabelle,F,95,2870404,3007
3493,Asahd,M,95,2870499,3640
3494,Audrianna,F,95,2870594,3909
3495,Ayven,M,95,2870689,3936
3496,Braylynn,F,95,2870784,3099
3497,Brigham,M,95,2870879,3308
3498,Camellia,F,95,2870974,3604
3499,Colleen,F,95,2871069,3825
3500,Eila,F,95,2871164,3826
3501,Fred,M,95,2871259,3637
3502,Gerson,M,95,2871354,3187
3503,Hagen,M,95,2871449,3093
3504,Ivanka,F,95,2871544,3784
3505,Loren,F,95,2871639,3199
3506,Malina,F,95,2871734,3802
3507,Mariajose,F,95,2871829,3969
3508,Melia,F,95,2871924,3726
3509,Melinda,F,95,2872019,3812
3510,Mindy,F,95,2872114,3403
3511,Morris,M,95,2872209,3114
3512,Pia,F,95,2872304,3603
3513,Priscila,F,95,2872399,3410
3514,Rivers,M,95,2872494,3499
3515,Shae,F,95,2872589,3868
3516,Thor,M,95,2872684,3521
3517,Tristin,M,95,2872779,3426
3518,Vanellope,F,95,2872874,3743
3519,Xavion,M,95,2872969,3294
3520,Zavion,M,95,2873064,3429
3521,Zayda,F,95,2873159,3915
3522,Analeah,F,94,2873253,3494
3523,Antony,M,94,2873347,3945
3524,Aribella,F,94,2873441,3912
3525,Arran,M,94,2873535,3852
3526,Dayleen,F,94,2873629,3076
3527,Emalyn,F,94,2873723,3235
3528,Emoni,F,94,2873817,3363
3529,Eren,M,94,2873911,3463
3530,Evolet,F,94,2874005,3345
3531,Haidyn,F,94,2874099,3458
3532,Heiress,F,94,2874193,3239
3533,Jaidyn,M,94,2874287,3532
3534,Josephina,F,94,2874381,3667
3535,Luana,F,94,2874475,3619
3536,Maribel,F,94,2874569,3268
3537,Natanael,M,94,2874663,3693
3538,Vito,M,94,2874757,3496
3539,Zayleigh,F,94,2874851,3377
3540,Zymir,M,94,2874945,3982
3541,Alder,M,93,2875038,3022
3542,Alister,M,93,2875131,3717
3543,Alyna,F,93,2875224,3548
3544,Avyan,M,93,2875317,3023
3545,Britney,F,93,2875410,3539
3546,Bryar,M,93,2875503,3808
3547,Cameran,F,93,2875596,3807
3548,Chava,F,93,2875689,3212
3549,Dawsyn,F,93,2875782,3663
3550,Echo,F,93,2875875,3226
3551,Fitzgerald,M,93,2875968,3935
3552,Gauge,M,93,2876061,3269
3553,Gio,M,93,2876154,3670
3554,Hafsa,F,93,2876247,3032
3555,Jaqueline,F,93,2876340,3537
3556,Jaxston,M,93,2876433,3876
3557,Kainoa,M,93,2876526,3708
3558,Karmyn,F,93,2876619,3689
3559,Kavya,F,93,2876712,3210
3560,Kendyl,F,93,2876805,3950
3561,Kiran,M,93,2876898,3830
3562,Lyrica,F,93,2876991,3767
3563,Masen,M,93,2877084,3459
3564,Micaiah,M,93,2877177,3455
3565,Obadiah,M,93,2877270,3026
3566,Raylen,M,93,2877363,3736
3567,Wilmer,M,93,2877456,3102
3568,Ahana,F,92,2877548,3087
3569,Amarie,F,92,2877640,3638
3570,Betsy,F,92,2877732,3151
3571,Braven,M,92,2877824,3572
3572,Cosette,F,92,2877916,3889
3573,Deion,M,92,2878008,3841
3574,Haylie,F,92,2878100,3714
3575,Hiram,M,92,2878192,3021
3576,Jacobo,M,92,2878284,3971
3577,Jaxyn,M,92,2878376,3697
3578,Keoni,M,92,2878468,3261
3579,Kyaire,M,92,2878560,3922
3580,Mackenna,F,92,2878652,3582
3581,Maddix,M,92,2878744,3460
3582,Maverik,M,92,2878836,3957
3583,Maylin,F,92,2878928,3220
3584,Nirvana,F,92,2879020,3136
3585,Xitlali,F,92,2879112,3947
3586,Aaden,M,91,2879203,3386
3587,Abbie,F,91,2879294,3053
3588,Carrie,F,91,2879385,3576
3589,Caydence,F,91,2879476,3168
3590,Chester,M,91,2879567,3518
3591,Delylah,F,91,2879658,3898
3592,Eris,F,91,2879749,3848
3593,Hellen,F,91,2879840,3337
3594,Hussain,M,91,2879931,3159
3595,Jahlil,M,91,2880022,3365
3596,Janylah,F,91,2880113,3441
3597,Jrue,M,91,2880204,3877
3598,Kaelani,F,91,2880295,3911
3599,Khali,F,91,2880386,3578
3600,Klay,M,91,2880477,3651
3601,Lazaro,M,91,2880568,3883
3602,Lluvia,F,91,2880659,3860
3603,Maven,F,91,2880750,3809
3604,Nahomi,F,91,2880841,3404
3605,Philomena,F,91,2880932,3487
3606,Reyan,M,91,2881023,3390
3607,Shania,F,91,2881114,3492
3608,Wylie,M,91,2881205,3430
3609,Yehoshua,M,91,2881296,3418
3610,Amaira,F,90,2881386,3866
3611,Aviva,F,90,2881476,3287
3612,Ayat,F,90,2881566,3361
3613,Ayda,F,90,2881656,3756
3614,Brandt,M,90,2881746,3484
3615,Corban,M,90,2881836,3184
3616,Deonte,M,90,2881926,3926
3617,Edrick,M,90,2882016,3861
3618,Harlynn,F,90,2882106,3588
3619,Isobel,F,90,2882196,3552
3620,Janelly,F,90,2882286,3044
3621,Jannat,F,90,2882376,3751
3622,Jayse,M,90,2882466,3845
3623,Johann,M,90,2882556,3840
3624,Kainen,M,90,2882646,3503
3625,Karam,M,90,2882736,3292
3626,Katy,F,90,2882826,3438
3627,Khelani,F,90,2882916,3568
3628,Khristian,M,90,2883006,3563
3629,Kreed,M,90,2883096,3313
3630,Lacie,F,90,2883186,3148
3631,Lathan,M,90,2883276,3647
3632,Mahogany,F,90,2883366,3125
3633,Makari,M,90,2883456,3392
3634,Mayla,F,90,2883546,3538
3635,Ruaridh,M,90,2883636,3952
3636,Sequoia,F,90,2883726,3665
3637,Sheila,F,90,2883816,3843
3638,Stormie,F,90,2883906,3481
3639,Tiara,F,90,2883996,3930
3640,Yousuf,M,90,2884086,3197
3641,Yuvan,M,90,2884176,3699
3642,Zamira,F,90,2884266,3316
3643,Zamora,F,90,2884356,3815
3644,Ziyah,F,90,2884446,3762
3645,Aiyla,F,89,2884535,3445
3646,Ansh,M,89,2884624,3008
3647,Antwan,M,89,2884713,3417
3648,Aris,M,89,2884802,3273
3649,Avrohom,M,89,2884891,3203
3650,Avyanna,F,89,2884980,3744
3651,Blakelynn,F,89,2885069,3659
3652,Booker,M,89,2885158,3334
3653,Chasity,F,89,2885247,3695
3654,Darby,F,89,2885336,3810
3655,Eiza,F,89,2885425,3279
3656,Ellarose,F,89,2885514,3089
3657,Ellia,F,89,2885603,3612
3658,Emberleigh,F,89,2885692,3071
3659,Fabiola,F,89,2885781,3162
3660,Gisele,F,89,2885870,3854
3661,Hermione,F,89,2885959,3974
3662,Hosanna,F,89,2886048,3622
3663,Jelani,M,89,2886137,3017
3664,Jeriah,M,89,2886226,3916
3665,Judd,M,89,2886315,3556
3666,Kadyn,M,89,2886404,3620
3667,Kasyn,M,89,2886493,3616
3668,Kendal,F,89,2886582,3654
3669,Kylar,M,89,2886671,3761
3670,Lonnie,M,89,2886760,3156
3671,Lovely,F,89,2886849,3163
3672,Maizy,F,89,2886938,3772
3673,Marielle,F,89,2887027,3599
3674,Raizy,F,89,2887116,3346
3675,Sedona,F,89,2887205,3317
3676,Sulaiman,M,89,2887294,3535
3677,Syrus,M,89,2887383,3646
3678,Virgil,M,89,2887472,3745
3679,Witten,M,89,2887561,3218
3680,Zena,F,89,2887650,3587
3681,Afton,F,88,2887738,3855
3682,Amado,M,88,2887826,3555
3683,Arley,M,88,2887914,3733
3684,Arvin,M,88,2888002,3923
3685,Britton,M,88,2888090,3009
3686,Cambree,F,88,2888178,3202
3687,Charleston,F,88,2888266,3396
3688,Citlali,F,88,2888354,3359
3689,Deja,F,88,2888442,3248
3690,Hampton,M,88,2888530,3987
3691,Haniya,F,88,2888618,3083
3692,Jenevieve,F,88,2888706,3817
3693,Kahlil,M,88,2888794,3271
3694,Kanon,M,88,2888882,3027
3695,Kenlee,F,88,2888970,3735
3696,Khyree,M,88,2889058,3286
3697,Lex,M,88,2889146,3246
3698,Magdalene,F,88,2889234,3764
3699,Mars,M,88,2889322,3107
3700,Mauro,M,88,2889410,3144
3701,Mavrick,M,88,2889498,3621
3702,Niamh,F,88,2889586,3645
3703,Oriana,F,88,2889674,3988
3704,Rosalinda,F,88,2889762,3624
3705,Shaurya,M,88,2889850,3995
3706,Sumaya,F,88,2889938,3884
3707,Tyrese,M,88,2890026,3497
3708,Zamari,M,88,2890114,3849
3709,Abriella,F,87,2890201,3369
3710,Aniston,F,87,2890288,3561
3711,Annmarie,F,87,2890375,3397
3712,Asma,F,87,2890462,3648
3713,Avaya,F,87,2890549,3501
3714,Berklee,F,87,2890636,3416
3715,Caia,F,87,2890723,3712
3716,Carli,F,87,2890810,3653
3717,Danni,F,87,2890897,3018
3718,Demir,M,87,2890984,3412
3719,Divine,F,87,2891071,3844
3720,Don,M,87,2891158,3650
3721,Everlie,F,87,2891245,3342
3722,Halima,F,87,2891332,3105
3723,Kalliope,F,87,2891419,3228
3724,Kayne,M,87,2891506,3529
3725,Laia,F,87,2891593,3013
3726,Larkin,F,87,2891680,3902
3727,Malena,F,87,2891767,3617
3728,Malika,F,87,2891854,3851
3729,Masiah,M,87,2891941,3352
3730,Precious,F,87,2892028,3605
3731,Primrose,F,87,2892115,3483
3732,Sebastien,M,87,2892202,3709
3733,Shaan,M,87,2892289,3037
3734,Triniti,F,87,2892376,3636
3735,Zyan,M,87,2892463,3262
3736,Abbas,M,86,2892549,3519
3737,Adelia,F,86,2892635,3051
3738,Alyanna,F,86,2892721,3288
3739,Anisa,F,86,2892807,3820
3740,Avaleigh,F,86,2892893,3319
3741,Braulio,M,86,2892979,3310
3742,Croix,M,86,2893065,3201
3743,Dawn,F,86,2893151,3831
3744,Diesel,M,86,2893237,3491
3745,Drayden,M,86,2893323,3104
3746,Efren,M,86,2893409,3425
3747,Emarie,F,86,2893495,3456
3748,Giuseppe,M,86,2893581,3266
3749,Holt,M,86,2893667,3385
3750,Hoyt,M,86,2893753,3734
3751,Ivar,M,86,2893839,3967
3752,Jamil,M,86,2893925,3545
3753,Jovanny,M,86,2894011,3770
3754,Lotus,F,86,2894097,3525
3755,Markel,M,86,2894183,3775
3756,Nour,F,86,2894269,3340
3757,Shalom,M,86,2894355,3119
3758,Shayna,F,86,2894441,3185
3759,Solana,F,86,2894527,3183
3760,Stryker,M,86,2894613,3626
3761,Tom,M,86,2894699,3024
3762,Triston,M,86,2894785,3574
3763,Winry,F,86,2894871,3296
3764,Wolf,M,86,2894957,3015
3765,Yana,F,86,2895043,3000
3766,Yasmeen,F,86,2895129,3179
3767,Aleen,F,85,2895214,3822
3768,Anabia,F,85,2895299,3452
3769,Asiyah,F,85,2895384,3129
3770,Aubreigh,F,85,2895469,3691
3771,Davi,M,85,2895554,3356
3772,Eliora,F,85,2895639,3320
3773,Finlee,F,85,2895724,3440
3774,Grayden,M,85,2895809,3038
3775,Haizley,F,85,2895894,3330
3776,Isela,F,85,2895979,3768
3777,Jalaya,F,85,2896064,3121
3778,Jaylyn,F,85,2896149,3274
3779,Joie,F,85,2896234,3908
3780,Leander,M,85,2896319,3249
3781,Leyton,M,85,2896404,3193
3782,Merida,F,85,2896489,3190
3783,Oakland,M,85,2896574,3414
3784,Ria,F,85,2896659,3442
3785,Samarah,F,85,2896744,3823
3786,Selma,F,85,2896829,3180
3787,Shamar,M,85,2896914,3181
3788,Shia,M,85,2896999,3835
3789,Stori,F,85,2897084,3541
3790,Taylin,F,85,2897169,3953
3791,Yunus,M,85,2897254,3012
3792,Zayna,F,85,2897339,3940
3793,Adleigh,F,84,2897423,3904
3794,Aeris,F,84,2897507,3479
3795,Ailany,F,84,2897591,3872
3796,Alyse,F,84,2897675,3713
3797,Andromeda,F,84,2897759,3039
3798,Asiah,M,84,2897843,3141
3799,Aubriana,F,84,2897927,3754
3800,Carissa,F,84,2898011,3474
3801,Coco,F,84,2898095,3504
3802,Constantine,M,84,2898179,3028
3803,Desire,F,84,2898263,3433
3804,Eowyn,F,84,2898347,3314
3805,Fredy,M,84,2898431,3091
3806,Jaeden,M,84,2898515,3264
3807,Josey,F,84,2898599,3242
3808,Justyce,F,84,2898683,3618
3809,Kiyah,F,84,2898767,3903
3810,Koby,M,84,2898851,3398
3811,Miabella,F,84,2898935,3813
3812,Niya,F,84,2899019,3435
3813,Rebel,F,84,2899103,3471
3814,Sidra,F,84,2899187,3723
3815,Simcha,M,84,2899271,3791
3816,Theodor,M,84,2899355,3173
3817,Tiberius,M,84,2899439,3669
3818,Abdirahman,M,83,2899522,3520
3819,Auri,F,83,2899605,3217
3820,Calder,M,83,2899688,3465
3821,Catarina,F,83,2899771,3383
3822,Dafne,F,83,2899854,3072
3823,Dianna,F,83,2899937,3195
3824,Eliette,F,83,2900020,3543
3825,Elysia,F,83,2900103,3671
3826,Emori,F,83,2900186,3084
3827,Eryn,F,83,2900269,3658
3828,Graycen,M,83,2900352,3495
3829,Greer,F,83,2900435,3232
3830,Harmonee,F,83,2900518,3170
3831,Hendrick,M,83,2900601,3956
3832,Hussein,M,83,2900684,3420
3833,Isael,M,83,2900767,3409
3834,Ishan,M,83,2900850,3558
3835,Jennings,M,83,2900933,3355
3836,Khylan,M,83,2901016,3827
3837,Korey,M,83,2901099,3378
3838,Kris,M,83,2901182,3289
3839,Lua,F,83,2901265,3672
3840,Marwa,F,83,2901348,3134
3841,Minerva,F,83,2901431,3379
3842,Savion,M,83,2901514,3682
3843,Terra,F,83,2901597,3502
3844,Zaine,M,83,2901680,3462
3845,Aditi,F,82,2901762,3990
3846,Aliyana,F,82,2901844,3111
3847,Ani,F,82,2901926,3758
3848,Annamarie,F,82,2902008,3395
3849,Bracha,F,82,2902090,3630
3850,Brie,F,82,2902172,3507
3851,Chosen,M,82,2902254,3590
3852,Debora,F,82,2902336,3315
3853,Eternity,F,82,2902418,3998
3854,Fischer,M,82,2902500,3996
3855,Hennessy,F,82,2902582,3293
3856,Ilana,F,82,2902664,3580
3857,Ileana,F,82,2902746,3447
3858,Jaceon,M,82,2902828,3635
3859,Joana,F,82,2902910,3837
3860,Lake,M,82,2902992,3746
3861,Lamont,M,82,2903074,3787
3862,Mahdi,M,82,2903156,3522
3863,Marko,M,82,2903238,3169
3864,Oden,M,82,2903320,3874
3865,Rigoberto,M,82,2903402,3382
3866,Ronaldo,M,82,2903484,3978
3867,Ruhi,F,82,2903566,3247
3868,Taniyah,F,82,2903648,3760
3869,Yolanda,F,82,2903730,3110
3870,Abbey,F,81,2903811,3778
3871,Adara,F,81,2903892,3437
3872,Aeson,M,81,2903973,3300
3873,Amyah,F,81,2904054,3277
3874,Ania,F,81,2904135,3375
3875,Annalia,F,81,2904216,3042
3876,Azlynn,F,81,2904297,3329
3877,Brea,F,81,2904378,3975
3878,Brogan,M,81,2904459,3955
3879,Cove,M,81,2904540,3086
3880,Desirae,F,81,2904621,3029
3881,Donnie,M,81,2904702,3706
3882,Emmit,M,81,2904783,3205
3883,Hayleigh,F,81,2904864,3283
3884,Hazen,M,81,2904945,3324
3885,Hernan,M,81,2905026,3108
3886,Jorden,M,81,2905107,3080
3887,Kaizen,M,81,2905188,3476
3888,Kinsey,F,81,2905269,3344
3889,Kyden,M,81,2905350,3818
3890,Lani,F,81,2905431,3924
3891,Legaci,F,81,2905512,3728
3892,Leora,F,81,2905593,3569
3893,Louella,F,81,2905674,3511
3894,Maeva,F,81,2905755,3782
3895,Mayte,F,81,2905836,3100
3896,Mayzie,F,81,2905917,3490
3897,Neel,M,81,2905998,3656
3898,Osiel,M,81,2906079,3633
3899,Paizlee,F,81,2906160,3542
3900,Reilly,F,81,2906241,3137
3901,Rush,M,81,2906322,3302
3902,Serene,F,81,2906403,3113
3903,Taylee,F,81,2906484,3423
3904,Yohan,M,81,2906565,3486
3905,Zemira,F,81,2906646,3109
3906,Zyion,M,81,2906727,3871
3907,Abdulaziz,M,80,2906807,3550
3908,Acelynn,F,80,2906887,3629
3909,Adnan,M,80,2906967,3307
3910,Aleyda,F,80,2907047,3298
3911,Analiyah,F,80,2907127,3229
3912,Ariyanna,F,80,2907207,3332
3913,Atley,F,80,2907287,3597
3914,Branch,M,80,2907367,3757
3915,Dandre,M,80,2907447,3910
3916,Fraser,M,80,2907527,3432
3917,Gene,M,80,2907607,3128
3918,Hashim,M,80,2907687,3006
3919,Hayven,F,80,2907767,3905
3920,Hollie,F,80,2907847,3594
3921,Iyana,F,80,2907927,3154
3922,Jaci,F,80,2908007,3399
3923,Jaquan,M,80,2908087,3457
3924,Jionni,M,80,2908167,3661
3925,Jiselle,F,80,2908247,3204
3926,Josef,M,80,2908327,3461
3927,Kalen,M,80,2908407,3333
3928,Kaniyah,F,80,2908487,3611
3929,Keylor,M,80,2908567,3011
3930,Kiyomi,F,80,2908647,3301
3931,Klynn,F,80,2908727,3464
3932,Laci,F,80,2908807,3963
3933,Laina,F,80,2908887,3122
3934,Leen,F,80,2908967,3299
3935,Maddilyn,F,80,2909047,3657
3936,Mishka,F,80,2909127,3692
3937,Naim,M,80,2909207,3976
3938,Omer,M,80,2909287,3178
3939,Ozzie,M,80,2909367,3177
3940,Pranav,M,80,2909447,3047
3941,Rachael,F,80,2909527,3339
3942,Riker,M,80,2909607,3020
3943,Rosabella,F,80,2909687,3175
3944,Sabastian,M,80,2909767,3391
3945,Samaya,F,80,2909847,3158
3946,Sonja,F,80,2909927,3900
3947,Susana,F,80,2910007,3602
3948,Zaidyn,M,80,2910087,3450
3949,Aalayah,F,79,2910166,3724
3950,Abe,M,79,2910245,3666
3951,Adrielle,F,79,2910324,3245
3952,Aira,F,79,2910403,3533
3953,Amen,M,79,2910482,3842
3954,Annalynn,F,79,2910561,3427
3955,Avni,F,79,2910640,3720
3956,Berenice,F,79,2910719,3241
3957,Charly,F,79,2910798,3700
3958,Cianna,F,79,2910877,3453
3959,Coralie,F,79,2910956,3948
3960,Domenic,M,79,2911035,3485
3961,Edna,F,79,2911114,3133
3962,Edric,M,79,2911193,3327
3963,Eyad,M,79,2911272,3036
3964,Hamilton,M,79,2911351,3592
3965,Issabella,F,79,2911430,3836
3966,Ivette,F,79,2911509,3829
3967,Izaac,M,79,2911588,3103
3968,Jasir,M,79,2911667,3153
3969,Kamaria,F,79,2911746,3444
3970,Mariel,F,79,2911825,3322
3971,Nolen,M,79,2911904,3270
3972,Nyasia,F,79,2911983,3878
3973,Sai,M,79,2912062,3765
3974,Tamir,M,79,2912141,3557
3975,Tyce,M,79,2912220,3326
3976,Agatha,F,78,2912298,3052
3977,Akiva,M,78,2912376,3623
3978,Alyana,F,78,2912454,3715
3979,Arin,M,78,2912532,3349
3980,Aylani,F,78,2912610,3167
3981,Caelum,M,78,2912688,3090
3982,Dashawn,M,78,2912766,3424
3983,Ellington,F,78,2912844,3160
3984,Elton,M,78,2912922,3236
3985,Elyza,F,78,2913000,3928
3986,Estevan,M,78,2913078,3627
3987,Jayne,F,78,2913156,3701
3988,Joi,F,78,2913234,3143
3989,Kiari,F,78,2913312,3573
3990,Kyrah,F,78,2913390,3554
3991,Laiken,F,78,2913468,3737
3992,Maelee,F,78,2913546,3628
3993,Mahir,M,78,2913624,3961
3994,Marcelino,M,78,2913702,3972
3995,Marguerite,F,78,2913780,3796
3996,Marianne,F,78,2913858,3880
3997,Mirabelle,F,78,2913936,3610
3998,Ofelia,F,78,2914014,3253
3999,Renley,F,78,2914092,3046
4000,Rocio,F,78,2914170,4558
4001,Sahasra,F,78,2914248,4909
4002,Shaindy,F,78,2914326,4413
4003,Tanya,F,78,2914404,4044
4004,Tobin,M,78,2914482,4090
4005,Tytus,M,78,2914560,4089
4006,Vania,F,78,2914638,4409
4007,Wendell,M,78,2914716,4563
4008,Ahlani,F,77,2914793,4869
4009,Ahuva,F,77,2914870,4478
4010,Ajay,M,77,2914947,4423
4011,Anvi,F,77,2915024,4318
4012,Aulani,F,77,2915101,4756
4013,Aziyah,F,77,2915178,4032
4014,Brigid,F,77,2915255,4100
4015,Caine,M,77,2915332,4138
4016,Daxtyn,M,77,2915409,4309
4017,Delani,F,77,2915486,4308
4018,Dwight,M,77,2915563,4191
4019,Ellisyn,F,77,2915640,4958
4020,Emree,F,77,2915717,4435
4021,Evelin,F,77,2915794,4453
4022,Fatoumata,F,77,2915871,4124
4023,Hansel,M,77,2915948,4391
4024,Henrietta,F,77,2916025,4368
4025,Ignatius,M,77,2916102,4942
4026,Innes,M,77,2916179,4536
4027,Iqra,F,77,2916256,4779
4028,Iverson,M,77,2916333,4347
4029,Jamel,M,77,2916410,4621
4030,Jaron,M,77,2916487,4459
4031,Juanita,F,77,2916564,4802
4032,Kingstyn,M,77,2916641,4520
4033,Kyara,F,77,2916718,4411
4034,Laynee,F,77,2916795,4216
4035,Lexa,F,77,2916872,4031
4036,Maddex,M,77,2916949,4324
4037,Maiya,F,77,2917026,4893
4038,Malcom,M,77,2917103,4256
4039,Marla,F,77,2917180,4051
4040,Mildred,F,77,2917257,4170
4041,Paizley,F,77,2917334,4837
4042,Raelee,F,77,2917411,4405
4043,Riot,M,77,2917488,4403
4044,Roscoe,M,77,2917565,4437
4045,Saira,F,77,2917642,4247
4046,Samarth,M,77,2917719,4818
4047,Sandy,F,77,2917796,4548
4048,Sora,F,77,2917873,4239
4049,Swara,F,77,2917950,4562
4050,Teegan,F,77,2918027,4660
4051,Terence,M,77,2918104,4626
4052,Wednesday,F,77,2918181,4597
4053,Xavi,M,77,2918258,4276
4054,Yash,M,77,2918335,4993
4055,Yazan,M,77,2918412,4161
4056,Yulissa,F,77,2918489,4078
4057,Adore,F,76,2918565,4791
4058,Ahaan,M,76,2918641,4887
4059,Ameena,F,76,2918717,4043
4060,Arnav,M,76,2918793,4292
4061,Azaiah,M,76,2918869,4253
4062,Benji,M,76,2918945,4068
4063,Damoni,M,76,2919021,4774
4064,Demarion,M,76,2919097,4990
4065,Devan,M,76,2919173,4569
4066,Eimy,F,76,2919249,4361
4067,Elliotte,F,76,2919325,4962
4068,Esmee,F,76,2919401,4729
4069,Floyd,M,76,2919477,4054
4070,Janna,F,76,2919553,4773
4071,Jayven,M,76,2919629,4059
4072,Kambree,F,76,2919705,4355
4073,Karmelo,M,76,2919781,4258
4074,Kelsi,F,76,2919857,4843
4075,Khaliyah,F,76,2919933,4475
4076,Lucianna,F,76,2920009,4186
4077,Marshawn,M,76,2920085,4638
4078,Nate,M,76,2920161,4455
4079,Orin,M,76,2920237,4515
4080,Sanaya,F,76,2920313,4490
4081,Stephany,F,76,2920389,4627
4082,Woodrow,M,76,2920465,4747
4083,Zacari,M,76,2920541,4428
4084,Zailey,F,76,2920617,4922
4085,Zari,F,76,2920693,4320
4086,Zofia,F,76,2920769,4635
4087,Aaradhya,F,75,2920844,4173
4088,Abdullahi,M,75,2920919,4831
4089,Adalynne,F,75,2920994,4181
4090,Adella,F,75,2921069,4267
4091,Agastya,M,75,2921144,4517
4092,Amerie,F,75,2921219,4820
4093,Amorah,F,75,2921294,4232
4094,Annemarie,F,75,2921369,4219
4095,Atlee,F,75,2921444,4397
4096,Blakeley,F,75,2921519,4903
4097,Bodi,M,75,2921594,4899
4098,Branden,M,75,2921669,4661
4099,Coralee,F,75,2921744,4793
4100,Cordell,M,75,2921819,4275
4101,Daylan,M,75,2921894,4035
4102,Domingo,M,75,2921969,4396
4103,Edmond,M,75,2922044,4755
4104,Eidan,M,75,2922119,4432
4105,Giorgio,M,75,2922194,4857
4106,Isra,F,75,2922269,4780
4107,Jesslyn,F,75,2922344,4599
4108,Jia,F,75,2922419,4208
4109,Josefina,F,75,2922494,4145
4110,Kaedyn,M,75,2922569,4288
4111,Kage,M,75,2922644,4140
4112,Kalayah,F,75,2922719,4177
4113,Kirk,M,75,2922794,4131
4114,Leviathan,M,75,2922869,4223
4115,Lexington,M,75,2922944,4663
4116,Marbella,F,75,2923019,4588
4117,Marcell,M,75,2923094,4350
4118,Maximillian,M,75,2923169,4649
4119,Nakoa,M,75,2923244,4418
4120,Nava,F,75,2923319,4166
4121,Reva,F,75,2923394,4524
4122,Rihaan,M,75,2923469,4826
4123,Skarlett,F,75,2923544,4714
4124,Stacey,F,75,2923619,4866
4125,Stephon,M,75,2923694,4163
4126,Taysom,M,75,2923769,4972
4127,Timber,F,75,2923844,4442
4128,Xavian,M,75,2923919,4106
4129,Yousif,M,75,2923994,4488
4130,Zabdiel,M,75,2924069,4876
4131,Zipporah,F,75,2924144,4617
4132,Acacia,F,74,2924218,4004
4133,Anaiyah,F,74,2924292,4864
4134,Aurelius,M,74,2924366,4472
4135,Brennen,M,74,2924440,4719
4136,Charm,F,74,2924514,4375
4137,Corina,F,74,2924588,4158
4138,Draya,F,74,2924662,4263
4139,Elisheva,F,74,2924736,4146
4140,Ezlyn,F,74,2924810,4895
4141,Flint,M,74,2924884,4298
4142,Glen,M,74,2924958,4310
4143,Gracen,M,74,2925032,4311
4144,Hyrum,M,74,2925106,4152
4145,Jamya,F,74,2925180,4126
4146,Jayleigh,F,74,2925254,4645
4147,Kasper,M,74,2925328,4064
4148,Kathy,F,74,2925402,4058
4149,Kelis,F,74,2925476,4293
4150,Kennadi,F,74,2925550,4571
4151,Klaire,F,74,2925624,4066
4152,Konrad,M,74,2925698,4270
4153,Lillyann,F,74,2925772,4334
4154,Manolo,M,74,2925846,4071
4155,Marlin,M,74,2925920,4519
4156,Murray,M,74,2925994,4340
4157,Naira,F,74,2926068,4063
4158,Neve,F,74,2926142,4978
4159,Nika,F,74,2926216,4538
4160,Nile,M,74,2926290,4698
4161,Riyan,M,74,2926364,4497
4162,Romi,F,74,2926438,4526
4163,Sylvester,M,74,2926512,4305
4164,Tenzin,M,74,2926586,4733
4165,Trae,M,74,2926660,4871
4166,Treyvon,M,74,2926734,4029
4167,Willem,M,74,2926808,4057
4168,Yehudis,F,74,2926882,4573
4169,Zylah,F,74,2926956,4752
4170,Abilene,F,73,2927029,4076
4171,Aleida,F,73,2927102,4566
4172,Aleya,F,73,2927175,4556
4173,Alyza,F,73,2927248,4651
4174,Arianny,F,73,2927321,4255
4175,Aryn,F,73,2927394,4799
4176,Avett,M,73,2927467,4936
4177,Avia,F,73,2927540,4585
4178,Ayub,M,73,2927613,4445
4179,Azlan,M,73,2927686,4708
4180,Breck,M,73,2927759,4196
4181,Chayce,M,73,2927832,4710
4182,Copeland,M,73,2927905,4877
4183,Daryl,M,73,2927978,4854
4184,Deshaun,M,73,2928051,4149
4185,Everette,M,73,2928124,4910
4186,Gavriel,M,73,2928197,4499
4187,Hawkins,M,73,2928270,4723
4188,Inez,F,73,2928343,4351
4189,Issa,M,73,2928416,4070
4190,Kanaan,M,73,2928489,4026
4191,Krue,M,73,2928562,4365
4192,Kynsley,F,73,2928635,4586
4193,Miamor,F,73,2928708,4302
4194,Mohamad,M,73,2928781,4745
4195,Muhammed,M,73,2928854,4000
4196,Nella,F,73,2928927,4003
4197,Nichole,F,73,2929000,4813
4198,Nikki,F,73,2929073,4021
4199,Norma,F,73,2929146,4228
4200,Rayla,F,73,2929219,4521
4201,Roxanna,F,73,2929292,4360
4202,Samar,M,73,2929365,4501
4203,Selim,M,73,2929438,4271
4204,Shayan,M,73,2929511,4498
4205,Slater,M,73,2929584,4771
4206,Summit,M,73,2929657,4592
4207,Tesla,F,73,2929730,4272
4208,Theadora,F,73,2929803,4549
4209,Tracy,F,73,2929876,4125
4210,Treyson,M,73,2929949,4101
4211,Westen,M,73,2930022,4153
4212,Aharon,M,72,2930094,4168
4213,Alexandro,M,72,2930166,4201
4214,Amaziah,M,72,2930238,4200
4215,Anayeli,F,72,2930310,4500
4216,Andrei,M,72,2930382,4555
4217,Annalisa,F,72,2930454,4321
4218,Aveline,F,72,2930526,4513
4219,Azeneth,F,72,2930598,4010
4220,Cy,M,72,2930670,4949
4221,Deasia,F,72,2930742,4670
4222,Diane,F,72,2930814,4634
4223,Dua,F,72,2930886,4815
4224,Eldon,M,72,2930958,4850
4225,Eliyah,F,72,2931030,4859
4226,Elli,F,72,2931102,4959
4227,Esai,M,72,2931174,4781
4228,Eshaal,F,72,2931246,4306
4229,Evianna,F,72,2931318,4861
4230,Flor,F,72,2931390,4600
4231,Haya,F,72,2931462,4664
4232,Herman,M,72,2931534,4749
4233,Iona,F,72,2931606,4136
4234,Javian,M,72,2931678,4695
4235,Jawad,M,72,2931750,4987
4236,Jaydan,M,72,2931822,4280
4237,Jayna,F,72,2931894,4880
4238,Jayvon,M,72,2931966,4516
4239,Kalli,F,72,2932038,4159
4240,Karol,F,72,2932110,4628
4241,Karsten,M,72,2932182,4204
4242,Kaylah,F,72,2932254,4178
4243,Kayleb,M,72,2932326,4112
4244,Kenzleigh,F,72,2932398,4882
4245,Kingsten,M,72,2932470,4380
4246,Leana,F,72,2932542,4613
4247,Lemuel,M,72,2932614,4476
4248,Leya,F,72,2932686,4686
4249,Lynleigh,F,72,2932758,4398
4250,Mabry,F,72,2932830,4049
4251,Marlena,F,72,2932902,4072
4252,Marta,F,72,2932974,4211
4253,Maylani,F,72,2933046,4785
4254,Minnie,F,72,2933118,4222
4255,Oona,F,72,2933190,4061
4256,Ransom,M,72,2933262,4111
4257,Razan,F,72,2933334,4933
4258,Sury,F,72,2933406,4652
4259,Susie,F,72,2933478,4481
4260,Taha,M,72,2933550,4913
4261,Townes,M,72,2933622,4017
4262,Wynn,M,72,2933694,4080
4263,Yasiel,M,72,2933766,4151
4264,Yisrael,M,72,2933838,4002
4265,Zariya,F,72,2933910,4632
4266,Advaith,M,71,2933981,4955
4267,Alexandre,M,71,2934052,4619
4268,Amadeus,M,71,2934123,4427
4269,Analy,F,71,2934194,4867
4270,Aniah,F,71,2934265,4199
4271,Aryia,F,71,2934336,4800
4272,Avayah,F,71,2934407,4425
4273,Avian,M,71,2934478,4618
4274,Avigail,F,71,2934549,4218
4275,Avonlea,F,71,2934620,4296
4276,Basil,M,71,2934691,4244
4277,Batsheva,F,71,2934762,4095
4278,Brynnley,F,71,2934833,4534
4279,Champion,M,71,2934904,4522
4280,Chelsey,F,71,2934975,4772
4281,Collette,F,71,2935046,4721
4282,Damani,M,71,2935117,4642
4283,Dasha,F,71,2935188,4865
4284,Gretchen,F,71,2935259,4605
4285,Grettel,F,71,2935330,4824
4286,Heriberto,M,71,2935401,4342
4287,Honesti,F,71,2935472,4601
4288,Jeronimo,M,71,2935543,4116
4289,Johnnie,M,71,2935614,4712
4290,Kamiah,F,71,2935685,4033
4291,Lucah,M,71,2935756,4798
4292,Magaly,F,71,2935827,4415
4293,Maleigha,F,71,2935898,4897
4294,Marquez,M,71,2935969,4734
4295,Mendel,M,71,2936040,4327
4296,Mordecai,M,71,2936111,4135
4297,Nahomy,F,71,2936182,4875
4298,Olympia,F,71,2936253,4082
4299,Patricio,M,71,2936324,4367
4300,Rafe,M,71,2936395,4467
4301,Reef,M,71,2936466,4287
4302,Rylei,F,71,2936537,4565
4303,Sabina,F,71,2936608,4611
4304,Savanah,F,71,2936679,4326
4305,Shyanne,F,71,2936750,4093
4306,Sunnie,F,71,2936821,4417
4307,Tremaine,M,71,2936892,4974
4308,Uma,F,71,2936963,4192
4309,Vanya,F,71,2937034,4673
4310,Violett,F,71,2937105,4852
4311,Zachery,M,71,2937176,4690
4312,Aavya,F,70,2937246,4440
4313,Adalyne,F,70,2937316,4656
4314,Alias,M,70,2937386,4983
4315,Ameliah,F,70,2937456,4683
4316,Anora,F,70,2937526,4133
4317,Archibald,M,70,2937596,4202
4318,Arion,M,70,2937666,4693
4319,Averly,F,70,2937736,4484
4320,Cailyn,F,70,2937806,4162
4321,Daelyn,F,70,2937876,4587
4322,Demetri,M,70,2937946,4706
4323,Dewayne,M,70,2938016,4338
4324,Duane,M,70,2938086,4689
4325,Ely,M,70,2938156,4682
4326,Emmylou,F,70,2938226,4259
4327,Esdras,M,70,2938296,4465
4328,Hindy,F,70,2938366,4167
4329,Irelyn,F,70,2938436,4603
4330,Jahari,M,70,2938506,4312
4331,Kamaya,F,70,2938576,4590
4332,Kambrie,F,70,2938646,4137
4333,Kawhi,M,70,2938716,4992
4334,Knight,M,70,2938786,4725
4335,Lacy,F,70,2938856,4020
4336,Loralei,F,70,2938926,4329
4337,Lourdes,F,70,2938996,4640
4338,Manha,F,70,2939066,4337
4339,Nassir,M,70,2939136,4523
4340,Nayomi,F,70,2939206,4038
4341,Rayah,F,70,2939276,4716
4342,Reggie,M,70,2939346,4792
4343,Rosario,F,70,2939416,4176
4344,Sinai,F,70,2939486,4576
4345,Taraji,F,70,2939556,4254
4346,Veronika,F,70,2939626,4537
4347,Yatziri,F,70,2939696,4366
4348,Zyra,F,70,2939766,4462
4349,Adora,F,69,2939835,4817
4350,Amour,F,69,2939904,4965
4351,Andrey,M,69,2939973,4945
4352,Annalyse,F,69,2940042,4085
4353,Aseel,F,69,2940111,4980
4354,Ayce,M,69,2940180,4950
4355,Aylen,F,69,2940249,4479
4356,Burke,M,69,2940318,4504
4357,Caison,M,69,2940387,4578
4358,Candice,F,69,2940456,4018
4359,Charlette,F,69,2940525,4668
4360,Chaz,M,69,2940594,4886
4361,Crawford,M,69,2940663,4822
4362,Ellamae,F,69,2940732,4748
4363,Elyssa,F,69,2940801,4898
4364,Federico,M,69,2940870,4967
4365,Fenix,M,69,2940939,4584
4366,Filip,M,69,2941008,4335
4367,Finnigan,M,69,2941077,4607
4368,Giovonni,M,69,2941146,4821
4369,Jahsiah,M,69,2941215,4213
4370,Jasai,M,69,2941284,4952
4371,Jaycie,F,69,2941353,4014
4372,Jeanette,F,69,2941422,4705
4373,Jed,M,69,2941491,4130
4374,Kaeson,M,69,2941560,4589
4375,Kalaya,F,69,2941629,4702
4376,Kasai,M,69,2941698,4610
4377,Kerrigan,F,69,2941767,4666
4378,Kiersten,F,69,2941836,4704
4379,Klaus,M,69,2941905,4577
4380,Krisha,F,69,2941974,4901
4381,Lars,M,69,2942043,4717
4382,Lenore,F,69,2942112,4369
4383,Liyah,F,69,2942181,4491
4384,Lynnlee,F,69,2942250,4934
4385,Maisey,F,69,2942319,4448
4386,Manuela,F,69,2942388,4551
4387,Matheus,M,69,2942457,4653
4388,Mayer,M,69,2942526,4665
4389,Merci,F,69,2942595,4047
4390,Nihira,F,69,2942664,4009
4391,Om,M,69,2942733,4489
4392,Rahma,F,69,2942802,4896
4393,Romello,M,69,2942871,4888
4394,Sabine,F,69,2942940,4782
4395,Said,M,69,2943009,4165
4396,Shira,F,69,2943078,4739
4397,Trystan,M,69,2943147,4065
4398,Valen,M,69,2943216,4921
4399,Zaida,F,69,2943285,4701
4400,Aaryn,F,68,2943353,4625
4401,Ames,M,68,2943421,4911
4402,Arwa,F,68,2943489,4598
4403,Atalie,F,68,2943557,4768
4404,Athan,M,68,2943625,4964
4405,Azaan,M,68,2943693,4055
4406,Camari,M,68,2943761,4514
4407,Carlton,M,68,2943829,4614
4408,Darell,M,68,2943897,4241
4409,Deven,M,68,2943965,4217
4410,Faiga,F,68,2944033,4045
4411,Georgie,F,68,2944101,4557
4412,Gizelle,F,68,2944169,4947
4413,Iylah,F,68,2944237,4139
4414,Izrael,M,68,2944305,4678
4415,Jacelyn,F,68,2944373,4184
4416,Jaxsyn,M,68,2944441,4908
4417,Jaziah,M,68,2944509,4016
4418,Korie,F,68,2944577,4572
4419,Layah,F,68,2944645,4148
4420,Luci,F,68,2944713,4658
4421,Markell,M,68,2944781,4098
4422,Myracle,F,68,2944849,4853
4423,Niall,M,68,2944917,4657
4424,Novalynn,F,68,2944985,4797
4425,Paulo,M,68,2945053,4532
4426,Quest,M,68,2945121,4938
4427,Riggins,M,68,2945189,4546
4428,Ryu,M,68,2945257,4535
4429,Sariya,F,68,2945325,4751
4430,Sirena,F,68,2945393,4402
4431,Taleah,F,68,2945461,4674
4432,Trisha,F,68,2945529,4341
4433,Tylen,M,68,2945597,4174
4434,Yeimy,F,68,2945665,4825
4435,Aarohi,F,67,2945732,4767
4436,Abella,F,67,2945799,4977
4437,Aja,F,67,2945866,4641
4438,Akram,M,67,2945933,4060
4439,Aleina,F,67,2946000,4902
4440,Alpha,M,67,2946067,4870
4441,Amariana,F,67,2946134,4508
4442,Amaryllis,F,67,2946201,4841
4443,Ambar,F,67,2946268,4809
4444,Anabel,F,67,2946335,4900
4445,Anastacia,F,67,2946402,4848
4446,Ariyana,F,67,2946469,4226
4447,Arlen,M,67,2946536,4370
4448,Artist,M,67,2946603,4970
4449,Azari,F,67,2946670,4881
4450,Berkleigh,F,67,2946737,4313
4451,Bradyn,M,67,2946804,4757
4452,Broly,M,67,2946871,4086
4453,Brystol,F,67,2946938,4212
4454,Caelan,M,67,2947005,4056
4455,Calia,F,67,2947072,4832
4456,Chancellor,M,67,2947139,4464
4457,Coralynn,F,67,2947206,4381
4458,Cristofer,M,67,2947273,4325
4459,Cypress,M,67,2947340,4963
4460,Everlyn,F,67,2947407,4973
4461,Francine,F,67,2947474,4048
4462,Goddess,F,67,2947541,4190
4463,Haziel,M,67,2947608,4469
4464,Hendrik,M,67,2947675,4249
4465,Honey,F,67,2947742,4169
4466,Huda,F,67,2947809,4692
4467,Isis,F,67,2947876,4127
4468,Jackie,F,67,2947943,4790
4469,Jacques,M,67,2948010,4540
4470,Jamia,F,67,2948077,4680
4471,Jaxin,M,67,2948144,4224
4472,Josselyn,F,67,2948211,4496
4473,Justine,F,67,2948278,4473
4474,Kaislee,F,67,2948345,4533
4475,Kaitlin,F,67,2948412,4738
4476,Kalila,F,67,2948479,4444
4477,Kamara,F,67,2948546,4814
4478,Kashtyn,M,67,2948613,4207
4479,Kaylene,F,67,2948680,4735
4480,Lumi,F,67,2948747,4382
4481,Lynette,F,67,2948814,4122
4482,Miguelangel,M,67,2948881,4353
4483,Naftali,M,67,2948948,4835
4484,Nazareth,F,67,2949015,4408
4485,Neva,F,67,2949082,4393
4486,Obed,M,67,2949149,4581
4487,Octavius,M,67,2949216,4001
4488,Orrin,M,67,2949283,4834
4489,Oziel,M,67,2949350,4493
4490,Penn,M,67,2949417,4238
4491,Revan,M,67,2949484,4554
4492,Rockwell,M,67,2949551,4765
4493,Rumi,F,67,2949618,4986
4494,Rylin,F,67,2949685,4699
4495,Ulices,M,67,2949752,4559
4496,Viktoria,F,67,2949819,4720
4497,Yitty,F,67,2949886,4155
4498,Ahmari,M,66,2949952,4104
4499,Alyce,F,66,2950018,4697
4500,Avamarie,F,66,2950084,4492
4501,Aziah,M,66,2950150,4839
4502,Bently,M,66,2950216,4856
4503,Blayne,M,66,2950282,4494
4504,Cai,M,66,2950348,4644
4505,Dave,M,66,2950414,4094
4506,Dayanara,F,66,2950480,4373
4507,Elyanna,F,66,2950546,4265
4508,Hiba,F,66,2950612,4028
4509,Ishanvi,F,66,2950678,4390
4510,Itzae,M,66,2950744,4443
4511,Jahziel,M,66,2950810,4616
4512,Jaila,F,66,2950876,4073
4513,Jamilah,F,66,2950942,4567
4514,Jennie,F,66,2951008,4760
4515,Joni,F,66,2951074,4197
4516,Keilany,F,66,2951140,4731
4517,Kirra,F,66,2951206,4447
4518,Kollins,F,66,2951272,4285
4519,Lavinia,F,66,2951338,4810
4520,Lenna,F,66,2951404,4819
4521,Lizzie,F,66,2951470,4919
4522,Mahmoud,M,66,2951536,4776
4523,Marek,M,66,2951602,4352
4524,Maxson,M,66,2951668,4012
4525,Melisa,F,66,2951734,4234
4526,Raniyah,F,66,2951800,4144
4527,Royale,F,66,2951866,4422
4528,Sabella,F,66,2951932,4929
4529,Sade,F,66,2951998,4102
4530,Sparrow,F,66,2952064,4129
4531,Suleiman,M,66,2952130,4966
4532,Theron,M,66,2952196,4510
4533,Xenia,F,66,2952262,4250
4534,Abelardo,M,65,2952327,4251
4535,Alizah,F,65,2952392,4823
4536,Amyrah,F,65,2952457,4724
4537,Anaiya,F,65,2952522,4545
4538,Angelie,F,65,2952587,4659
4539,Blossom,F,65,2952652,4330
4540,Brookelynn,F,65,2952717,4806
4541,Denali,F,65,2952782,4629
4542,Dontae,M,65,2952847,4315
4543,Eira,F,65,2952912,4229
4544,Eliott,M,65,2952977,4294
4545,Eloisa,F,65,2953042,4412
4546,Emeline,F,65,2953107,4912
4547,Emile,M,65,2953172,4672
4548,Fulton,M,65,2953237,4732
4549,Hadassa,F,65,2953302,4257
4550,Islah,F,65,2953367,4609
4551,Ivie,F,65,2953432,4404
4552,Jordon,M,65,2953497,4182
4553,Katharine,F,65,2953562,4753
4554,Kayley,F,65,2953627,4883
4555,Kensleigh,F,65,2953692,4304
4556,Keshawn,M,65,2953757,4180
4557,Keyon,M,65,2953822,4372
4558,Kolbe,M,65,2953887,4454
4559,Liora,F,65,2953952,4631
4560,Nairobi,F,65,2954017,4195
4561,Nikhil,M,65,2954082,4119
4562,Nikita,M,65,2954147,4024
4563,Ori,M,65,2954212,4406
4564,Pax,M,65,2954277,4077
4565,Ravyn,F,65,2954342,4081
4566,Rayaan,M,65,2954407,4891
4567,Rickey,M,65,2954472,4117
4568,Sheyla,F,65,2954537,4333
4569,Tirzah,F,65,2954602,4227
4570,Tre,M,65,2954667,4700
4571,Vianney,F,65,2954732,4279
4572,Xavien,M,65,2954797,4915
4573,Zamiyah,F,65,2954862,4805
4574,Abhiram,M,64,2954926,4343
4575,Ahad,M,64,2954990,4074
4576,Aj,M,64,2955054,4932
4577,Alea,F,64,2955118,4624
4578,Annaleah,F,64,2955182,4715
4579,Arantza,F,64,2955246,4015
4580,Becca,F,64,2955310,4796
4581,Clive,M,64,2955374,4429
4582,Colston,M,64,2955438,4833
4583,Darrius,M,64,2955502,4775
4584,Devante,M,64,2955566,4210
4585,Dhruva,M,64,2955630,4862
4586,Elanor,F,64,2955694,4461
4587,Ellowyn,F,64,2955758,4920
4588,Emmaleigh,F,64,2955822,4807
4589,Emorie,F,64,2955886,4156
4590,Everhett,M,64,2955950,4034
4591,Ezio,M,64,2956014,4939
4592,Haze,M,64,2956078,4317
4593,Hazley,F,64,2956142,4260
4594,Italia,F,64,2956206,4840
4595,Jairus,M,64,2956270,4198
4596,Jamarcus,M,64,2956334,4999
4597,Jaycion,M,64,2956398,4194
4598,Jaylan,M,64,2956462,4740
4599,Jaysen,M,64,2956526,4141
4600,Jessalyn,F,64,2956590,4583
4601,Joseluis,M,64,2956654,4750
4602,Jru,M,64,2956718,4982
4603,Katya,F,64,2956782,4529
4604,Kennady,F,64,2956846,4872
4605,Kezia,F,64,2956910,4946
4606,Kipton,M,64,2956974,4262
4607,Kobi,M,64,2957038,4851
4608,Krista,F,64,2957102,4233
4609,Lenin,M,64,2957166,4931
4610,Lya,F,64,2957230,4323
4611,Mali,F,64,2957294,4387
4612,Mandy,F,64,2957358,4743
4613,Mera,F,64,2957422,4917
4614,Nahum,M,64,2957486,4984
4615,Nashla,F,64,2957550,4713
4616,Natali,F,64,2957614,4988
4617,Niles,M,64,2957678,4278
4618,Novella,F,64,2957742,4283
4619,Railynn,F,64,2957806,4550
4620,Rena,F,64,2957870,4778
4621,Rhyder,M,64,2957934,4205
4622,Ryah,F,64,2957998,4975
4623,Shiv,M,64,2958062,4245
4624,Susannah,F,64,2958126,4030
4625,Talitha,F,64,2958190,4553
4626,Victory,F,64,2958254,4436
4627,Xayden,M,64,2958318,4889
4628,Yechiel,M,64,2958382,4596
4629,Yonatan,M,64,2958446,4681
4630,Zeina,F,64,2958510,4400
4631,Zuriel,M,64,2958574,4560
4632,Aariz,M,63,2958637,4118
4633,Aayden,M,63,2958700,4525
4634,Allister,M,63,2958763,4579
4635,Anari,F,63,2958826,4109
4636,Armin,M,63,2958889,4630
4637,Auria,F,63,2958952,4711
4638,Azariyah,F,63,2959015,4648
4639,Blakeleigh,F,63,2959078,4316
4640,Briseis,F,63,2959141,4336
4641,Chesney,F,63,2959204,4816
4642,Daemon,M,63,2959267,4407
4643,Everlynn,F,63,2959330,4303
4644,Fitz,M,63,2959393,4995
4645,Gladys,F,63,2959456,4602
4646,Graeme,M,63,2959519,4495
4647,Hawk,M,63,2959582,4154
4648,Huntley,F,63,2959645,4022
4649,Junia,F,63,2959708,4240
4650,Kekoa,M,63,2959771,4531
4651,Khloee,F,63,2959834,4539
4652,Leonie,F,63,2959897,4878
4653,Leonora,F,63,2959960,4855
4654,Lukah,M,63,2960023,4203
4655,Mikhael,M,63,2960086,4981
4656,Mykel,M,63,2960149,4237
4657,Nivaan,M,63,2960212,4456
4658,Olyvia,F,63,2960275,4450
4659,Quadir,M,63,2960338,4269
4660,Quill,M,63,2960401,4463
4661,Raizel,F,63,2960464,4389
4662,Raylon,M,63,2960527,4438
4663,Rileigh,F,63,2960590,4976
4664,Shakur,M,63,2960653,4943
4665,Tayla,F,63,2960716,4916
4666,Ysabella,F,63,2960779,4143
4667,Aahana,F,62,2960841,4424
4668,Aayush,M,62,2960903,4879
4669,Akai,M,62,2960965,4446
4670,Alanni,F,62,2961027,4261
4671,Alastair,M,62,2961089,4564
4672,Analee,F,62,2961151,4503
4673,Analeigh,F,62,2961213,4926
4674,Asad,M,62,2961275,4685
4675,Bauer,M,62,2961337,4206
4676,Brentlee,M,62,2961399,4703
4677,Charisma,F,62,2961461,4307
4678,Conway,M,62,2961523,4623
4679,Deklyn,M,62,2961585,4620
4680,Dempsey,M,62,2961647,4956
4681,Dottie,F,62,2961709,4040
4682,Heston,M,62,2961771,4314
4683,Iver,M,62,2961833,4013
4684,Jacen,M,62,2961895,4252
4685,Joann,F,62,2961957,4754
4686,Kemari,M,62,2962019,4636
4687,Koah,M,62,2962081,4175
4688,Leighla,F,62,2962143,4679
4689,Lupita,F,62,2962205,4568
4690,Malinda,F,62,2962267,4667
4691,Marisa,F,62,2962329,4377
4692,Mayeli,F,62,2962391,4741
4693,Meyer,M,62,2962453,4046
4694,Nalah,F,62,2962515,4050
4695,Omarion,M,62,2962577,4953
4696,Patton,M,62,2962639,4079
4697,Riyaan,M,62,2962701,4132
4698,Rye,M,62,2962763,4344
4699,Samaria,F,62,2962825,4863
4700,Shaina,F,62,2962887,4595
4701,Skai,F,62,2962949,4297
4702,Stuart,M,62,2963011,4468
4703,Tyla,F,62,2963073,4349
4704,Unknown,M,62,2963135,4804
4705,Valentine,M,62,2963197,4801
4706,Wayde,M,62,2963259,4527
4707,Xion,M,62,2963321,4552
4708,Zach,M,62,2963383,4172
4709,Adalind,F,61,2963444,4996
4710,Aislyn,F,61,2963505,4346
4711,Aiyden,M,61,2963566,4345
4712,Alakai,M,61,2963627,4873
4713,Amaiya,F,61,2963688,4892
4714,Aren,M,61,2963749,4053
4715,Aslan,M,61,2963810,4164
4716,Atharva,M,61,2963871,4951
4717,Aylan,M,61,2963932,4419
4718,Ayson,M,61,2963993,4541
4719,Bennet,M,61,2964054,4505
4720,Calli,F,61,2964115,4331
4721,Cerenity,F,61,2964176,4092
4722,Connie,F,61,2964237,4783
4723,Cree,M,61,2964298,4829
4724,Daliyah,F,61,2964359,4591
4725,Devansh,M,61,2964420,4160
4726,Ellyana,F,61,2964481,4452
4727,Fabio,M,61,2964542,4828
4728,Gavyn,M,61,2964603,4794
4729,Hanan,F,61,2964664,4328
4730,Harleen,F,61,2964725,4460
4731,Ike,M,61,2964786,4225
4732,Ilyana,F,61,2964847,4128
4733,Imogene,F,61,2964908,4268
4734,Isidro,M,61,2964969,4075
4735,Izzy,F,61,2965030,4612
4736,Jasleen,F,61,2965091,4968
4737,Javen,M,61,2965152,4431
4738,Jaycen,M,61,2965213,4221
4739,Jensyn,F,61,2965274,4742
4740,Johannes,M,61,2965335,4023
4741,Jozie,F,61,2965396,4067
4742,Kaiah,F,61,2965457,4979
4743,Kamal,M,61,2965518,4291
4744,Keturah,F,61,2965579,4110
4745,Kierra,F,61,2965640,4954
4746,Kylynn,F,61,2965701,4961
4747,Laurence,M,61,2965762,4849
4748,Leann,F,61,2965823,4383
4749,Lexy,F,61,2965884,4512
4750,Livi,F,61,2965945,4248
4751,Lyon,M,61,2966006,4669
4752,Makenzi,F,61,2966067,4414
4753,Makinley,F,61,2966128,4502
4754,Malachai,M,61,2966189,4399
4755,Mamadou,M,61,2966250,4433
4756,Marlei,F,61,2966311,4416
4757,Mattis,M,61,2966372,4777
4758,Mei,F,61,2966433,4574
4759,Morrison,M,61,2966494,4969
4760,Navaeh,F,61,2966555,4604
4761,Nilah,F,61,2966616,4007
4762,Ronen,M,61,2966677,4386
4763,Sofiya,F,61,2966738,4042
4764,Sunshine,F,61,2966799,4096
4765,Tamar,F,61,2966860,4687
4766,Thompson,M,61,2966921,4242
4767,Tyrus,M,61,2966982,4290
4768,Uziel,M,61,2967043,4103
4769,Via,F,61,2967104,4845
4770,Yocheved,F,61,2967165,4727
4771,Zacharias,M,61,2967226,4944
4772,Zackery,M,61,2967287,4376
4773,Zoee,F,61,2967348,4650
4774,Aahil,M,60,2967408,4941
4775,Ainslee,F,60,2967468,4147
4776,Aleksandra,F,60,2967528,4937
4777,Aly,F,60,2967588,4487
4778,Amiri,M,60,2967648,4860
4779,Anay,M,60,2967708,4722
4780,Arisbeth,F,60,2967768,4107
4781,Aruna,F,60,2967828,4231
4782,Azuri,F,60,2967888,4930
4783,Brandi,F,60,2967948,4295
4784,Brigitte,F,60,2968008,4570
4785,Candace,F,60,2968068,4744
4786,Charbel,M,60,2968128,4299
4787,Ciaran,M,60,2968188,4006
4788,Cierra,F,60,2968248,4480
4789,Daksh,M,60,2968308,4142
4790,Eastyn,M,60,2968368,4885
4791,Ellena,F,60,2968428,4036
4792,Elsy,F,60,2968488,4718
4793,Fiorella,F,60,2968548,4359
4794,Fritz,M,60,2968608,4485
4795,Harlen,M,60,2968668,4518
4796,Jacie,F,60,2968728,4766
4797,Jakoby,M,60,2968788,4655
4798,Janai,F,60,2968848,4803
4799,Janaya,F,60,2968908,4844
4800,Jayvian,M,60,2968968,4948
4801,Justina,F,60,2969028,4874
4802,Kassie,F,60,2969088,4677
4803,Kayli,F,60,2969148,4786
4804,Keandre,M,60,2969208,4927
4805,Kensli,F,60,2969268,4471
4806,Kiah,F,60,2969328,4266
4807,Kirsten,F,60,2969388,4770
4808,Leviticus,M,60,2969448,4639
4809,Lyan,M,60,2969508,4339
4810,Mace,M,60,2969568,4662
4811,Maceo,M,60,2969628,4608
4812,Makaio,M,60,2969688,4193
4813,Mathis,M,60,2969748,4108
4814,Meira,F,60,2969808,4426
4815,Montrell,M,60,2969868,4392
4816,Nawal,F,60,2969928,4506
4817,Raylin,F,60,2969988,4052
4818,Rayven,F,60,2970048,4282
4819,Roma,F,60,2970108,4246
4820,Saleh,M,60,2970168,4286
4821,Saraya,F,60,2970228,4482
4822,Sianna,F,60,2970288,4041
4823,Sunni,F,60,2970348,4769
4824,Syre,M,60,2970408,4842
4825,Takoda,M,60,2970468,4025
4826,Vianna,F,60,2970528,4884
4827,Zaden,M,60,2970588,4281
4828,Abdallah,M,59,2970647,4827
4829,Abigayle,F,59,2970706,4684
4830,Adriano,M,59,2970765,4606
4831,Alaa,F,59,2970824,4243
4832,Alayiah,F,59,2970883,4449
4833,Aleister,M,59,2970942,4868
4834,Aniylah,F,59,2971001,4594
4835,Artem,M,59,2971060,4675
4836,Augustin,M,59,2971119,4858
4837,Bayron,M,59,2971178,4183
4838,Beauden,M,59,2971237,4358
4839,Becky,F,59,2971296,4789
4840,Bobbi,F,59,2971355,4171
4841,Carsten,M,59,2971414,4348
4842,Cattaleya,F,59,2971473,4441
4843,Chany,F,59,2971532,4935
4844,Christy,F,59,2971591,4134
4845,Clarity,F,59,2971650,4421
4846,Conley,M,59,2971709,4671
4847,Cristal,F,59,2971768,4547
4848,Daquan,M,59,2971827,4364
4849,Daylon,M,59,2971886,4083
4850,Divinity,F,59,2971945,4385
4851,Elvira,F,59,2972004,4220
4852,Emeric,M,59,2972063,4914
4853,Emmanuella,F,59,2972122,4726
4854,Emmery,F,59,2972181,4264
4855,Gillian,F,59,2972240,4439
4856,Hania,F,59,2972299,4430
4857,Indi,F,59,2972358,4746
4858,Isreal,M,59,2972417,4458
4859,Jadore,F,59,2972476,4561
4860,Jaslynn,F,59,2972535,4410
4861,Jaydah,F,59,2972594,4113
4862,Jessi,F,59,2972653,4905
4863,Johnson,M,59,2972712,4388
4864,Juanpablo,M,59,2972771,4215
4865,Kaito,M,59,2972830,4371
4866,Kalena,F,59,2972889,4811
4867,Kamran,M,59,2972948,4069
4868,Katana,F,59,2973007,4466
4869,Keion,M,59,2973066,4643
4870,Kollyns,F,59,2973125,4062
4871,Kristine,F,59,2973184,4737
4872,Layken,F,59,2973243,4542
4873,Leigh,F,59,2973302,4582
4874,Maddyn,F,59,2973361,4575
4875,Masyn,M,59,2973420,4356
4876,Oaklen,M,59,2973479,4615
4877,Octavian,M,59,2973538,4998
4878,Rachelle,F,59,2973597,4189
4879,Riverlynn,F,59,2973656,4363
4880,Ruairidh,M,59,2973715,4730
4881,Sakura,F,59,2973774,4121
4882,Samirah,F,59,2973833,4691
4883,Scotlyn,F,59,2973892,4091
4884,Sunday,F,59,2973951,4420
4885,Tyshawn,M,59,2974010,4087
4886,Waylan,M,59,2974069,4906
4887,Yandel,M,59,2974128,4812
4888,Yohana,F,59,2974187,4985
4889,Yuvraj,M,59,2974246,4830
4890,Adlee,F,58,2974304,4530
4891,Alayia,F,58,2974362,4274
4892,Alize,F,58,2974420,4115
4893,Annalyn,F,58,2974478,4763
4894,Antoinette,F,58,2974536,4764
4895,Ashlee,F,58,2974594,4736
4896,Audrie,F,58,2974652,4179
4897,Avarie,F,58,2974710,4795
4898,Aveer,M,58,2974768,4654
4899,Averee,F,58,2974826,4924
4900,Brant,M,58,2974884,4633
4901,Camiyah,F,58,2974942,4762
4902,Daniyah,F,58,2975000,4543
4903,Deniz,M,58,2975058,4011
4904,Effie,F,58,2975116,4709
4905,Emaan,F,58,2975174,4925
4906,Enoc,M,58,2975232,4284
4907,Eugenia,F,58,2975290,4507
4908,Everardo,M,58,2975348,4474
4909,Evette,F,58,2975406,4637
4910,Gareth,M,58,2975464,4277
4911,Illiana,F,58,2975522,4696
4912,Jamiya,F,58,2975580,4027
4913,Job,M,58,2975638,4209
4914,Juancarlos,M,58,2975696,4593
4915,Kelsea,F,58,2975754,4289
4916,Kory,M,58,2975812,4646
4917,Lively,F,58,2975870,4470
4918,Madelyne,F,58,2975928,4846
4919,Madisson,F,58,2975986,4332
4920,Marius,M,58,2976044,4787
4921,Miliana,F,58,2976102,4379
4922,Neev,M,58,2976160,4357
4923,Nyle,M,58,2976218,4647
4924,Oshea,M,58,2976276,4707
4925,Pearson,M,58,2976334,4759
4926,Ragnar,M,58,2976392,4997
4927,Rana,F,58,2976450,4847
4928,Roberta,F,58,2976508,4528
4929,Rooney,F,58,2976566,4088
4930,Rosella,F,58,2976624,4580
4931,Saad,M,58,2976682,4114
4932,Sahil,M,58,2976740,4688
4933,Shulem,M,58,2976798,4187
4934,Sonora,F,58,2976856,4761
4935,Taron,M,58,2976914,4904
4936,Tavion,M,58,2976972,4676
4937,Trayvon,M,58,2977030,4374
4938,Triton,M,58,2977088,4322
4939,Tymir,M,58,2977146,4544
4940,Yasmina,F,58,2977204,4354
4941,Zade,M,58,2977262,4120
4942,Zakiyah,F,58,2977320,4940
4943,Zarina,F,58,2977378,4301
4944,Aarin,M,57,2977435,4483
4945,Abir,M,57,2977492,4401
4946,Adaya,F,57,2977549,4728
4947,Adin,M,57,2977606,4037
4948,Adonai,M,57,2977663,4994
4949,Alston,M,57,2977720,4008
4950,Anja,F,57,2977777,4989
4951,Aramis,M,57,2977834,4957
4952,Bethel,F,57,2977891,4923
4953,Brittney,F,57,2977948,4188
4954,Bruin,M,57,2978005,4509
4955,Bryden,M,57,2978062,4384
4956,Cael,M,57,2978119,4123
4957,Corrine,F,57,2978176,4890
4958,Devora,F,57,2978233,4991
4959,Elianny,F,57,2978290,4395
4960,Elyjah,M,57,2978347,4099
4961,Emric,M,57,2978404,4005
4962,Esty,F,57,2978461,4019
4963,Ezriel,M,57,2978518,4784
4964,Gema,F,57,2978575,4157
4965,Ginger,F,57,2978632,4378
4966,Gregorio,M,57,2978689,4362
4967,Izaak,M,57,2978746,4838
4968,Jareth,M,57,2978803,4185
4969,Jeremih,M,57,2978860,4236
4970,Jermani,F,57,2978917,4907
4971,Kaily,F,57,2978974,4836
4972,Karime,F,57,2979031,4622
4973,Katheryn,F,57,2979088,4788
4974,Keely,F,57,2979145,4084
4975,Khyler,M,57,2979202,4486
4976,Kylon,M,57,2979259,4511
4977,Laiyah,F,57,2979316,4039
4978,Livie,F,57,2979373,4928
4979,Locke,M,57,2979430,4960
4980,Luc,M,57,2979487,4758
4981,Lulu,F,57,2979544,4105
4982,Malea,F,57,2979601,4451
4983,Melodi,F,57,2979658,4235
4984,Monique,F,57,2979715,4918
4985,Naiomi,F,57,2979772,4394
4986,Nura,F,57,2979829,4894
4987,Payten,F,57,2979886,4477
4988,Phoenyx,F,57,2979943,4808
4989,Preslie,F,57,2980000,4300
4990,Raymundo,M,57,2980057,4273
4991,Reema,F,57,2980114,4434
4992,Richie,M,57,2980171,4971
4993,Salomon,M,57,2980228,4214
4994,Taylynn,F,57,2980285,4230
4995,Tim,M,57,2980342,4694
4996,Una,F,57,2980399,4319
4997,Uzziah,M,57,2980456,4097
4998,Viraaj,M,57,2980513,4457
4999,Yasser,M,57,2980570,4150
5000,Zori,F,57,2980627,5948
5001,Aariv,M,56,2980683,5710
5002,Aceson,M,56,2980739,5125
5003,Alahni,F,56,2980795,5553
5004,Ammon,M,56,2980851,5612
5005,Anasofia,F,56,2980907,5393
5006,Annastasia,F,56,2980963,5920
5007,Arina,F,56,2981019,5205
5008,Arizbeth,F,56,2981075,5283
5009,Aveah,F,56,2981131,5040
5010,Ayaansh,M,56,2981187,5656
5011,Aysha,F,56,2981243,5266
5012,Aziza,F,56,2981299,5038
5013,Baileigh,F,56,2981355,5356
5014,Brewer,M,56,2981411,5813
5015,Caelyn,F,56,2981467,5020
5016,Charis,F,56,2981523,5960
5017,Deontae,M,56,2981579,5742
5018,Eevee,F,56,2981635,5292
5019,Eoin,M,56,2981691,5229
5020,Haris,M,56,2981747,5492
5021,Hayzel,F,56,2981803,5493
5022,Jabril,M,56,2981859,5067
5023,Joella,F,56,2981915,5069
5024,Josette,F,56,2981971,5255
5025,Kalilah,F,56,2982027,5933
5026,Kam,M,56,2982083,5724
5027,Kamani,F,56,2982139,5970
5028,Kendrix,M,56,2982195,5653
5029,Laniya,F,56,2982251,5491
5030,Lark,F,56,2982307,5624
5031,Letti,F,56,2982363,5460
5032,Maddilynn,F,56,2982419,5358
5033,Mariama,F,56,2982475,5288
5034,Marilynn,F,56,2982531,5674
5035,Mazi,M,56,2982587,5641
5036,Mirabella,F,56,2982643,5027
5037,Miraya,F,56,2982699,5530
5038,Naeem,M,56,2982755,5886
5039,Olivier,M,56,2982811,5104
5040,Rainey,F,56,2982867,5853
5041,Ravi,M,56,2982923,5305
5042,Reyaan,M,56,2982979,5998
5043,Rhyleigh,F,56,2983035,5878
5044,Rorie,F,56,2983091,5620
5045,Rosaline,F,56,2983147,5073
5046,Rosanna,F,56,2983203,5025
5047,Sena,F,56,2983259,5574
5048,Shlok,M,56,2983315,5053
5049,Skylin,F,56,2983371,5150
5050,Syaire,M,56,2983427,5651
5051,Tyrion,M,56,2983483,5495
5052,Usher,M,56,2983539,5152
5053,Vedansh,M,56,2983595,5523
5054,Yassin,M,56,2983651,5194
5055,Zacchaeus,M,56,2983707,5486
5056,Zayaan,M,56,2983763,5348
5057,Zina,F,56,2983819,5118
5058,Aashvi,F,55,2983874,5482
5059,Abiel,M,55,2983929,5791
5060,Abigale,F,55,2983984,5578
5061,Adelyne,F,55,2984039,5164
5062,Adria,F,55,2984094,5652
5063,Affan,M,55,2984149,5452
5064,Ahron,M,55,2984204,5045
5065,Anish,M,55,2984259,5894
5066,Antoni,M,55,2984314,5896
5067,Anuel,M,55,2984369,5939
5068,Atom,M,55,2984424,5626
5069,Ayala,F,55,2984479,5068
5070,Ayoub,M,55,2984534,5041
5071,Aziz,M,55,2984589,5583
5072,Caterina,F,55,2984644,5198
5073,Cayleigh,F,55,2984699,5741
5074,Cristhian,M,55,2984754,5050
5075,Darin,M,55,2984809,5983
5076,Domenico,M,55,2984864,5431
5077,Eldana,F,55,2984919,5480
5078,Emiko,F,55,2984974,5254
5079,Gwenevere,F,55,2985029,5469
5080,Harland,M,55,2985084,5829
5081,Harlowe,F,55,2985139,5351
5082,Henderson,M,55,2985194,5711
5083,Hinda,F,55,2985249,5876
5084,Jadyn,F,55,2985304,5670
5085,Jaiceon,M,55,2985359,5139
5086,Jakhi,M,55,2985414,5713
5087,Jamere,M,55,2985469,5910
5088,Jania,F,55,2985524,5589
5089,Janney,F,55,2985579,5672
5090,Jariyah,F,55,2985634,5052
5091,Javari,M,55,2985689,5905
5092,Jennah,F,55,2985744,5013
5093,Joah,M,55,2985799,5794
5094,Kainan,M,55,2985854,5593
5095,Kallum,M,55,2985909,5926
5096,Karon,M,55,2985964,5510
5097,Kayliana,F,55,2986019,5528
5098,Kendalyn,F,55,2986074,5213
5099,Keyli,F,55,2986129,5698
5100,Khyrie,M,55,2986184,5588
5101,Kloe,F,55,2986239,5435
5102,Kolter,M,55,2986294,5159
5103,Levy,M,55,2986349,5155
5104,Lilliann,F,55,2986404,5172
5105,Lyana,F,55,2986459,5899
5106,Mael,M,55,2986514,5346
5107,Mailen,F,55,2986569,5985
5108,Mazen,M,55,2986624,5160
5109,Monty,M,55,2986679,5033
5110,Niah,F,55,2986734,5211
5111,Niomi,F,55,2986789,5705
5112,Othniel,M,55,2986844,5691
5113,Paradise,F,55,2986899,5715
5114,Praise,F,55,2986954,5309
5115,Quinley,F,55,2987009,5247
5116,Rafaela,F,55,2987064,5338
5117,Rhyatt,M,55,2987119,5262
5118,Safwan,M,55,2987174,5163
5119,Sima,F,55,2987229,5912
5120,Simona,F,55,2987284,5755
5121,Ted,M,55,2987339,5459
5122,Zaedyn,M,55,2987394,5245
5123,Zamaya,F,55,2987449,5966
5124,Zulema,F,55,2987504,5340
5125,Aaria,F,54,2987558,5175
5126,Addy,F,54,2987612,5374
5127,Allegra,F,54,2987666,5095
5128,Amilah,F,54,2987720,5433
5129,Amore,F,54,2987774,5914
5130,Ara,F,54,2987828,5660
5131,Arisha,F,54,2987882,5789
5132,Armias,M,54,2987936,5276
5133,Aurielle,F,54,2987990,5828
5134,Beckam,M,54,2988044,5521
5135,Bernice,F,54,2988098,5556
5136,Brinleigh,F,54,2988152,5639
5137,Caesar,M,54,2988206,5106
5138,Carys,F,54,2988260,5357
5139,Cassia,F,54,2988314,5625
5140,Chayse,M,54,2988368,5399
5141,Dixon,M,54,2988422,5317
5142,Elianah,F,54,2988476,5192
5143,Ellee,F,54,2988530,5671
5144,Emilyn,F,54,2988584,5184
5145,Essa,M,54,2988638,5582
5146,Evana,F,54,2988692,5758
5147,Geoffrey,M,54,2988746,5426
5148,Geovanny,M,54,2988800,5115
5149,Hiro,M,54,2988854,5419
5150,Jahleel,M,54,2988908,5776
5151,Jan,M,54,2988962,5723
5152,Jaxten,M,54,2989016,5122
5153,Jayci,F,54,2989070,5450
5154,Jibreel,M,54,2989124,5294
5155,Joao,M,54,2989178,5263
5156,Journii,F,54,2989232,5100
5157,Kal,M,54,2989286,5290
5158,Kambri,F,54,2989340,5300
5159,Kavin,M,54,2989394,5515
5160,Khaleel,M,54,2989448,5532
5161,Kim,F,54,2989502,5608
5162,Leyna,F,54,2989556,5602
5163,Lyrik,F,54,2989610,5872
5164,Maira,F,54,2989664,5996
5165,Maycee,F,54,2989718,5318
5166,Mela,F,54,2989772,5326
5167,Minha,F,54,2989826,5554
5168,Price,M,54,2989880,5999
5169,Quinlan,M,54,2989934,5162
5170,Rakan,M,54,2989988,5422
5171,Remedy,F,54,2990042,5391
5172,Roen,M,54,2990096,5780
5173,Rozlyn,F,54,2990150,5333
5174,Salim,M,54,2990204,5764
5175,Santi,M,54,2990258,5716
5176,Santiel,M,54,2990312,5831
5177,Serayah,F,54,2990366,5209
5178,Slate,M,54,2990420,5605
5179,Struan,M,54,2990474,5591
5180,Talya,F,54,2990528,5526
5181,Tanvi,F,54,2990582,5967
5182,Tova,F,54,2990636,5368
5183,Truly,F,54,2990690,5822
5184,Vander,M,54,2990744,5907
5185,Virat,M,54,2990798,5972
5186,Von,M,54,2990852,5182
5187,Weslyn,F,54,2990906,5900
5188,Younis,M,54,2990960,5968
5189,Yusef,M,54,2991014,5195
5190,Zaliyah,F,54,2991068,5444
5191,Zaniah,F,54,2991122,5663
5192,Zaryah,F,54,2991176,5773
5193,Zaydan,M,54,2991230,5044
5194,Zaylynn,F,54,2991284,5427
5195,Aaleyah,F,53,2991337,5664
5196,Addelynn,F,53,2991390,5735
5197,Aella,F,53,2991443,5458
5198,Aicha,F,53,2991496,5058
5199,Amberlee,F,53,2991549,5901
5200,Angelia,F,53,2991602,5253
5201,Ansleigh,F,53,2991655,5381
5202,Anvika,F,53,2991708,5108
5203,Avarose,F,53,2991761,5977
5204,Baxter,M,53,2991814,5477
5205,Brayton,M,53,2991867,5180
5206,Brexley,F,53,2991920,5143
5207,Brynnleigh,F,53,2991973,5576
5208,Caliana,F,53,2992026,5418
5209,Cayla,F,53,2992079,5413
5210,Cruze,M,53,2992132,5251
5211,Daliah,F,53,2992185,5144
5212,Darion,M,53,2992238,5313
5213,Dolly,F,53,2992291,5658
5214,Eder,M,53,2992344,5308
5215,Emalee,F,53,2992397,5002
5216,Essie,F,53,2992450,5170
5217,Farhan,M,53,2992503,5745
5218,Graydon,M,53,2992556,5504
5219,Hera,F,53,2992609,5810
5220,Herbert,M,53,2992662,5173
5221,Jaheim,M,53,2992715,5681
5222,Jailynn,F,53,2992768,5306
5223,Jamaal,M,53,2992821,5165
5224,Jeff,M,53,2992874,5633
5225,Keiry,F,53,2992927,5307
5226,Kendell,M,53,2992980,5774
5227,Kevon,M,53,2993033,5373
5228,Kimani,F,53,2993086,5893
5229,Kion,M,53,2993139,5989
5230,Kollin,M,53,2993192,5903
5231,Kymber,F,53,2993245,5220
5232,Landree,F,53,2993298,5026
5233,Lariyah,F,53,2993351,5769
5234,Linley,F,53,2993404,5446
5235,Madina,F,53,2993457,5557
5236,Maeleigh,F,53,2993510,5094
5237,Maja,F,53,2993563,5490
5238,Makhai,M,53,2993616,5949
5239,Maris,F,53,2993669,5501
5240,Marlen,F,53,2993722,5984
5241,Marwan,M,53,2993775,5105
5242,Muhammadali,M,53,2993828,5767
5243,Nicolai,M,53,2993881,5587
5244,Nolyn,M,53,2993934,5975
5245,Nubia,F,53,2993987,5325
5246,Pilar,F,53,2994040,5382
5247,Polina,F,53,2994093,5884
5248,Radley,M,53,2994146,5931
5249,Reyes,M,53,2994199,5594
5250,Ronny,M,53,2994252,5682
5251,Roya,F,53,2994305,5269
5252,Ryanne,F,53,2994358,5430
5253,Saleem,M,53,2994411,5275
5254,Selvin,M,53,2994464,5134
5255,Sirius,M,53,2994517,5648
5256,Skylyn,F,53,2994570,5289
5257,Sven,M,53,2994623,5889
5258,Sydnee,F,53,2994676,5709
5259,Talen,M,53,2994729,5519
5260,Tarik,M,53,2994782,5646
5261,Tye,M,53,2994835,5114
5262,Vaida,F,53,2994888,5429
5263,Vianey,F,53,2994941,5185
5264,Westlyn,F,53,2994994,5955
5265,Whitaker,M,53,2995047,5389
5266,Ziyon,M,53,2995100,5915
5267,Zoha,F,53,2995153,5408
5268,Advika,F,52,2995205,5808
5269,Aleeyah,F,52,2995257,5265
5270,Anali,F,52,2995309,5133
5271,Arius,M,52,2995361,5354
5272,Azra,F,52,2995413,5512
5273,Bane,M,52,2995465,5101
5274,Bayan,F,52,2995517,5434
5275,Blakley,F,52,2995569,5754
5276,Brennon,M,52,2995621,5376
5277,Caeli,F,52,2995673,5721
5278,Carolynn,F,52,2995725,5834
5279,Colsen,M,52,2995777,5604
5280,Danyla,F,52,2995829,5934
5281,Dayla,F,52,2995881,5217
5282,Debra,F,52,2995933,5509
5283,Dejuan,M,52,2995985,5946
5284,Demarco,M,52,2996037,5708
5285,Elif,F,52,2996089,5562
5286,Eliyana,F,52,2996141,5383
5287,Ericka,F,52,2996193,5296
5288,Everli,F,52,2996245,5443
5289,Golda,F,52,2996297,5929
5290,Gretta,F,52,2996349,5579
5291,Hershy,M,52,2996401,5958
5292,Izabela,F,52,2996453,5412
5293,Jaire,M,52,2996505,5874
5294,Jalil,M,52,2996557,5076
5295,Jenelle,F,52,2996609,5345
5296,Jidenna,M,52,2996661,5327
5297,Jovany,M,52,2996713,5237
5298,Kahlia,F,52,2996765,5581
5299,Kaiyah,F,52,2996817,5849
5300,Kaleia,F,52,2996869,5489
5301,Kamia,F,52,2996921,5564
5302,Kayvon,M,52,2996973,5848
5303,Kenyon,M,52,2997025,5965
5304,Kenzlie,F,52,2997077,5056
5305,Khori,F,52,2997129,5049
5306,Koltyn,M,52,2997181,5017
5307,Lael,M,52,2997233,5394
5308,Layden,M,52,2997285,5075
5309,Lindy,F,52,2997337,5845
5310,Luan,M,52,2997389,5506
5311,Malaika,F,52,2997441,5752
5312,Merlin,M,52,2997493,5407
5313,Mikail,M,52,2997545,5947
5314,Mirren,F,52,2997597,5273
5315,Moxie,F,52,2997649,5785
5316,Myka,F,52,2997701,5233
5317,Natan,M,52,2997753,5544
5318,Neela,F,52,2997805,5542
5319,Nirvaan,M,52,2997857,5607
5320,Novalie,F,52,2997909,5568
5321,Omega,M,52,2997961,5534
5322,Prynce,M,52,2998013,5636
5323,Santhiago,M,52,2998065,5404
5324,Saya,F,52,2998117,5295
5325,Shriya,F,52,2998169,5219
5326,Simran,F,52,2998221,5986
5327,Stiles,M,52,2998273,5201
5328,Stratton,M,52,2998325,5284
5329,Swayze,F,52,2998377,5779
5330,Syeda,F,52,2998429,5540
5331,Tahir,M,52,2998481,5445
5332,Vega,F,52,2998533,5679
5333,Vikram,M,52,2998585,5685
5334,Whitlee,F,52,2998637,5479
5335,Xaria,F,52,2998689,5640
5336,Zekiel,M,52,2998741,5112
5337,Zyler,M,52,2998793,5465
5338,Adaly,F,51,2998844,5661
5339,Adelle,F,51,2998895,5321
5340,Adelynne,F,51,2998946,5121
5341,Alexavier,M,51,2998997,5451
5342,Amaiyah,F,51,2999048,5807
5343,Amere,M,51,2999099,5415
5344,Amna,F,51,2999150,5473
5345,Anistyn,F,51,2999201,5174
5346,Anwar,M,51,2999252,5873
5347,Asaad,M,51,2999303,5257
5348,Ashad,M,51,2999354,5621
5349,Avary,F,51,2999405,5669
5350,Bayley,F,51,2999456,5406
5351,Binyomin,M,51,2999507,5573
5352,Brook,F,51,2999558,5385
5353,Cailey,F,51,2999609,5771
5354,Callista,F,51,2999660,5011
5355,Darianna,F,51,2999711,5812
5356,Decklan,M,51,2999762,5997
5357,Eesa,M,51,2999813,5285
5358,Emalynn,F,51,2999864,5193
5359,Erwin,M,51,2999915,5978
5360,Evelynne,F,51,2999966,5158
5361,Faisal,M,51,3000017,5552
5362,Fannie,F,51,3000068,5861
5363,Francisca,F,51,3000119,5890
5364,Gala,F,51,3000170,5007
5365,Genaro,M,51,3000221,5031
5366,Giulietta,F,51,3000272,5347
5367,Goldy,F,51,3000323,5361
5368,Isley,F,51,3000374,5223
5369,Izel,F,51,3000425,5909
5370,Jailyne,F,51,3000476,5364
5371,Josabeth,F,51,3000527,5091
5372,Joslynn,F,51,3000578,5470
5373,Kaileigh,F,51,3000629,5243
5374,Kaisyn,M,51,3000680,5004
5375,Kamri,F,51,3000731,5630
5376,Kato,M,51,3000782,5140
5377,Keeley,F,51,3000833,5531
5378,Ken,M,51,3000884,5824
5379,Kolbie,F,51,3000935,5293
5380,Lavon,M,51,3000986,5034
5381,Layth,M,51,3001037,5895
5382,Lesley,F,51,3001088,5795
5383,Lipa,M,51,3001139,5837
5384,Lisandro,M,51,3001190,5787
5385,Mahira,F,51,3001241,5102
5386,Masai,M,51,3001292,5731
5387,Mecca,M,51,3001343,5689
5388,Moana,F,51,3001394,5008
5389,Muna,F,51,3001445,5601
5390,Naylani,F,51,3001496,5416
5391,Oaklie,F,51,3001547,5782
5392,October,F,51,3001598,5019
5393,Qasim,M,51,3001649,5398
5394,Raziel,M,51,3001700,5925
5395,Robbie,M,51,3001751,5484
5396,Rustin,M,51,3001802,5280
5397,Silver,F,51,3001853,5761
5398,Starla,F,51,3001904,5525
5399,Suzanne,F,51,3001955,5856
5400,Talayah,F,51,3002006,5551
5401,Tierney,F,51,3002057,5726
5402,Tyra,F,51,3002108,5208
5403,Tyron,M,51,3002159,5657
5404,Wali,M,51,3002210,5246
5405,Wisdom,M,51,3002261,5957
5406,Yaqub,M,51,3002312,5729
5407,Zenaida,F,51,3002363,5074
5408,Zyir,M,51,3002414,5197
5409,Aariyah,F,50,3002464,5804
5410,Abhinav,M,50,3002514,5071
5411,Abubakr,M,50,3002564,5803
5412,Akari,M,50,3002614,5645
5413,Akash,M,50,3002664,5055
5414,Aleiah,F,50,3002714,5539
5415,Amada,F,50,3002764,5016
5416,Amay,M,50,3002814,5339
5417,Aniyla,F,50,3002864,5487
5418,Annora,F,50,3002914,5850
5419,Ashwin,M,50,3002964,5360
5420,Aubrei,F,50,3003014,5012
5421,Avelyn,F,50,3003064,5595
5422,Braedyn,M,50,3003114,5072
5423,Calix,M,50,3003164,5825
5424,Colden,M,50,3003214,5089
5425,Coltyn,M,50,3003264,5659
5426,Cross,M,50,3003314,5737
5427,Dakotah,F,50,3003364,5518
5428,Darlyn,F,50,3003414,5543
5429,Darsh,M,50,3003464,5132
5430,Delila,F,50,3003514,5702
5431,Dillan,M,50,3003564,5113
5432,Dynasty,F,50,3003614,5918
5433,Elder,M,50,3003664,5687
5434,Eman,F,50,3003714,5272
5435,Emari,M,50,3003764,5123
5436,Emmarose,F,50,3003814,5911
5437,Evaan,M,50,3003864,5386
5438,Evin,M,50,3003914,5286
5439,Evren,M,50,3003964,5527
5440,Fayth,F,50,3004014,5600
5441,Gabe,M,50,3004064,5917
5442,Gigi,F,50,3004114,5973
5443,Gracey,F,50,3004164,5462
5444,Haizlee,F,50,3004214,5867
5445,Haylen,F,50,3004264,5234
5446,Izhaan,M,50,3004314,5599
5447,Jayveon,M,50,3004364,5472
5448,Jimmie,M,50,3004414,5078
5449,Jorja,F,50,3004464,5120
5450,Joseline,F,50,3004514,5990
5451,Kaydon,M,50,3004564,5203
5452,Kellin,M,50,3004614,5694
5453,Kiya,F,50,3004664,5846
5454,Konstantinos,M,50,3004714,5678
5455,Kota,M,50,3004764,5238
5456,Laela,F,50,3004814,5993
5457,Leiah,F,50,3004864,5797
5458,Luiza,F,50,3004914,5936
5459,Mai,F,50,3004964,5420
5460,Maida,F,50,3005014,5204
5461,Malorie,F,50,3005064,5402
5462,Marty,M,50,3005114,5706
5463,Meara,F,50,3005164,5513
5464,Mulan,F,50,3005214,5481
5465,Nadya,F,50,3005264,5323
5466,Naveen,M,50,3005314,5454
5467,Osmar,M,50,3005364,5226
5468,Priest,M,50,3005414,5256
5469,Ramir,M,50,3005464,5902
5470,Raniya,F,50,3005514,5994
5471,Rhiley,F,50,3005564,5821
5472,Rick,M,50,3005614,5428
5473,Rosaleen,F,50,3005664,5546
5474,Rosetta,F,50,3005714,5410
5475,Roxy,F,50,3005764,5392
5476,Ryla,F,50,3005814,5388
5477,Sahar,F,50,3005864,5987
5478,Saydee,F,50,3005914,5718
5479,Symone,F,50,3005964,5178
5480,Talan,M,50,3006014,5474
5481,Tuff,M,50,3006064,5976
5482,Veera,F,50,3006114,5906
5483,Winslow,F,50,3006164,5136
5484,Wrenlee,F,50,3006214,5868
5485,Xareni,F,50,3006264,5225
5486,Zac,M,50,3006314,5455
5487,Zamara,F,50,3006364,5088
5488,Adelaida,F,49,3006413,5974
5489,Aela,F,49,3006462,5207
5490,Aero,M,49,3006511,5908
5491,Alain,M,49,3006560,5778
5492,Alaysha,F,49,3006609,5222
5493,Alethea,F,49,3006658,5597
5494,Aliviah,F,49,3006707,5337
5495,Allisson,F,49,3006756,5770
5496,Alysia,F,49,3006805,5969
5497,Aman,M,49,3006854,5442
5498,Amoni,F,49,3006903,5221
5499,Augusta,F,49,3006952,5441
5500,Bostyn,F,49,3007001,5751
5501,Brandy,F,49,3007050,5137
5502,Brecklyn,F,49,3007099,5690
5503,Breelyn,F,49,3007148,5629
5504,Brilynn,F,49,3007197,5814
5505,Bryston,M,49,3007246,5141
5506,Calen,M,49,3007295,5395
5507,Chyna,F,49,3007344,5149
5508,Clement,M,49,3007393,5206
5509,Conan,M,49,3007442,5065
5510,Cosmo,M,49,3007491,5278
5511,Egan,M,49,3007540,5631
5512,Ellora,F,49,3007589,5882
5513,Eloy,M,49,3007638,5322
5514,Elva,F,49,3007687,5830
5515,Galen,M,49,3007736,5547
5516,Gianella,F,49,3007785,5524
5517,Giulianna,F,49,3007834,5585
5518,Harbor,F,49,3007883,5722
5519,Haroon,M,49,3007932,5667
5520,Hero,M,49,3007981,5632
5521,Ibraheem,M,49,3008030,5405
5522,Ilias,M,49,3008079,5298
5523,Indya,F,49,3008128,5336
5524,Ishika,F,49,3008177,5618
5525,Jackeline,F,49,3008226,5302
5526,Jahaziel,M,49,3008275,5005
5527,Jalissa,F,49,3008324,5555
5528,Jariah,F,49,3008373,5616
5529,Kaladin,M,49,3008422,5514
5530,Kami,F,49,3008471,5343
5531,Kamil,M,49,3008520,5991
5532,Kaoir,F,49,3008569,5271
5533,Kaylei,F,49,3008618,5466
5534,Keilan,M,49,3008667,5538
5535,Kitana,F,49,3008716,5448
5536,Kolsen,M,49,3008765,5570
5537,Kruze,M,49,3008814,5248
5538,Laramie,F,49,3008863,5496
5539,Leiana,F,49,3008912,5766
5540,Lilyan,F,49,3008961,5235
5541,Liviana,F,49,3009010,5940
5542,Maleek,M,49,3009059,5559
5543,Mallorie,F,49,3009108,5281
5544,Maureen,F,49,3009157,5371
5545,Meila,F,49,3009206,5190
5546,Michelangelo,M,49,3009255,5384
5547,Olen,M,49,3009304,5843
5548,Pauline,F,49,3009353,5261
5549,Philippa,F,49,3009402,5331
5550,Polly,F,49,3009451,5463
5551,Randi,F,49,3009500,5665
5552,Rayshawn,M,49,3009549,5623
5553,Rina,F,49,3009598,5892
5554,Salah,M,49,3009647,5087
5555,Saxon,M,49,3009696,5748
5556,Shaniya,F,49,3009745,5887
5557,Sylus,M,49,3009794,5097
5558,Thayer,M,49,3009843,5390
5559,Trevion,M,49,3009892,5116
5560,Tristyn,M,49,3009941,5349
5561,Willis,M,49,3009990,5762
5562,Yameli,F,49,3010039,5676
5563,Yides,F,49,3010088,5840
5564,Zeynep,F,49,3010137,5712
5565,Zidane,M,49,3010186,5188
5566,Aanvi,F,48,3010234,5304
5567,Aceyn,M,48,3010282,5788
5568,Adaliah,F,48,3010330,5734
5569,Alaynah,F,48,3010378,5511
5570,Aloni,F,48,3010426,5536
5571,Ameir,M,48,3010474,5202
5572,Amenadiel,M,48,3010522,5421
5573,Amera,F,48,3010570,5154
5574,Amyiah,F,48,3010618,5603
5575,Arlett,F,48,3010666,5315
5576,Aryiah,F,48,3010714,5145
5577,Ashten,M,48,3010762,5147
5578,Astraea,F,48,3010810,5865
5579,Ayush,M,48,3010858,5548
5580,Boris,M,48,3010906,5738
5581,Brelynn,F,48,3010954,5772
5582,Brianne,F,48,3011002,5375
5583,Cailee,F,48,3011050,5401
5584,Calleigh,F,48,3011098,5571
5585,Cameryn,F,48,3011146,5334
5586,Caris,F,48,3011194,5437
5587,Carlota,F,48,3011242,5414
5588,Carmello,M,48,3011290,5704
5589,Carmyn,F,48,3011338,5250
5590,Corrina,F,48,3011386,5598
5591,Darcie,F,48,3011434,5066
5592,Dasia,F,48,3011482,5183
5593,Deanthony,M,48,3011530,5644
5594,Deen,M,48,3011578,5768
5595,Emersen,F,48,3011626,5372
5596,Fateh,M,48,3011674,5950
5597,Geronimo,M,48,3011722,5871
5598,Hala,F,48,3011770,5093
5599,Hilda,F,48,3011818,5166
5600,Kailer,M,48,3011866,5189
5601,Kaori,F,48,3011914,5485
5602,Kaycie,F,48,3011962,5563
5603,Keidy,F,48,3012010,5686
5604,Kwame,M,48,3012058,5000
5605,Kylani,F,48,3012106,5344
5606,Larson,M,48,3012154,5643
5607,Laurie,F,48,3012202,5342
5608,Lili,F,48,3012250,5935
5609,Lilli,F,48,3012298,5475
5610,Linkoln,M,48,3012346,5239
5611,Lisbeth,F,48,3012394,5855
5612,Loxley,F,48,3012442,5756
5613,Maha,F,48,3012490,5214
5614,Makoa,M,48,3012538,5086
5615,Maleia,F,48,3012586,5819
5616,Mayleigh,F,48,3012634,5662
5617,Maylen,F,48,3012682,5790
5618,Naisha,F,48,3012730,5572
5619,Peace,F,48,3012778,5438
5620,Rhema,F,48,3012826,5070
5621,Ritchie,M,48,3012874,5488
5622,Rook,M,48,3012922,5586
5623,Runa,F,48,3012970,5924
5624,Ryver,F,48,3013018,5030
5625,Sameer,M,48,3013066,5841
5626,Sapphira,F,48,3013114,5079
5627,Silvana,F,48,3013162,5287
5628,Skyy,F,48,3013210,5471
5629,Snow,F,48,3013258,5930
5630,Stefano,M,48,3013306,5092
5631,Sutter,M,48,3013354,5858
5632,Taiden,M,48,3013402,5606
5633,Tailynn,F,48,3013450,5522
5634,Tali,F,48,3013498,5877
5635,Tammy,F,48,3013546,5119
5636,Tidus,M,48,3013594,5037
5637,Tytan,M,48,3013642,5916
5638,Vanna,F,48,3013690,5210
5639,Zaylah,F,48,3013738,5352
5640,Ziah,F,48,3013786,5028
5641,Zuleyka,F,48,3013834,5151
5642,Zyana,F,48,3013882,5811
5643,Aayansh,M,47,3013929,5424
5644,Abygail,F,47,3013976,5992
5645,Aiko,F,47,3014023,5199
5646,Aine,F,47,3014070,5077
5647,Alexei,M,47,3014117,5022
5648,Alona,F,47,3014164,5409
5649,Alycia,F,47,3014211,5035
5650,Amadou,M,47,3014258,5436
5651,Amairany,F,47,3014305,5468
5652,Amie,F,47,3014352,5124
5653,Arik,M,47,3014399,5329
5654,Arsema,F,47,3014446,5516
5655,Avila,F,47,3014493,5844
5656,Blayze,M,47,3014540,5060
5657,Bradford,M,47,3014587,5736
5658,Brynna,F,47,3014634,5880
5659,Chanelle,F,47,3014681,5796
5660,Chip,M,47,3014728,5324
5661,Danya,F,47,3014775,5862
5662,Daron,M,47,3014822,5042
5663,Devontae,M,47,3014869,5700
5664,Dorothea,F,47,3014916,5827
5665,Eleonora,F,47,3014963,5610
5666,Eliany,F,47,3015010,5869
5667,Emelie,F,47,3015057,5191
5668,Euan,M,47,3015104,5146
5669,Eyden,M,47,3015151,5314
5670,Fahad,M,47,3015198,5282
5671,Gittel,F,47,3015245,5110
5672,Haider,M,47,3015292,5024
5673,Harmonii,F,47,3015339,5494
5674,Jakhari,M,47,3015386,5805
5675,Jansen,M,47,3015433,5945
5676,Jaziyah,F,47,3015480,5786
5677,Jetson,M,47,3015527,5497
5678,Joleigh,F,47,3015574,5366
5679,Josabet,F,47,3015621,5757
5680,Kamyla,F,47,3015668,5258
5681,Kayce,M,47,3015715,5818
5682,Kenza,F,47,3015762,5090
5683,Kodah,M,47,3015809,5684
5684,Kree,M,47,3015856,5196
5685,Krishna,M,47,3015903,5765
5686,Lainee,F,47,3015950,5988
5687,Lamiyah,F,47,3015997,5699
5688,Landri,F,47,3016044,5611
5689,Lilyanne,F,47,3016091,5885
5690,Lizette,F,47,3016138,5517
5691,Lucifer,M,47,3016185,5668
5692,Lucky,M,47,3016232,5851
5693,Maelie,F,47,3016279,5815
5694,Mahalia,F,47,3016326,5730
5695,Maizey,F,47,3016373,5798
5696,Makiya,F,47,3016420,5457
5697,Maricela,F,47,3016467,5396
5698,Mehlani,F,47,3016514,5888
5699,Monae,F,47,3016561,5801
5700,Morrigan,F,47,3016608,5727
5701,Muad,M,47,3016655,5148
5702,Nabil,M,47,3016702,5231
5703,Nataleigh,F,47,3016749,5590
5704,Neema,F,47,3016796,5864
5705,Olga,F,47,3016843,5332
5706,Payson,M,47,3016890,5483
5707,Raelynne,F,47,3016937,5809
5708,Raiya,F,47,3016984,5666
5709,Remmy,M,47,3017031,5836
5710,Renly,M,47,3017078,5476
5711,Rhylan,M,47,3017125,5852
5712,Samari,F,47,3017172,5303
5713,Shayne,M,47,3017219,5244
5714,Shreyan,M,47,3017266,5365
5715,Siobhan,F,47,3017313,5341
5716,Suzanna,F,47,3017360,5980
5717,Sylvan,M,47,3017407,5784
5718,Tasneem,F,47,3017454,5362
5719,Teyana,F,47,3017501,5498
5720,Tziporah,F,47,3017548,5057
5721,Unity,F,47,3017595,5655
5722,Venice,F,47,3017642,5938
5723,Vicky,F,47,3017689,5792
5724,Wayland,M,47,3017736,5014
5725,Waylynn,F,47,3017783,5823
5726,Weldon,M,47,3017830,5268
5727,Wynne,F,47,3017877,5499
5728,Zalaya,F,47,3017924,5440
5729,Adryan,M,46,3017970,5236
5730,Ainara,F,46,3018016,5720
5731,Alaska,F,46,3018062,5508
5732,Aleyza,F,46,3018108,5241
5733,Alysson,F,46,3018154,5099
5734,Amaru,M,46,3018200,5642
5735,Anessa,F,46,3018246,5817
5736,Annamae,F,46,3018292,5833
5737,Asir,M,46,3018338,5301
5738,Astoria,F,46,3018384,5860
5739,Bea,F,46,3018430,5806
5740,Berlin,F,46,3018476,5330
5741,Brailynn,F,46,3018522,5449
5742,Bronwyn,F,46,3018568,5171
5743,Carrington,F,46,3018614,5982
5744,Cedrick,M,46,3018660,5781
5745,Crimson,F,46,3018706,5464
5746,Demian,M,46,3018752,5403
5747,Destini,F,46,3018798,5647
5748,Eben,M,46,3018844,5335
5749,Edyn,F,46,3018890,5274
5750,Ekam,M,46,3018936,5083
5751,Eleen,F,46,3018982,5135
5752,Emsley,F,46,3019028,5232
5753,Ena,F,46,3019074,5310
5754,Evalee,F,46,3019120,5417
5755,Fallyn,F,46,3019166,5592
5756,Galilee,F,46,3019212,5826
5757,Haddon,M,46,3019258,5320
5758,Hamzah,M,46,3019304,5153
5759,Jaren,M,46,3019350,5922
5760,Jarrod,M,46,3019396,5242
5761,Jazmyne,F,46,3019442,5085
5762,Jerimiah,M,46,3019488,5866
5763,Jeter,M,46,3019534,5230
5764,Jonatan,M,46,3019580,5904
5765,Julieth,F,46,3019626,5951
5766,Kalise,F,46,3019672,5537
5767,Kaniya,F,46,3019718,5047
5768,Karisma,F,46,3019764,5359
5769,Kayloni,F,46,3019810,5062
5770,Keshav,M,46,3019856,5707
5771,Kharter,M,46,3019902,5355
5772,Kimberlyn,F,46,3019948,5054
5773,Kurtis,M,46,3019994,5311
5774,Leeanna,F,46,3020040,5719
5775,Llewyn,M,46,3020086,5046
5776,Lyza,F,46,3020132,5212
5777,Macon,M,46,3020178,5126
5778,Makaylah,F,46,3020224,5142
5779,Manny,M,46,3020270,5675
5780,Mateus,M,46,3020316,5098
5781,Milla,F,46,3020362,5297
5782,Myrah,F,46,3020408,5021
5783,Namir,M,46,3020454,5759
5784,Nikolaos,M,46,3020500,5650
5785,Nohemi,F,46,3020546,5692
5786,Noora,F,46,3020592,5637
5787,Nyjah,M,46,3020638,5963
5788,Paetyn,F,46,3020684,5400
5789,Prescott,M,46,3020730,5793
5790,Quade,M,46,3020776,5577
5791,Rhoda,F,46,3020822,5875
5792,Rhythm,F,46,3020868,5677
5793,Robinson,M,46,3020914,5560
5794,Romelo,M,46,3020960,5545
5795,Romero,M,46,3021006,5816
5796,Roxie,F,46,3021052,5942
5797,Safia,F,46,3021098,5084
5798,Sahily,F,46,3021144,5200
5799,Samadhi,F,46,3021190,5943
5800,Sanvi,F,46,3021236,5369
5801,Shaquille,M,46,3021282,5252
5802,Siana,F,46,3021328,5432
5803,Stefania,F,46,3021374,5387
5804,Stefany,F,46,3021420,5503
5805,Tai,M,46,3021466,5215
5806,Tyren,M,46,3021512,5928
5807,Vittoria,F,46,3021558,5839
5808,Weslynn,F,46,3021604,5186
5809,Yitzchak,M,46,3021650,5891
5810,Zaki,M,46,3021696,5550
5811,Zayra,F,46,3021742,5941
5812,Zya,F,46,3021788,5566
5813,Aaliya,F,45,3021833,5032
5814,Abbott,M,45,3021878,5835
5815,Abbygail,F,45,3021923,5006
5816,Aisley,F,45,3021968,5725
5817,Aleeza,F,45,3022013,5029
5818,Ami,F,45,3022058,5001
5819,Andoni,M,45,3022103,5820
5820,Arlee,F,45,3022148,5635
5821,Asiel,M,45,3022193,5703
5822,Aster,F,45,3022238,5954
5823,Avionna,F,45,3022283,5023
5824,Bayla,F,45,3022328,5187
5825,Brison,M,45,3022373,5279
5826,Brissa,F,45,3022418,5614
5827,Brooklynne,F,45,3022463,5747
5828,Brylan,M,45,3022508,5018
5829,Brynlie,F,45,3022553,5380
5830,Buck,M,45,3022598,5580
5831,Cainen,M,45,3022643,5596
5832,Cambri,F,45,3022688,5622
5833,Candy,F,45,3022733,5693
5834,Ciana,F,45,3022778,5064
5835,Cornell,M,45,3022823,5039
5836,Corrie,F,45,3022868,5216
5837,Dakoda,M,45,3022913,5638
5838,Delainey,F,45,3022958,5847
5839,Demetria,F,45,3023003,5109
5840,Devina,F,45,3023048,5744
5841,Eliah,M,45,3023093,5259
5842,Emberley,F,45,3023138,5881
5843,Emerly,F,45,3023183,5063
5844,Emmanuelle,F,45,3023228,5962
5845,Eviana,F,45,3023273,5270
5846,Eziah,M,45,3023318,5048
5847,Ezri,F,45,3023363,5654
5848,Fabiana,F,45,3023408,5953
5849,Fraidy,F,45,3023453,5617
5850,Hart,M,45,3023498,5696
5851,Havyn,F,45,3023543,5051
5852,Hayat,F,45,3023588,5240
5853,Hillary,F,45,3023633,5743
5854,Hillel,M,45,3023678,5959
5855,Hogan,M,45,3023723,5228
5856,Island,F,45,3023768,5775
5857,Jacelynn,F,45,3023813,5533
5858,Jamiah,F,45,3023858,5838
5859,Jemima,F,45,3023903,5979
5860,Kayde,M,45,3023948,5952
5861,Keilyn,F,45,3023993,5397
5862,Kenadee,F,45,3024038,5760
5863,Keylin,F,45,3024083,5627
5864,Khaleb,M,45,3024128,5453
5865,Khalif,M,45,3024173,5701
5866,Landrie,F,45,3024218,5740
5867,Latrell,M,45,3024263,5777
5868,Lennyn,F,45,3024308,5680
5869,Lino,M,45,3024353,5783
5870,Madelin,F,45,3024398,5411
5871,Mahki,M,45,3024443,5535
5872,Manal,F,45,3024488,5467
5873,Marely,F,45,3024533,5224
5874,Maryama,F,45,3024578,5367
5875,Mckay,M,45,3024623,5763
5876,Meher,F,45,3024668,5181
5877,Miko,M,45,3024713,5370
5878,Milliana,F,45,3024758,5964
5879,Mirabel,F,45,3024803,5932
5880,Mirella,F,45,3024848,5117
5881,Nevin,M,45,3024893,5502
5882,Oak,M,45,3024938,5697
5883,Percy,M,45,3024983,5799
5884,Pryce,M,45,3025028,5961
5885,Raeya,F,45,3025073,5130
5886,Railyn,F,45,3025118,5859
5887,Rashawn,M,45,3025163,5688
5888,Raylyn,F,45,3025208,5584
5889,Rehan,M,45,3025253,5003
5890,Rikki,F,45,3025298,5009
5891,Rilyn,F,45,3025343,5913
5892,Rosy,F,45,3025388,5425
5893,Sahir,M,45,3025433,5111
5894,Stockton,M,45,3025478,5082
5895,Therese,F,45,3025523,5956
5896,Torren,M,45,3025568,5995
5897,Tydus,M,45,3025613,5842
5898,Vedant,M,45,3025658,5081
5899,Walden,M,45,3025703,5870
5900,Willard,M,45,3025748,5854
5901,Williams,M,45,3025793,5107
5902,Zavien,M,45,3025838,5179
5903,Zayyan,M,45,3025883,5613
5904,Aaira,F,44,3025927,5377
5905,Abrianna,F,44,3025971,5328
5906,Adil,M,44,3026015,5128
5907,Adrianne,F,44,3026059,5569
5908,Ailsa,F,44,3026103,5507
5909,Aiya,F,44,3026147,5981
5910,Alise,F,44,3026191,5177
5911,Amyla,F,44,3026235,5103
5912,Annalie,F,44,3026279,5714
5913,Ariane,F,44,3026323,5378
5914,Arionna,F,44,3026367,5218
5915,Avie,F,44,3026411,5927
5916,Aycen,M,44,3026455,5312
5917,Azalia,F,44,3026499,5717
5918,Azara,F,44,3026543,5529
5919,Bliss,F,44,3026587,5227
5920,Briseida,F,44,3026631,5010
5921,Cainan,M,44,3026675,5316
5922,Camelia,F,44,3026719,5863
5923,Chauncey,M,44,3026763,5753
5924,Chayton,M,44,3026807,5883
5925,Chloee,F,44,3026851,5879
5926,Claudio,M,44,3026895,5673
5927,Cylas,M,44,3026939,5319
5928,Dagny,F,44,3026983,5015
5929,Deisy,F,44,3027027,5138
5930,Dru,M,44,3027071,5628
5931,Edan,M,44,3027115,5061
5932,Ellanor,F,44,3027159,5277
5933,Evanna,F,44,3027203,5478
5934,Evy,F,44,3027247,5156
5935,Ezlynn,F,44,3027291,5683
5936,Golden,M,44,3027335,5728
5937,Griselda,F,44,3027379,5649
5938,Gustav,M,44,3027423,5363
5939,Haevyn,F,44,3027467,5541
5940,Halia,F,44,3027511,5567
5941,Henny,F,44,3027555,5176
5942,Holley,F,44,3027599,5919
5943,Hoorain,F,44,3027643,5423
5944,Ilah,F,44,3027687,5739
5945,Irma,F,44,3027731,5695
5946,Jaciel,M,44,3027775,5291
5947,Jakub,M,44,3027819,5898
5948,Janely,F,44,3027863,5575
5949,Janeth,F,44,3027907,5746
5950,Jedediah,M,44,3027951,5129
5951,Joselin,F,44,3027995,5558
5952,Jullian,M,44,3028039,5857
5953,Kahari,M,44,3028083,5353
5954,Kaleigha,F,44,3028127,5749
5955,Keisha,F,44,3028171,5732
5956,Kenslie,F,44,3028215,5549
5957,Keylani,F,44,3028259,5505
5958,Kidus,M,44,3028303,5565
5959,Krishiv,M,44,3028347,5379
5960,Kristin,F,44,3028391,5299
5961,Kristofer,M,44,3028435,5168
5962,Lazer,M,44,3028479,5456
5963,Leeann,F,44,3028523,5036
5964,Leopoldo,M,44,3028567,5267
5965,Leovanni,M,44,3028611,5971
5966,Lorna,F,44,3028655,5937
5967,Lou,M,44,3028699,5096
5968,Mahlon,M,44,3028743,5832
5969,Marisela,F,44,3028787,5619
5970,Maxen,M,44,3028831,5043
5971,Naksh,M,44,3028875,5461
5972,Naliyah,F,44,3028919,5447
5973,Nami,F,44,3028963,5080
5974,Oz,M,44,3029007,5897
5975,Perrin,M,44,3029051,5750
5976,Pete,M,44,3029095,5439
5977,Pryor,M,44,3029139,5800
5978,Renae,F,44,3029183,5260
5979,Rider,M,44,3029227,5921
5980,Royalti,F,44,3029271,5944
5981,Sayler,F,44,3029315,5249
5982,Shanelle,F,44,3029359,5127
5983,Shifra,F,44,3029403,5169
5984,Shreyas,M,44,3029447,5609
5985,Tommie,M,44,3029491,5157
5986,Usman,M,44,3029535,5520
5987,Vinny,M,44,3029579,5350
5988,Wolfe,M,44,3029623,5615
5989,Wynston,M,44,3029667,5634
5990,Yadira,F,44,3029711,5059
5991,Zael,M,44,3029755,5923
5992,Ziad,M,44,3029799,5500
5993,Aasir,M,43,3029842,5561
5994,Abdoulaye,M,43,3029885,5802
5995,Adhira,F,43,3029928,5264
5996,Adhvik,M,43,3029971,5167
5997,Adonnis,M,43,3030014,5733
5998,Ahlam,F,43,3030057,5131
5999,Ajani,M,43,3030100,5161
6000,Aking,M,43,3030143,6670
6001,Alany,F,43,3030186,6871
6002,Aleksandr,M,43,3030229,6207
6003,Alexandros,M,43,3030272,6706
6004,Alexi,F,43,3030315,6720
6005,Alli,F,43,3030358,6059
6006,Amalie,F,43,3030401,6505
6007,Anamaria,F,43,3030444,6540
6008,Anslee,F,43,3030487,6147
6009,Aric,M,43,3030530,6416
6010,Ariyan,M,43,3030573,6476
6011,Armand,M,43,3030616,6844
6012,Asees,F,43,3030659,6713
6013,Asim,M,43,3030702,6170
6014,Avan,M,43,3030745,6532
6015,Aviel,M,43,3030788,6530
6016,Aysel,F,43,3030831,6519
6017,Blima,F,43,3030874,6030
6018,Bowman,M,43,3030917,6691
6019,Brailey,F,43,3030960,6042
6020,Cale,M,43,3031003,6975
6021,Chet,M,43,3031046,6149
6022,Coda,M,43,3031089,6370
6023,Coralyn,F,43,3031132,6635
6024,Cornelia,F,43,3031175,6253
6025,Darrin,M,43,3031218,6456
6026,Delphine,F,43,3031261,6642
6027,Donavan,M,43,3031304,6418
6028,Elida,F,43,3031347,6580
6029,Embry,F,43,3031390,6443
6030,Estefani,F,43,3031433,6594
6031,Gabby,F,43,3031476,6602
6032,Gamaliel,M,43,3031519,6567
6033,Halley,F,43,3031562,6690
6034,Hosea,M,43,3031605,6638
6035,Hudsyn,F,43,3031648,6721
6036,Ily,F,43,3031691,6383
6037,Ishani,F,43,3031734,6628
6038,Jaide,F,43,3031777,6977
6039,Jakiyah,F,43,3031820,6399
6040,Jalynn,F,43,3031863,6795
6041,Januel,M,43,3031906,6082
6042,Jasmyn,F,43,3031949,6159
6043,Jevon,M,43,3031992,6226
6044,Jhonny,M,43,3032035,6954
6045,Jiana,F,43,3032078,6107
6046,Jireh,M,43,3032121,6769
6047,Jodi,F,43,3032164,6086
6048,Josiyah,M,43,3032207,6689
6049,Josslyn,F,43,3032250,6987
6050,Kaloni,F,43,3032293,6267
6051,Kendric,M,43,3032336,6794
6052,Kerry,M,43,3032379,6414
6053,Keyden,M,43,3032422,6862
6054,Knoxx,M,43,3032465,6083
6055,Leylah,F,43,3032508,6188
6056,Liara,F,43,3032551,6775
6057,Lillianne,F,43,3032594,6598
6058,Lynley,F,43,3032637,6034
6059,Maynor,M,43,3032680,6244
6060,Mehar,F,43,3032723,6285
6061,Muhsin,M,43,3032766,6885
6062,Nahmir,M,43,3032809,6187
6063,Naiya,F,43,3032852,6236
6064,Naomie,F,43,3032895,6300
6065,Nara,F,43,3032938,6357
6066,Odysseus,M,43,3032981,6997
6067,Rashid,M,43,3033024,6652
6068,Riyah,F,43,3033067,6911
6069,Rowynn,F,43,3033110,6674
6070,Saisha,F,43,3033153,6068
6071,Serina,F,43,3033196,6851
6072,Sherry,F,43,3033239,6164
6073,Siara,F,43,3033282,6423
6074,Skylie,F,43,3033325,6722
6075,Tennyson,M,43,3033368,6912
6076,Tula,F,43,3033411,6856
6077,Tzipora,F,43,3033454,6898
6078,Viyan,M,43,3033497,6903
6079,Xzander,M,43,3033540,6829
6080,Yahaira,F,43,3033583,6270
6081,Zahid,M,43,3033626,6364
6082,Zayah,F,43,3033669,6752
6083,Zedekiah,M,43,3033712,6293
6084,Aadvik,M,42,3033754,6018
6085,Abdias,M,42,3033796,6171
6086,Abimael,M,42,3033838,6422
6087,Adia,F,42,3033880,6338
6088,Aizah,F,42,3033922,6228
6089,Akil,M,42,3033964,6330
6090,Alizee,F,42,3034006,6214
6091,Alysha,F,42,3034048,6273
6092,Amberley,F,42,3034090,6434
6093,Ameen,M,42,3034132,6391
6094,Ameya,F,42,3034174,6900
6095,Anibal,M,42,3034216,6582
6096,Ashar,M,42,3034258,6863
6097,Ashleigh,F,42,3034300,6601
6098,Azir,M,42,3034342,6852
6099,Baylie,F,42,3034384,6780
6100,Bennie,M,42,3034426,6883
6101,Braya,F,42,3034468,6342
6102,Brylie,F,42,3034510,6723
6103,Bushra,F,42,3034552,6067
6104,Cami,F,42,3034594,6035
6105,Claude,M,42,3034636,6746
6106,Delina,F,42,3034678,6440
6107,Desean,M,42,3034720,6702
6108,Divina,F,42,3034762,6282
6109,Efraim,M,42,3034804,6132
6110,Eian,M,42,3034846,6278
6111,Eliab,M,42,3034888,6754
6112,Elimelech,M,42,3034930,6538
6113,Ellah,F,42,3034972,6648
6114,Emerick,M,42,3035014,6650
6115,Enslee,F,42,3035056,6256
6116,Era,F,42,3035098,6098
6117,Erynn,F,42,3035140,6247
6118,Etty,F,42,3035182,6013
6119,Evans,M,42,3035224,6061
6120,Fergus,M,42,3035266,6888
6121,Gwenivere,F,42,3035308,6056
6122,Hadlie,F,42,3035350,6669
6123,Hazely,F,42,3035392,6290
6124,Husna,F,42,3035434,6186
6125,Iain,M,42,3035476,6876
6126,Infinity,F,42,3035518,6340
6127,Jaiyana,F,42,3035560,6223
6128,Jamaya,F,42,3035602,6504
6129,Jehilyn,F,42,3035644,6939
6130,Jessia,F,42,3035686,6205
6131,Jeyden,M,42,3035728,6043
6132,Joanie,F,42,3035770,6447
6133,Jolynn,F,42,3035812,6867
6134,Jonny,M,42,3035854,6731
6135,Jordana,F,42,3035896,6239
6136,Judge,M,42,3035938,6604
6137,Katherin,F,42,3035980,6295
6138,Kay,F,42,3036022,6928
6139,Kingslee,M,42,3036064,6466
6140,Kirby,M,42,3036106,6299
6141,Kiyaan,M,42,3036148,6873
6142,Lakota,M,42,3036190,6544
6143,Lejend,M,42,3036232,6190
6144,Lora,F,42,3036274,6983
6145,Lucina,F,42,3036316,6375
6146,Mahi,F,42,3036358,6833
6147,Maliki,M,42,3036400,6281
6148,Marques,M,42,3036442,6925
6149,Medina,F,42,3036484,6586
6150,Mirha,F,42,3036526,6626
6151,Moussa,M,42,3036568,6144
6152,Munira,F,42,3036610,6120
6153,Nathen,M,42,3036652,6265
6154,Nessa,F,42,3036694,6405
6155,Nilan,M,42,3036736,6923
6156,Nino,M,42,3036778,6596
6157,Noura,F,42,3036820,6248
6158,Oziah,M,42,3036862,6561
6159,Reeva,F,42,3036904,6815
6160,Remmi,F,42,3036946,6023
6161,Rheya,F,42,3036988,6103
6162,Ridhaan,M,42,3037030,6548
6163,Rogue,F,42,3037072,6671
6164,Rya,F,42,3037114,6367
6165,Rynlee,F,42,3037156,6874
6166,Shloka,F,42,3037198,6011
6167,Shourya,M,42,3037240,6934
6168,Sione,M,42,3037282,6789
6169,Sitara,F,42,3037324,6118
6170,Solara,F,42,3037366,6296
6171,Srinika,F,42,3037408,6135
6172,Surya,M,42,3037450,6714
6173,Svea,F,42,3037492,6002
6174,Thane,M,42,3037534,6763
6175,Theophilus,M,42,3037576,6275
6176,Treyton,M,42,3037618,6776
6177,Valarie,F,42,3037660,6685
6178,Wellington,M,42,3037702,6724
6179,Yanis,M,42,3037744,6492
6180,Aarvi,F,41,3037785,6044
6181,Abigael,F,41,3037826,6349
6182,Acadia,F,41,3037867,6319
6183,Airam,F,41,3037908,6291
6184,Alanie,F,41,3037949,6237
6185,Allana,F,41,3037990,6309
6186,Alonna,F,41,3038031,6401
6187,Ameenah,F,41,3038072,6150
6188,Amelya,F,41,3038113,6040
6189,Analucia,F,41,3038154,6318
6190,Ananias,M,41,3038195,6849
6191,Bakari,M,41,3038236,6778
6192,Bradlee,M,41,3038277,6036
6193,Brave,M,41,3038318,6861
6194,Brayla,F,41,3038359,6613
6195,Brently,M,41,3038400,6973
6196,Briseyda,F,41,3038441,6104
6197,Caeden,M,41,3038482,6820
6198,Catalaya,F,41,3038523,6742
6199,Cavan,M,41,3038564,6547
6200,Codi,F,41,3038605,6556
6201,Collier,M,41,3038646,6344
6202,Cylus,M,41,3038687,6807
6203,Cyril,M,41,3038728,6797
6204,Dariyah,F,41,3038769,6738
6205,Darrion,M,41,3038810,6390
6206,Dequan,M,41,3038851,6709
6207,Dietrich,M,41,3038892,6985
6208,Dinah,F,41,3038933,6919
6209,Dinero,M,41,3038974,6922
6210,Dolores,F,41,3039015,6944
6211,Dyson,M,41,3039056,6644
6212,Edin,M,41,3039097,6500
6213,Fares,M,41,3039138,6131
6214,Frieda,F,41,3039179,6081
6215,Genevie,F,41,3039220,6419
6216,Graceson,M,41,3039261,6345
6217,Hanson,M,41,3039302,6633
6218,Harun,M,41,3039343,6154
6219,Ina,F,41,3039384,6663
6220,Jadelyn,F,41,3039425,6967
6221,Jaice,M,41,3039466,6559
6222,Jaliah,F,41,3039507,6972
6223,Jameer,M,41,3039548,6298
6224,Jeanne,F,41,3039589,6622
6225,Jibril,M,41,3039630,6854
6226,Jodie,F,41,3039671,6469
6227,Juliett,F,41,3039712,6304
6228,Juna,F,41,3039753,6688
6229,Kaliana,F,41,3039794,6808
6230,Kanen,M,41,3039835,6673
6231,Kashmere,M,41,3039876,6433
6232,Katara,F,41,3039917,6452
6233,Kaylanie,F,41,3039958,6123
6234,Kensie,F,41,3039999,6112
6235,Klarissa,F,41,3040040,6523
6236,Kofi,M,41,3040081,6719
6237,Korah,F,41,3040122,6592
6238,Ladarius,M,41,3040163,6307
6239,Lamarcus,M,41,3040204,6289
6240,Landan,M,41,3040245,6181
6241,Lelani,F,41,3040286,6662
6242,Lennix,F,41,3040327,6993
6243,Leonor,F,41,3040368,6377
6244,Lillyanne,F,41,3040409,6092
6245,Lowell,M,41,3040450,6380
6246,Lyriq,F,41,3040491,6964
6247,Mannat,F,41,3040532,6787
6248,Manraj,M,41,3040573,6193
6249,Mehki,M,41,3040614,6546
6250,Murad,M,41,3040655,6006
6251,Musab,M,41,3040696,6392
6252,Nadiya,F,41,3040737,6811
6253,Nael,M,41,3040778,6066
6254,Navie,F,41,3040819,6882
6255,Neftali,M,41,3040860,6744
6256,Parks,M,41,3040901,6052
6257,Quin,M,41,3040942,6140
6258,Rahaf,F,41,3040983,6687
6259,Rahmir,M,41,3041024,6472
6260,Ravenna,F,41,3041065,6710
6261,Rayland,M,41,3041106,6826
6262,Reigna,F,41,3041147,6643
6263,Reyaansh,M,41,3041188,6151
6264,Roosevelt,M,41,3041229,6759
6265,Rudolph,M,41,3041270,6143
6266,Rue,F,41,3041311,6202
6267,Sakina,F,41,3041352,6891
6268,Sampson,M,41,3041393,6234
6269,Sanad,M,41,3041434,6343
6270,Shloimy,M,41,3041475,6675
6271,Shyann,F,41,3041516,6686
6272,Supreme,M,41,3041557,6020
6273,Taim,M,41,3041598,6629
6274,Taleen,F,41,3041639,6412
6275,Tayvion,M,41,3041680,6327
6276,Tyriq,M,41,3041721,6496
6277,Tysen,M,41,3041762,6183
6278,Vaani,F,41,3041803,6902
6279,Zian,M,41,3041844,6502
6280,Abubakar,M,40,3041884,6126
6281,Acen,M,40,3041924,6571
6282,Adamaris,F,40,3041964,6425
6283,Ailey,F,40,3042004,6951
6284,Alaura,F,40,3042044,6937
6285,Aleeah,F,40,3042084,6683
6286,Amarachi,F,40,3042124,6907
6287,Amarii,F,40,3042164,6760
6288,Amayra,F,40,3042204,6225
6289,Angeles,F,40,3042244,6753
6290,Anyeli,F,40,3042284,6534
6291,Asael,M,40,3042324,6994
6292,Barret,M,40,3042364,6886
6293,Brad,M,40,3042404,6676
6294,Bryton,M,40,3042444,6949
6295,Caleah,F,40,3042484,6196
6296,Cary,M,40,3042524,6461
6297,Cesia,F,40,3042564,6692
6298,Cheryl,F,40,3042604,6589
6299,Clair,F,40,3042644,6543
6300,Clarice,F,40,3042684,6328
6301,Cutler,M,40,3042724,6475
6302,Cutter,M,40,3042764,6014
6303,Dakhari,M,40,3042804,6620
6304,Dalylah,F,40,3042844,6204
6305,Derian,M,40,3042884,6303
6306,Dmitri,M,40,3042924,6359
6307,Ebenezer,M,40,3042964,6192
6308,Elenora,F,40,3043004,6893
6309,Enid,F,40,3043044,6956
6310,Enos,M,40,3043084,6651
6311,Everson,M,40,3043124,6488
6312,Eythan,M,40,3043164,6000
6313,Ezrael,M,40,3043204,6640
6314,Fynlee,F,40,3043244,6565
6315,Gretel,F,40,3043284,6573
6316,Hadiya,F,40,3043324,6697
6317,Haelyn,F,40,3043364,6437
6318,Hareem,F,40,3043404,6813
6319,Inayah,F,40,3043444,6374
6320,Jaceyon,M,40,3043484,6087
6321,Jahmari,M,40,3043524,6755
6322,Janell,F,40,3043564,6047
6323,Jashawn,M,40,3043604,6255
6324,Javien,M,40,3043644,6846
6325,Javin,M,40,3043684,6792
6326,Jazleen,F,40,3043724,6655
6327,Jentry,F,40,3043764,6208
6328,Jhon,M,40,3043804,6889
6329,Kambria,F,40,3043844,6365
6330,Kavon,M,40,3043884,6515
6331,Kensi,F,40,3043924,6864
6332,Khole,F,40,3043964,6430
6333,Kimberlynn,F,40,3044004,6435
6334,Klani,F,40,3044044,6736
6335,Kodiak,M,40,3044084,6693
6336,Kristel,F,40,3044124,6029
6337,Kru,M,40,3044164,6127
6338,Krystian,M,40,3044204,6306
6339,Kynsleigh,F,40,3044244,6142
6340,Layana,F,40,3044284,6167
6341,Leandra,F,40,3044324,6968
6342,Lillia,F,40,3044364,6524
6343,Lochlann,M,40,3044404,6718
6344,Lucciano,M,40,3044444,6491
6345,Luqman,M,40,3044484,6717
6346,Lynden,F,40,3044524,6339
6347,Macario,M,40,3044564,6748
6348,Maloni,F,40,3044604,6728
6349,Maram,F,40,3044644,6821
6350,Marcelina,F,40,3044684,6283
6351,Marcia,F,40,3044724,6806
6352,Mckynlee,F,40,3044764,6506
6353,Meklit,F,40,3044804,6079
6354,Mick,M,40,3044844,6703
6355,Milagro,F,40,3044884,6549
6356,Minna,F,40,3044924,6989
6357,Montez,M,40,3044964,6323
6358,Mosiah,M,40,3045004,6772
6359,Mycah,M,40,3045044,6009
6360,Mykah,F,40,3045084,6649
6361,Mylie,F,40,3045124,6259
6362,Nalaya,F,40,3045164,6996
6363,Nayelli,F,40,3045204,6008
6364,Niylah,F,40,3045244,6857
6365,Remie,F,40,3045284,6110
6366,Rivaan,M,40,3045324,6091
6367,Saja,F,40,3045364,6124
6368,Salina,F,40,3045404,6117
6369,Saria,F,40,3045444,6420
6370,Savana,F,40,3045484,6393
6371,Scotlynn,F,40,3045524,6467
6372,Shaila,F,40,3045564,6417
6373,Shamir,M,40,3045604,6031
6374,Tanisha,F,40,3045644,6358
6375,Travon,M,40,3045684,6483
6376,Tyanna,F,40,3045724,6791
6377,Varun,M,40,3045764,6969
6378,Vedanth,M,40,3045804,6796
6379,Viggo,M,40,3045844,6681
6380,Yeison,M,40,3045884,6781
6381,Yelitza,F,40,3045924,6141
6382,Yessenia,F,40,3045964,6992
6383,Zaylie,F,40,3046004,6581
6384,Ziyad,M,40,3046044,6837
6385,Zoelle,F,40,3046084,6646
6386,Aahan,M,39,3046123,6507
6387,Adelin,F,39,3046162,6182
6388,Adem,M,39,3046201,6025
6389,Advait,M,39,3046240,6961
6390,Alahna,F,39,3046279,6109
6391,Aliyanna,F,39,3046318,6489
6392,Alizae,F,39,3046357,6782
6393,Amellia,F,39,3046396,6361
6394,Amillia,F,39,3046435,6585
6395,Anaira,F,39,3046474,6134
6396,Analiah,F,39,3046513,6384
6397,Antwon,M,39,3046552,6129
6398,Aralynn,F,39,3046591,6397
6399,Arav,M,39,3046630,6088
6400,Arianne,F,39,3046669,6599
6401,Asya,F,39,3046708,6050
6402,Atalia,F,39,3046747,6990
6403,Auron,M,39,3046786,6533
6404,Avelina,F,39,3046825,6705
6405,Avin,M,39,3046864,6631
6406,Avri,F,39,3046903,6818
6407,Azaleah,F,39,3046942,6952
6408,Azazel,M,39,3046981,6493
6409,Azlyn,F,39,3047020,6827
6410,Betsabe,F,39,3047059,6156
6411,Bobbie,F,39,3047098,6936
6412,Brookelyn,F,39,3047137,6931
6413,Cing,F,39,3047176,6089
6414,Dallin,M,39,3047215,6053
6415,Delvin,M,39,3047254,6362
6416,Demond,M,39,3047293,6619
6417,Denton,M,39,3047332,6784
6418,Dia,F,39,3047371,6257
6419,Divya,F,39,3047410,6130
6420,Domani,M,39,3047449,6945
6421,Dutch,M,39,3047488,6396
6422,Esma,F,39,3047527,6178
6423,Ezana,M,39,3047566,6245
6424,Ezekial,M,39,3047605,6490
6425,Felicia,F,39,3047644,6486
6426,Habib,M,39,3047683,6348
6427,Holdyn,M,39,3047722,6274
6428,Humza,M,39,3047761,6825
6429,Hutson,M,39,3047800,6115
6430,Ilaria,F,39,3047839,6033
6431,Imari,M,39,3047878,6910
6432,Jafet,M,39,3047917,6038
6433,Jameel,M,39,3047956,6071
6434,Javonte,M,39,3047995,6471
6435,Jazzlynn,F,39,3048034,6998
6436,Jelena,F,39,3048073,6403
6437,Jettson,M,39,3048112,6048
6438,Jeziel,M,39,3048151,6429
6439,Jim,M,39,3048190,6311
6440,Joycelyn,F,39,3048229,6870
6441,Kailah,F,39,3048268,6287
6442,Kaimana,M,39,3048307,6404
6443,Karas,M,39,3048346,6331
6444,Kelli,F,39,3048385,6301
6445,Khylie,F,39,3048424,6924
6446,Kimbella,F,39,3048463,6101
6447,Kristy,F,39,3048502,6707
6448,Kyair,M,39,3048541,6314
6449,Laiya,F,39,3048580,6441
6450,Landin,M,39,3048619,6180
6451,Leveon,M,39,3048658,6352
6452,Lior,M,39,3048697,6645
6453,Lizzy,F,39,3048736,6246
6454,Marquel,M,39,3048775,6810
6455,Melo,M,39,3048814,6431
6456,Miangel,F,39,3048853,6879
6457,Nicco,M,39,3048892,6513
6458,Normani,F,39,3048931,6229
6459,November,F,39,3048970,6266
6460,Oswald,M,39,3049009,6735
6461,Pessy,F,39,3049048,6579
6462,Quinnley,F,39,3049087,6887
6463,Rahim,M,39,3049126,6498
6464,Ramiyah,F,39,3049165,6610
6465,Rishan,M,39,3049204,6979
6466,Rozlynn,F,39,3049243,6583
6467,Savior,M,39,3049282,6094
6468,Shaniyah,F,39,3049321,6376
6469,Suzette,F,39,3049360,6897
6470,Tierra,F,39,3049399,6672
6471,Timur,M,39,3049438,6715
6472,Tinslee,F,39,3049477,6521
6473,Urban,M,39,3049516,6869
6474,Vann,M,39,3049555,6577
6475,Verena,F,39,3049594,6366
6476,Vyom,M,39,3049633,6453
6477,Willamina,F,39,3049672,6072
6478,Woods,M,39,3049711,6839
6479,Yanuel,M,39,3049750,6198
6480,Yeshaya,M,39,3049789,6308
6481,Zemirah,F,39,3049828,6337
6482,Aaniyah,F,38,3049866,6474
6483,Abdel,M,38,3049904,6623
6484,Adyson,F,38,3049942,6641
6485,Albie,M,38,3049980,6606
6486,Amaury,M,38,3050018,6316
6487,Amory,M,38,3050056,6823
6488,Annabell,F,38,3050094,6454
6489,Arjan,M,38,3050132,6206
6490,Ashtin,M,38,3050170,6436
6491,Audie,M,38,3050208,6334
6492,Banner,M,38,3050246,6798
6493,Binyamin,M,38,3050284,6503
6494,Bohdi,M,38,3050322,6102
6495,Boy,M,38,3050360,6297
6496,Breccan,M,38,3050398,6745
6497,Bruchy,F,38,3050436,6842
6498,Brystal,F,38,3050474,6372
6499,Cathryn,F,38,3050512,6600
6500,Chole,F,38,3050550,6232
6501,Cleopatra,F,38,3050588,6294
6502,Coltin,M,38,3050626,6136
6503,Corben,M,38,3050664,6896
6504,Dakarai,M,38,3050702,6929
6505,Damiyah,F,38,3050740,6926
6506,Damya,F,38,3050778,6458
6507,Dashaun,M,38,3050816,6032
6508,Daveon,M,38,3050854,6704
6509,Dekari,M,38,3050892,6578
6510,Demitri,M,38,3050930,6512
6511,Eesha,F,38,3050968,6801
6512,Eleana,F,38,3051006,6317
6513,Eliud,M,38,3051044,6262
6514,Emri,F,38,3051082,6699
6515,Eriana,F,38,3051120,6424
6516,Esa,M,38,3051158,6251
6517,Eulalia,F,38,3051196,6809
6518,Evyn,F,38,3051234,6526
6519,Ezmae,F,38,3051272,6062
6520,Fay,F,38,3051310,6272
6521,Frederic,M,38,3051348,6591
6522,Gaige,M,38,3051386,6918
6523,Gwendolynn,F,38,3051424,6726
6524,Harli,F,38,3051462,6277
6525,Harlo,F,38,3051500,6564
6526,Henryk,M,38,3051538,6712
6527,Ilani,F,38,3051576,6974
6528,Ilya,M,38,3051614,6438
6529,Jaelani,F,38,3051652,6415
6530,Jahdiel,M,38,3051690,6394
6531,Jailani,F,38,3051728,6616
6532,Jassiel,M,38,3051766,6545
6533,Javi,M,38,3051804,6696
6534,Jayana,F,38,3051842,6980
6535,Jewels,F,38,3051880,6055
6536,Juliano,M,38,3051918,6005
6537,Kaan,M,38,3051956,6484
6538,Kalie,F,38,3051994,6021
6539,Kamrynn,F,38,3052032,6350
6540,Kavion,M,38,3052070,6786
6541,Kenzy,F,38,3052108,6286
6542,Kiani,F,38,3052146,6802
6543,Kimaya,F,38,3052184,6877
6544,Koi,M,38,3052222,6654
6545,Kristiana,F,38,3052260,6836
6546,Kylei,F,38,3052298,6012
6547,Lanae,F,38,3052336,6478
6548,Luigi,M,38,3052374,6901
6549,Macen,M,38,3052412,6661
6550,Mahina,F,38,3052450,6106
6551,Marciano,M,38,3052488,6235
6552,Mathilda,F,38,3052526,6174
6553,Matt,M,38,3052564,6576
6554,Maxime,M,38,3052602,6388
6555,Melah,F,38,3052640,6727
6556,Mervin,M,38,3052678,6121
6557,Meryem,F,38,3052716,6605
6558,Myasia,F,38,3052754,6172
6559,Mylan,M,38,3052792,6958
6560,Myleigh,F,38,3052830,6843
6561,Naomy,F,38,3052868,6630
6562,Neythan,M,38,3052906,6982
6563,Nicolle,F,38,3052944,6310
6564,Nosson,M,38,3052982,6028
6565,Ohana,F,38,3053020,6133
6566,Ona,F,38,3053058,6080
6567,Oswaldo,M,38,3053096,6459
6568,Pandora,F,38,3053134,6909
6569,Passion,F,38,3053172,6346
6570,Perri,F,38,3053210,6473
6571,Quran,M,38,3053248,6838
6572,Raevyn,F,38,3053286,6389
6573,Rakeem,M,38,3053324,6230
6574,Rasheed,M,38,3053362,6595
6575,Reaghan,F,38,3053400,6614
6576,Renna,F,38,3053438,6449
6577,Rohaan,M,38,3053476,6733
6578,Romee,F,38,3053514,6351
6579,Rosabelle,F,38,3053552,6093
6580,Roux,F,38,3053590,6768
6581,Rubie,F,38,3053628,6881
6582,Saray,F,38,3053666,6762
6583,Scotty,M,38,3053704,6007
6584,Serinity,F,38,3053742,6263
6585,Shaelynn,F,38,3053780,6268
6586,Shylah,F,38,3053818,6875
6587,Sion,M,38,3053856,6541
6588,Taniya,F,38,3053894,6354
6589,Teddi,F,38,3053932,6368
6590,Verona,F,38,3053970,6880
6591,Welles,M,38,3054008,6892
6592,Winnifred,F,38,3054046,6477
6593,Yamila,F,38,3054084,6986
6594,Yelena,F,38,3054122,6138
6595,Yohanna,F,38,3054160,6090
6596,Zaila,F,38,3054198,6751
6597,Zalayah,F,38,3054236,6209
6598,Zanyla,F,38,3054274,6531
6599,Zissy,F,38,3054312,6805
6600,Zorah,F,38,3054350,6482
6601,Aalia,F,37,3054387,6774
6602,Abagail,F,37,3054424,6933
6603,Acelyn,F,37,3054461,6113
6604,Adamari,F,37,3054498,6773
6605,Adelie,F,37,3054535,6217
6606,Adhya,F,37,3054572,6463
6607,Alastor,M,37,3054609,6830
6608,Aleana,F,37,3054646,6701
6609,Alexios,M,37,3054683,6222
6610,Amarianna,F,37,3054720,6371
6611,Amilya,F,37,3054757,6495
6612,Analisa,F,37,3054794,6041
6613,Anela,F,37,3054831,6450
6614,Aralyn,F,37,3054868,6569
6615,Arissa,F,37,3054905,6470
6616,Arlyn,F,37,3054942,6758
6617,Azura,F,37,3054979,6322
6618,Baylen,M,37,3055016,6386
6619,Bexleigh,F,37,3055053,6077
6620,Brenley,F,37,3055090,6400
6621,Caidyn,M,37,3055127,6511
6622,Cashel,M,37,3055164,6070
6623,Creedence,M,37,3055201,6060
6624,Dallis,F,37,3055238,6169
6625,Damen,M,37,3055275,6385
6626,Daniya,F,37,3055312,6803
6627,Dayna,F,37,3055349,6518
6628,Delany,F,37,3055386,6771
6629,Demarius,M,37,3055423,6292
6630,Dimitrios,M,37,3055460,6946
6631,Dusty,M,37,3055497,6783
6632,Ebony,F,37,3055534,6529
6633,Edgardo,M,37,3055571,6054
6634,Edvin,M,37,3055608,6353
6635,Elizabella,F,37,3055645,6426
6636,Elliemae,F,37,3055682,6859
6637,Emin,M,37,3055719,6139
6638,Emmelyn,F,37,3055756,6621
6639,Envy,F,37,3055793,6542
6640,Evaluna,F,37,3055830,6162
6641,Evee,F,37,3055867,6114
6642,Gaspar,M,37,3055904,6096
6643,Geno,M,37,3055941,6517
6644,Haislee,F,37,3055978,6557
6645,Hardy,M,37,3056015,6003
6646,Hayzlee,F,37,3056052,6355
6647,Henlee,F,37,3056089,6978
6648,Holton,M,37,3056126,6402
6649,Imona,F,37,3056163,6884
6650,Indica,F,37,3056200,6125
6651,Indira,F,37,3056237,6001
6652,Islay,F,37,3056274,6260
6653,Jaela,F,37,3056311,6485
6654,Jailah,F,37,3056348,6832
6655,Jalisa,F,37,3056385,6085
6656,Jarell,M,37,3056422,6119
6657,Jaydin,M,37,3056459,6406
6658,Jena,F,37,3056496,6455
6659,Jenavieve,F,37,3056533,6395
6660,Joleen,F,37,3056570,6076
6661,Kadir,M,37,3056607,6627
6662,Kamyra,F,37,3056644,6166
6663,Kashvi,F,37,3056681,6749
6664,Kateri,F,37,3056718,6991
6665,Kaydin,M,37,3056755,6445
6666,Keeva,F,37,3056792,6878
6667,Kyon,M,37,3056829,6750
6668,Kyzen,M,37,3056866,6865
6669,Laron,M,37,3056903,6804
6670,Lawton,M,37,3056940,6157
6671,Leyah,F,37,3056977,6793
6672,Lielle,F,37,3057014,6037
6673,Lillyan,F,37,3057051,6799
6674,Lynnox,F,37,3057088,6895
6675,Mable,F,37,3057125,6660
6676,Maelani,F,37,3057162,6442
6677,Makyla,F,37,3057199,6819
6678,Makynlee,F,37,3057236,6732
6679,Malayna,F,37,3057273,6777
6680,Maliha,F,37,3057310,6570
6681,Maribelle,F,37,3057347,6765
6682,Mariya,F,37,3057384,6817
6683,Maybelle,F,37,3057421,6741
6684,Mckinleigh,F,37,3057458,6845
6685,Melannie,F,37,3057495,6603
6686,Nani,F,37,3057532,6767
6687,Naylah,F,37,3057569,6840
6688,Neithan,M,37,3057606,6779
6689,Odelia,F,37,3057643,6664
6690,Ora,F,37,3057680,6679
6691,Percival,M,37,3057717,6587
6692,Ranveer,M,37,3057754,6073
6693,Rashaad,M,37,3057791,6816
6694,Rei,F,37,3057828,6015
6695,Rexton,M,37,3057865,6574
6696,Reza,M,37,3057902,6027
6697,Roel,M,37,3057939,6508
6698,Saeed,M,37,3057976,6853
6699,Sarayah,F,37,3058013,6555
6700,Scotland,F,37,3058050,6963
6701,Scottlyn,F,37,3058087,6729
6702,Sephora,F,37,3058124,6960
6703,Sereniti,F,37,3058161,6057
6704,Shivani,F,37,3058198,6737
6705,Shrinika,F,37,3058235,6740
6706,Stefanie,F,37,3058272,6175
6707,Subhan,M,37,3058309,6381
6708,Suhana,F,37,3058346,6243
6709,Talaya,F,37,3058383,6970
6710,Tamera,F,37,3058420,6261
6711,Tariyah,F,37,3058457,6379
6712,Tavian,M,37,3058494,6680
6713,Teigen,M,37,3058531,6481
6714,Theoden,M,37,3058568,6509
6715,Tyquan,M,37,3058605,6249
6716,Vesper,F,37,3058642,6464
6717,Vidal,M,37,3058679,6049
6718,Weslee,M,37,3058716,6329
6719,Xia,F,37,3058753,6941
6720,Yonathan,M,37,3058790,6520
6721,Yurani,F,37,3058827,6108
6722,Zacarias,M,37,3058864,6790
6723,Zahava,F,37,3058901,6024
6724,Zamya,F,37,3058938,6743
6725,Zarya,F,37,3058975,6971
6726,Zaylin,M,37,3059012,6212
6727,Zayvian,M,37,3059049,6725
6728,Zenith,M,37,3059086,6525
6729,Zenobia,F,37,3059123,6908
6730,Zyanna,F,37,3059160,6451
6731,Adel,M,36,3059196,6284
6732,Adelaine,F,36,3059232,6678
6733,Adison,F,36,3059268,6572
6734,Adna,F,36,3059304,6932
6735,Aislin,F,36,3059340,6279
6736,Alaila,F,36,3059376,6016
6737,Aleeya,F,36,3059412,6730
6738,Aleksandar,M,36,3059448,6321
6739,Alexandrea,F,36,3059484,6894
6740,Amaan,M,36,3059520,6457
6741,Amaiah,F,36,3059556,6668
6742,Amairani,F,36,3059592,6904
6743,Ameila,F,36,3059628,6191
6744,Anaelle,F,36,3059664,6128
6745,Aniela,F,36,3059700,6398
6746,Anisha,F,36,3059736,6336
6747,Arbor,F,36,3059772,6341
6748,Arleigh,F,36,3059808,6920
6749,Asante,M,36,3059844,6241
6750,Ashur,M,36,3059880,6872
6751,Atara,F,36,3059916,6930
6752,Augustina,F,36,3059952,6868
6753,Avagrace,F,36,3059988,6558
6754,Aylee,F,36,3060024,6850
6755,Benyamin,M,36,3060060,6617
6756,Bless,M,36,3060096,6356
6757,Blessin,F,36,3060132,6568
6758,Bram,M,36,3060168,6659
6759,Brilee,F,36,3060204,6276
6760,Caelynn,F,36,3060240,6155
6761,Caisen,M,36,3060276,6814
6762,Carrigan,F,36,3060312,6695
6763,Chasen,M,36,3060348,6984
6764,Christa,F,36,3060384,6560
6765,Citlaly,F,36,3060420,6658
6766,Collyns,F,36,3060456,6947
6767,Daniyal,M,36,3060492,6063
6768,Darya,F,36,3060528,6288
6769,Dayra,F,36,3060564,6152
6770,Dearra,F,36,3060600,6950
6771,Dontrell,M,36,3060636,6607
6772,Drayson,M,36,3060672,6444
6773,Eliazar,M,36,3060708,6017
6774,Elisia,F,36,3060744,6516
6775,Emryn,F,36,3060780,6211
6776,Fermin,M,36,3060816,6831
6777,Gohan,M,36,3060852,6428
6778,Graciella,F,36,3060888,6899
6779,Haden,M,36,3060924,6250
6780,Halen,F,36,3060960,6480
6781,Halsey,F,36,3060996,6224
6782,Haset,F,36,3061032,6335
6783,Heitor,M,36,3061068,6165
6784,Heran,F,36,3061104,6161
6785,Ishaq,M,36,3061140,6176
6786,Jahsir,M,36,3061176,6158
6787,Jailee,F,36,3061212,6761
6788,Jamieson,M,36,3061248,6539
6789,Jamyla,F,36,3061284,6552
6790,Javontae,M,36,3061320,6943
6791,Jeshua,M,36,3061356,6026
6792,Karthik,M,36,3061392,6590
6793,Keyshawn,M,36,3061428,6238
6794,Khylin,M,36,3061464,6221
6795,Kipp,M,36,3061500,6915
6796,Kyser,M,36,3061536,6988
6797,Levin,M,36,3061572,6955
6798,Liba,F,36,3061608,6940
6799,Lisette,F,36,3061644,6099
6800,Loukas,M,36,3061680,6848
6801,Lynda,F,36,3061716,6051
6802,Madaline,F,36,3061752,6148
6803,Makiah,F,36,3061788,6938
6804,Malique,M,36,3061824,6766
6805,Marnie,F,36,3061860,6860
6806,Martez,M,36,3061896,6195
6807,Mattison,F,36,3061932,6039
6808,Mavrik,M,36,3061968,6097
6809,Maximilliano,M,36,3062004,6522
6810,Mendy,M,36,3062040,6479
6811,Mercer,M,36,3062076,6137
6812,Mivaan,M,36,3062112,6074
6813,Mouhamed,M,36,3062148,6233
6814,Neely,F,36,3062184,6535
6815,Nicolo,M,36,3062220,6382
6816,Peri,F,36,3062256,6611
6817,Rayanna,F,36,3062292,6770
6818,Ronni,F,36,3062328,6216
6819,Rony,M,36,3062364,6462
6820,Roslynn,F,36,3062400,6566
6821,Roxas,M,36,3062436,6553
6822,Rylah,F,36,3062472,6677
6823,Sagan,M,36,3062508,6184
6824,Samiah,F,36,3062544,6231
6825,Shaelyn,F,36,3062580,6812
6826,Shahd,F,36,3062616,6363
6827,Shanvi,F,36,3062652,6058
6828,Solomia,F,36,3062688,6834
6829,Suhaib,M,36,3062724,6163
6830,Sumayyah,F,36,3062760,6305
6831,Taylon,M,36,3062796,6584
6832,Tehila,F,36,3062832,6312
6833,Tejas,M,36,3062868,6360
6834,Toren,M,36,3062904,6563
6835,Tylee,F,36,3062940,6302
6836,Waleed,M,36,3062976,6647
6837,Wheeler,M,36,3063012,6468
6838,Whit,M,36,3063048,6258
6839,Wilbur,M,36,3063084,6254
6840,Wrigley,M,36,3063120,6407
6841,Yadier,M,36,3063156,6022
6842,Yahia,M,36,3063192,6835
6843,Yug,M,36,3063228,6609
6844,Zackariah,M,36,3063264,6446
6845,Zakiya,F,36,3063300,6078
6846,Zamarion,M,36,3063336,6095
6847,Zamirah,F,36,3063372,6824
6848,Zidan,M,36,3063408,6315
6849,Zoei,F,36,3063444,6116
6850,Abdurrahman,M,35,3063479,6625
6851,Adeleine,F,35,3063514,6200
6852,Ahaana,F,35,3063549,6615
6853,Akshay,M,35,3063584,6326
6854,Alahia,F,35,3063619,6634
6855,Alarik,M,35,3063654,6965
6856,Aleczander,M,35,3063689,6906
6857,Aleiyah,F,35,3063724,6201
6858,Alekzander,M,35,3063759,6624
6859,Alynna,F,35,3063794,6636
6860,Amori,F,35,3063829,6747
6861,Analicia,F,35,3063864,6065
6862,Andersen,M,35,3063899,6608
6863,Annagrace,F,35,3063934,6264
6864,Anny,F,35,3063969,6168
6865,Arlie,F,35,3064004,6682
6866,Arwyn,F,35,3064039,6527
6867,Auriella,F,35,3064074,6757
6868,Avacyn,F,35,3064109,6716
6869,Aviv,M,35,3064144,6179
6870,Axyl,M,35,3064179,6347
6871,Blue,M,35,3064214,6734
6872,Bogdan,M,35,3064249,6935
6873,Brailyn,F,35,3064284,6739
6874,Breon,M,35,3064319,6105
6875,Brinkley,F,35,3064354,6213
6876,Chimamanda,F,35,3064389,6764
6877,Chozen,M,35,3064424,6966
6878,Cyncere,M,35,3064459,6510
6879,Dariela,F,35,3064494,6981
6880,Dayron,M,35,3064529,6501
6881,Deysi,F,35,3064564,6324
6882,Dmari,M,35,3064599,6942
6883,Eliaz,M,35,3064634,6421
6884,Elleanor,F,35,3064669,6194
6885,Ellias,M,35,3064704,6075
6886,Ellory,F,35,3064739,6632
6887,Emre,M,35,3064774,6413
6888,Fabricio,M,35,3064809,6378
6889,Graeson,M,35,3064844,6494
6890,Hagan,M,35,3064879,6227
6891,Halston,F,35,3064914,6280
6892,Hashir,M,35,3064949,6999
6893,Hatcher,M,35,3064984,6593
6894,Havanna,F,35,3065019,6828
6895,Hendrixx,M,35,3065054,6562
6896,Idrees,M,35,3065089,6045
6897,Jaedyn,M,35,3065124,6465
6898,Jamier,M,35,3065159,6369
6899,Janette,F,35,3065194,6708
6900,Jarred,M,35,3065229,6411
6901,Jarrell,M,35,3065264,6916
6902,Javan,M,35,3065299,6666
6903,Jayren,M,35,3065334,6921
6904,Jeramiah,M,35,3065369,6575
6905,Johannah,F,35,3065404,6325
6906,Jorah,M,35,3065439,6064
6907,Jordin,F,35,3065474,6550
6908,Kaidan,M,35,3065509,6800
6909,Kallan,M,35,3065544,6199
6910,Kalyn,F,35,3065579,6554
6911,Kamar,M,35,3065614,6700
6912,Kamea,F,35,3065649,6637
6913,Kameryn,F,35,3065684,6010
6914,Kamira,F,35,3065719,6612
6915,Kaydan,M,35,3065754,6487
6916,Kaynen,M,35,3065789,6215
6917,Kaz,M,35,3065824,6858
6918,Keisy,F,35,3065859,6448
6919,Keondre,M,35,3065894,6153
6920,Khaliah,F,35,3065929,6240
6921,Khylee,F,35,3065964,6271
6922,Kirin,M,35,3065999,6665
6923,Kodie,F,35,3066034,6408
6924,Kova,M,35,3066069,6995
6925,Kyland,M,35,3066104,6528
6926,Lamia,F,35,3066139,6146
6927,Larenzo,M,35,3066174,6537
6928,Leianna,F,35,3066209,6189
6929,Lilla,F,35,3066244,6332
6930,Maddax,M,35,3066279,6684
6931,Maeson,M,35,3066314,6177
6932,Mahad,M,35,3066349,6866
6933,Maher,M,35,3066384,6100
6934,Mallie,F,35,3066419,6847
6935,Matilyn,F,35,3066454,6656
6936,Mazzy,F,35,3066489,6822
6937,Meena,F,35,3066524,6913
6938,Mesa,F,35,3066559,6069
6939,Miarose,F,35,3066594,6269
6940,Minahil,F,35,3066629,6409
6941,Mirai,F,35,3066664,6004
6942,Monet,F,35,3066699,6962
6943,Myriam,F,35,3066734,6639
6944,Navia,F,35,3066769,6160
6945,Novalyn,F,35,3066804,6046
6946,Ollivander,M,35,3066839,6551
6947,Omri,M,35,3066874,6514
6948,Pavel,M,35,3066909,6313
6949,Peggy,F,35,3066944,6320
6950,Quincey,M,35,3066979,6432
6951,Raider,M,35,3067014,6855
6952,Raidyn,M,35,3067049,6917
6953,Riyansh,M,35,3067084,6667
6954,Roczen,M,35,3067119,6711
6955,Ruchy,F,35,3067154,6218
6956,Sabir,M,35,3067189,6203
6957,Samael,M,35,3067224,6145
6958,Samya,F,35,3067259,6499
6959,Shivam,M,35,3067294,6220
6960,Stanton,M,35,3067329,6653
6961,Steel,M,35,3067364,6588
6962,Sydnie,F,35,3067399,6953
6963,Sylis,M,35,3067434,6173
6964,Tinlee,F,35,3067469,6976
6965,Tory,M,35,3067504,6460
6966,Trevin,M,35,3067539,6185
6967,Truitt,M,35,3067574,6905
6968,Walt,M,35,3067609,6841
6969,Westlynn,F,35,3067644,6497
6970,Wilma,F,35,3067679,6597
6971,Wrenly,F,35,3067714,6756
6972,Yechezkel,M,35,3067749,6694
6973,Yessica,F,35,3067784,6890
6974,Yetzali,F,35,3067819,6410
6975,Yunis,M,35,3067854,6252
6976,Zaara,F,35,3067889,6084
6977,Zaelynn,F,35,3067924,6698
6978,Zaia,F,35,3067959,6210
6979,Zak,M,35,3067994,6536
6980,Zakary,M,35,3068029,6242
6981,Ziaire,M,35,3068064,6387
6982,Zianna,F,35,3068099,6333
6983,Aadi,M,34,3068133,6111
6984,Aayat,F,34,3068167,6197
6985,Adair,M,34,3068201,6618
6986,Adelita,F,34,3068235,6788
6987,Adhara,F,34,3068269,6019
6988,Aerin,F,34,3068303,6122
6989,Aerith,F,34,3068337,6914
6990,Ailee,F,34,3068371,6948
6991,Aisling,F,34,3068405,6959
6992,Alim,M,34,3068439,6427
6993,Alinna,F,34,3068473,6927
6994,Alyah,F,34,3068507,6373
6995,Amadeo,M,34,3068541,6657
6996,Amon,M,34,3068575,6785
6997,Anagha,F,34,3068609,6439
6998,Anastazia,F,34,3068643,6219
6999,Angeli,F,34,3068677,6957
7000,Aran,M,34,3068711,7827
7001,Arlan,M,34,3068745,7364
7002,Armen,M,34,3068779,7466
7003,Atleigh,F,34,3068813,7318
7004,Auston,M,34,3068847,7384
7005,Avalina,F,34,3068881,7899
7006,Avyana,F,34,3068915,7474
7007,Bartholomew,M,34,3068949,7357
7008,Baruch,M,34,3068983,7774
7009,Brax,M,34,3069017,7042
7010,Braxtin,M,34,3069051,7203
7011,Breckyn,F,34,3069085,7095
7012,Breelynn,F,34,3069119,7008
7013,Brenlee,F,34,3069153,7928
7014,Brenleigh,F,34,3069187,7959
7015,Brileigh,F,34,3069221,7911
7016,Caio,M,34,3069255,7383
7017,Callaway,F,34,3069289,7379
7018,Camia,F,34,3069323,7040
7019,Carlisle,M,34,3069357,7237
7020,Carlito,M,34,3069391,7232
7021,Cashmere,M,34,3069425,7083
7022,Chelsie,F,34,3069459,7142
7023,Cincere,M,34,3069493,7652
7024,Ciro,M,34,3069527,7589
7025,Cloe,F,34,3069561,7787
7026,Constanza,F,34,3069595,7293
7027,Damarius,M,34,3069629,7636
7028,Dasani,F,34,3069663,7236
7029,Davien,M,34,3069697,7221
7030,Daxx,M,34,3069731,7732
7031,Dedrick,M,34,3069765,7779
7032,Deena,F,34,3069799,7974
7033,Dekker,M,34,3069833,7403
7034,Deklin,M,34,3069867,7363
7035,Delyla,F,34,3069901,7400
7036,Deondre,M,34,3069935,7769
7037,Disha,F,34,3069969,7566
7038,Donnell,M,34,3070003,7243
7039,Dresden,M,34,3070037,7606
7040,Edy,M,34,3070071,7909
7041,Emiyah,F,34,3070105,7359
7042,Emmelia,F,34,3070139,7286
7043,Emran,M,34,3070173,7581
7044,Eveline,F,34,3070207,7138
7045,Fae,F,34,3070241,7043
7046,Farida,F,34,3070275,7156
7047,Freja,F,34,3070309,7770
7048,Galaxy,F,34,3070343,7978
7049,Germani,F,34,3070377,7109
7050,Hazelee,F,34,3070411,7345
7051,Ivee,F,34,3070445,7086
7052,Izael,M,34,3070479,7646
7053,Jaelah,F,34,3070513,7420
7054,Jaelle,F,34,3070547,7072
7055,Jaicee,F,34,3070581,7220
7056,Jamin,M,34,3070615,7025
7057,Janey,F,34,3070649,7431
7058,Janiel,M,34,3070683,7415
7059,Jaretzi,F,34,3070717,7327
7060,Jermiah,M,34,3070751,7991
7061,Jessalynn,F,34,3070785,7536
7062,Jeziah,M,34,3070819,7672
7063,Jiren,M,34,3070853,7101
7064,Jo,F,34,3070887,7069
7065,Jody,M,34,3070921,7489
7066,Joesiah,M,34,3070955,7985
7067,Junie,F,34,3070989,7257
7068,Justyn,M,34,3071023,7167
7069,Kadin,M,34,3071057,7473
7070,Kailo,M,34,3071091,7615
7071,Kalix,M,34,3071125,7655
7072,Kanyon,M,34,3071159,7714
7073,Karlos,M,34,3071193,7174
7074,Karmello,M,34,3071227,7477
7075,Karrington,F,34,3071261,7190
7076,Kashius,M,34,3071295,7258
7077,Kaydee,F,34,3071329,7521
7078,Kaylea,F,34,3071363,7504
7079,Keilah,F,34,3071397,7440
7080,Kenadi,F,34,3071431,7557
7081,Kerem,M,34,3071465,7800
7082,Keyan,M,34,3071499,7055
7083,Kingdom,M,34,3071533,7176
7084,Kyleah,F,34,3071567,7832
7085,Laelah,F,34,3071601,7338
7086,Layal,F,34,3071635,7218
7087,Liani,F,34,3071669,7972
7088,Lucile,F,34,3071703,7402
7089,Lyncoln,M,34,3071737,7631
7090,Maddisyn,F,34,3071771,7189
7091,Mahlia,F,34,3071805,7183
7092,Makaela,F,34,3071839,7983
7093,Malakhai,M,34,3071873,7145
7094,Marvel,F,34,3071907,7035
7095,Mayar,F,34,3071941,7377
7096,Maycie,F,34,3071975,7251
7097,Mazin,M,34,3072009,7523
7098,Melony,F,34,3072043,7306
7099,Mikai,M,34,3072077,7747
7100,Mikey,M,34,3072111,7924
7101,Miliano,M,34,3072145,7706
7102,Nada,F,34,3072179,7725
7103,Nalia,F,34,3072213,7078
7104,Naydelin,F,34,3072247,7151
7105,Nayely,F,34,3072281,7896
7106,Neila,F,34,3072315,7184
7107,Niara,F,34,3072349,7923
7108,Nihal,M,34,3072383,7752
7109,Noriel,M,34,3072417,7512
7110,Nyx,F,34,3072451,7224
7111,Paolo,M,34,3072485,7014
7112,Parth,M,34,3072519,7336
7113,Phebe,F,34,3072553,7175
7114,Pheonix,M,34,3072587,7505
7115,Posie,F,34,3072621,7599
7116,Raena,F,34,3072655,7804
7117,Rafaella,F,34,3072689,7487
7118,Rainer,M,34,3072723,7778
7119,Rawan,F,34,3072757,7240
7120,Renato,M,34,3072791,7634
7121,Ricki,F,34,3072825,7297
7122,Ridwan,M,34,3072859,7217
7123,Rielle,F,34,3072893,7085
7124,Rihan,M,34,3072927,7098
7125,Riva,F,34,3072961,7300
7126,Roque,M,34,3072995,7052
7127,Rosita,F,34,3073029,7429
7128,Rueben,M,34,3073063,7885
7129,Rylyn,F,34,3073097,7561
7130,Sammie,F,34,3073131,7976
7131,Saniah,F,34,3073165,7514
7132,Savvy,F,34,3073199,7833
7133,Sherman,M,34,3073233,7590
7134,Shlome,M,34,3073267,7619
7135,Shmiel,M,34,3073301,7841
7136,Sholom,M,34,3073335,7482
7137,Somaya,F,34,3073369,7302
7138,Tavon,M,34,3073403,7287
7139,Terri,F,34,3073437,7574
7140,Thielen,M,34,3073471,7238
7141,Uri,M,34,3073505,7346
7142,Viviann,F,34,3073539,7805
7143,Xylah,F,34,3073573,7572
7144,Yamen,M,34,3073607,7272
7145,Yamir,M,34,3073641,7322
7146,Yari,F,34,3073675,7674
7147,Yulianna,F,34,3073709,7180
7148,Zabella,F,34,3073743,7103
7149,Zaiya,F,34,3073777,7643
7150,Zakariah,M,34,3073811,7231
7151,Zo,F,34,3073845,7234
7152,Zubair,M,34,3073879,7777
7153,Zury,F,34,3073913,7895
7154,Aasim,M,33,3073946,7693
7155,Abhay,M,33,3073979,7244
7156,Addeline,F,33,3074012,7890
7157,Agam,M,33,3074045,7709
7158,Aletheia,F,33,3074078,7667
7159,Amaree,F,33,3074111,7015
7160,Amylia,F,33,3074144,7395
7161,Anara,F,33,3074177,7702
7162,Angad,M,33,3074210,7351
7163,Ariany,F,33,3074243,7162
7164,Aviraj,M,33,3074276,7951
7165,Bastion,M,33,3074309,7799
7166,Benzion,M,33,3074342,7352
7167,Beth,F,33,3074375,7826
7168,Bina,F,33,3074408,7503
7169,Boe,M,33,3074441,7126
7170,Calloway,M,33,3074474,7022
7171,Cassiel,M,33,3074507,7541
7172,Charolette,F,33,3074540,7534
7173,Christos,M,33,3074573,7940
7174,Darci,F,33,3074606,7353
7175,Demario,M,33,3074639,7449
7176,Dhriti,F,33,3074672,7783
7177,Dyland,M,33,3074705,7197
7178,Dylann,F,33,3074738,7719
7179,Eddison,M,33,3074771,7724
7180,Elicia,F,33,3074804,7622
7181,Ellyanna,F,33,3074837,7371
7182,Elric,M,33,3074870,7308
7183,Elvia,F,33,3074903,7698
7184,Emmagrace,F,33,3074936,7943
7185,Erianna,F,33,3074969,7199
7186,Erza,F,33,3075002,7547
7187,Esau,M,33,3075035,7699
7188,Eugenio,M,33,3075068,7472
7189,Franky,M,33,3075101,7751
7190,Gabino,M,33,3075134,7815
7191,Gaby,F,33,3075167,7226
7192,Genessis,F,33,3075200,7658
7193,Gertrude,F,33,3075233,7548
7194,Giabella,F,33,3075266,7596
7195,Giavonna,F,33,3075299,7334
7196,Gisela,F,33,3075332,7443
7197,Haydee,F,33,3075365,7439
7198,Heba,F,33,3075398,7717
7199,Hersh,M,33,3075431,7488
7200,Ilhan,F,33,3075464,7830
7201,Iram,M,33,3075497,7263
7202,Izaan,M,33,3075530,7676
7203,Izabell,F,33,3075563,7089
7204,Jae,M,33,3075596,7194
7205,Jaeda,F,33,3075629,7519
7206,Japheth,M,33,3075662,7933
7207,Jaslene,F,33,3075695,7612
7208,Jatniel,M,33,3075728,7252
7209,Jaylanie,F,33,3075761,7937
7210,Jaymeson,M,33,3075794,7250
7211,Jenaiah,F,33,3075827,7851
7212,Jerald,M,33,3075860,7256
7213,Jerick,M,33,3075893,7458
7214,Jerrell,M,33,3075926,7270
7215,Jessy,F,33,3075959,7743
7216,Jonael,M,33,3075992,7028
7217,Jory,F,33,3076025,7090
7218,Joselynn,F,33,3076058,7099
7219,Jourdyn,F,33,3076091,7570
7220,Jsan,M,33,3076124,7064
7221,Kahlan,F,33,3076157,7132
7222,Kalem,M,33,3076190,7475
7223,Kaliya,F,33,3076223,7501
7224,Kalynn,F,33,3076256,7729
7225,Kashten,M,33,3076289,7616
7226,Kavi,M,33,3076322,7568
7227,Kelson,M,33,3076355,7253
7228,Kymir,M,33,3076388,7870
7229,Kyomi,F,33,3076421,7603
7230,Laiklyn,F,33,3076454,7602
7231,Lander,M,33,3076487,7283
7232,Lavina,F,33,3076520,7861
7233,Lazar,M,33,3076553,7191
7234,Leeah,F,33,3076586,7790
7235,Leevi,M,33,3076619,7481
7236,Liesel,F,33,3076652,7546
7237,Lilyrose,F,33,3076685,7273
7238,Locklyn,F,33,3076718,7446
7239,Maimouna,F,33,3076751,7742
7240,Makeda,F,33,3076784,7625
7241,Malaiya,F,33,3076817,7321
7242,Maribella,F,33,3076850,7792
7243,Masa,F,33,3076883,7227
7244,Mathieu,M,33,3076916,7682
7245,Mattea,F,33,3076949,7497
7246,Mattilyn,F,33,3076982,7284
7247,Maveric,M,33,3077015,7398
7248,Maylene,F,33,3077048,7410
7249,Mesiah,M,33,3077081,7675
7250,Misty,F,33,3077114,7091
7251,Mubarak,M,33,3077147,7688
7252,Naija,F,33,3077180,7670
7253,Najee,M,33,3077213,7654
7254,Nathanial,M,33,3077246,7989
7255,Nayah,F,33,3077279,7748
7256,Neyland,M,33,3077312,7012
7257,Nikolaus,M,33,3077345,7320
7258,Nitya,F,33,3077378,7030
7259,Ojas,M,33,3077411,7685
7260,Opie,M,33,3077444,7673
7261,Orianna,F,33,3077477,7152
7262,Penina,F,33,3077510,7092
7263,Pharoah,M,33,3077543,7680
7264,Pietro,M,33,3077576,7277
7265,Quetzalli,F,33,3077609,7161
7266,Raghav,M,33,3077642,7485
7267,Renatta,F,33,3077675,7036
7268,Renlee,F,33,3077708,7328
7269,Rhylie,F,33,3077741,7565
7270,Rodrick,M,33,3077774,7074
7271,Rylinn,F,33,3077807,7878
7272,Saifan,M,33,3077840,7551
7273,Saori,F,33,3077873,7480
7274,Serah,F,33,3077906,7182
7275,Shaindel,F,33,3077939,7374
7276,Siham,F,33,3077972,7424
7277,Siraj,M,33,3078005,7063
7278,Skylan,F,33,3078038,7954
7279,Soliana,F,33,3078071,7781
7280,Stassi,F,33,3078104,7259
7281,Tahiry,F,33,3078137,7401
7282,Taran,M,33,3078170,7317
7283,Taven,M,33,3078203,7408
7284,Tayvon,M,33,3078236,7624
7285,Teagen,F,33,3078269,7274
7286,Teodor,M,33,3078302,7500
7287,Tilden,M,33,3078335,7198
7288,Tomi,F,33,3078368,7623
7289,Vale,F,33,3078401,7496
7290,Ward,M,33,3078434,7562
7291,Yaman,M,33,3078467,7392
7292,Yulian,M,33,3078500,7324
7293,Zayde,M,33,3078533,7653
7294,Zaydin,M,33,3078566,7537
7295,Zunairah,F,33,3078599,7404
7296,Zyah,F,33,3078632,7791
7297,Zyanya,F,33,3078665,7029
7298,Zyire,M,33,3078698,7679
7299,Aarushi,F,32,3078730,7107
7300,Aayla,F,32,3078762,7766
7301,Abriana,F,32,3078794,7739
7302,Adaley,F,32,3078826,7873
7303,Ahri,F,32,3078858,7883
7304,Ahsan,M,32,3078890,7202
7305,Aina,F,32,3078922,7292
7306,Aithana,F,32,3078954,7818
7307,Alexus,F,32,3078986,7216
7308,Allure,F,32,3079018,7222
7309,Alva,F,32,3079050,7451
7310,Amberlyn,F,32,3079082,7464
7311,Anirudh,M,32,3079114,7490
7312,Anniyah,F,32,3079146,7516
7313,Audri,F,32,3079178,7957
7314,Awa,F,32,3079210,7986
7315,Azayla,F,32,3079242,7084
7316,Azucena,F,32,3079274,7211
7317,Berlyn,F,32,3079306,7360
7318,Bransen,M,32,3079338,7881
7319,Braysen,M,32,3079370,7908
7320,Brienne,F,32,3079402,7929
7321,Britta,F,32,3079434,7100
7322,Brylynn,F,32,3079466,7344
7323,Cache,M,32,3079498,7910
7324,Calan,M,32,3079530,7797
7325,Calypso,F,32,3079562,7432
7326,Cayman,M,32,3079594,7515
7327,Dacari,M,32,3079626,7280
7328,Daelynn,F,32,3079658,7009
7329,Damarcus,M,32,3079690,7946
7330,Dany,M,32,3079722,7677
7331,Daren,M,32,3079754,7046
7332,Dena,F,32,3079786,7110
7333,Denny,M,32,3079818,7782
7334,Devaughn,M,32,3079850,7692
7335,Dex,M,32,3079882,7282
7336,Drako,M,32,3079914,7034
7337,Drayton,M,32,3079946,7726
7338,Dre,M,32,3079978,7335
7339,Elayah,F,32,3080010,7525
7340,Elizah,F,32,3080042,7950
7341,Elleigh,F,32,3080074,7376
7342,Ellieana,F,32,3080106,7970
7343,Elwood,M,32,3080138,7188
7344,Emersynn,F,32,3080170,7886
7345,Emoree,F,32,3080202,7081
7346,Enzley,F,32,3080234,7771
7347,Erielle,F,32,3080266,7204
7348,Eydan,M,32,3080298,7124
7349,Fabrizio,M,32,3080330,7930
7350,Georgianna,F,32,3080362,7291
7351,Gibran,M,32,3080394,7032
7352,Graelyn,F,32,3080426,7235
7353,Hadia,F,32,3080458,7594
7354,Haelynn,F,32,3080490,7898
7355,Helene,F,32,3080522,7528
7356,Henleigh,F,32,3080554,7586
7357,Herschel,M,32,3080586,7208
7358,Ilianna,F,32,3080618,7268
7359,Ilse,F,32,3080650,7428
7360,Jamauri,M,32,3080682,7115
7361,Jameir,M,32,3080714,7855
7362,Janella,F,32,3080746,7127
7363,Jayanna,F,32,3080778,7888
7364,Jeancarlos,M,32,3080810,7290
7365,Jeffry,M,32,3080842,7422
7366,Jehu,M,32,3080874,7750
7367,Jeslyn,F,32,3080906,7430
7368,Jin,M,32,3080938,7066
7369,Kacee,F,32,3080970,7154
7370,Kairos,M,32,3081002,7868
7371,Katalaya,F,32,3081034,7556
7372,Katalyna,F,32,3081066,7736
7373,Keanna,F,32,3081098,7840
7374,Kenadie,F,32,3081130,7563
7375,Kenslei,F,32,3081162,7535
7376,Kenzington,F,32,3081194,7341
7377,Ketzaly,F,32,3081226,7715
7378,Khalessi,F,32,3081258,7842
7379,Kimberlee,F,32,3081290,7017
7380,Koraline,F,32,3081322,7956
7381,Kynzie,F,32,3081354,7442
7382,Kyrell,M,32,3081386,7207
7383,Laikynn,F,32,3081418,7316
7384,Leilanie,F,32,3081450,7166
7385,Liev,M,32,3081482,7021
7386,Liliane,F,32,3081514,7447
7387,Lillee,F,32,3081546,7020
7388,Lilo,F,32,3081578,7756
7389,Lion,M,32,3081610,7471
7390,Lira,F,32,3081642,7633
7391,Loghan,F,32,3081674,7854
7392,Lovina,F,32,3081706,7461
7393,Lowen,M,32,3081738,7645
7394,Macallan,M,32,3081770,7370
7395,Majd,M,32,3081802,7233
7396,Malaiyah,F,32,3081834,7554
7397,Maryanne,F,32,3081866,7919
7398,Mayleen,F,32,3081898,7169
7399,Maze,M,32,3081930,7700
7400,Meelah,F,32,3081962,7987
7401,Megha,F,32,3081994,7433
7402,Minh,M,32,3082026,7560
7403,Miran,M,32,3082058,7531
7404,Mirielle,F,32,3082090,7810
7405,Nakai,M,32,3082122,7423
7406,Nidhi,F,32,3082154,7659
7407,Oaklan,M,32,3082186,7559
7408,Olivianna,F,32,3082218,7229
7409,Olliver,M,32,3082250,7684
7410,Oran,M,32,3082282,7200
7411,Oumar,M,32,3082314,7508
7412,Paislynn,F,32,3082346,7866
7413,Param,M,32,3082378,7149
7414,Pau,M,32,3082410,7856
7415,Phinehas,M,32,3082442,7638
7416,Quetzaly,F,32,3082474,7518
7417,Rani,F,32,3082506,7389
7418,Redding,M,32,3082538,7385
7419,Retal,F,32,3082570,7075
7420,Reuven,M,32,3082602,7757
7421,Rima,F,32,3082634,7139
7422,Rion,M,32,3082666,7745
7423,Romel,M,32,3082698,7939
7424,Rorik,M,32,3082730,7358
7425,Safiyah,F,32,3082762,7914
7426,Samual,M,32,3082794,7412
7427,Samy,M,32,3082826,7421
7428,Sayuri,F,32,3082858,7230
7429,Suraya,F,32,3082890,7478
7430,Tasnim,F,32,3082922,7990
7431,Tayah,F,32,3082954,7373
7432,Tayson,M,32,3082986,7455
7433,Tennessee,F,32,3083018,7900
7434,Terrion,M,32,3083050,7915
7435,Tiaraoluwa,F,32,3083082,7533
7436,Timmy,M,32,3083114,7506
7437,Tylin,M,32,3083146,7988
7438,Vanesa,F,32,3083178,7543
7439,Vir,M,32,3083210,7386
7440,Whitman,M,32,3083242,7131
7441,Wilfredo,M,32,3083274,7372
7442,Wynonna,F,32,3083306,7214
7443,Yahel,M,32,3083338,7411
7444,Yannis,M,32,3083370,7632
7445,Yemaya,F,32,3083402,7108
7446,Yonah,M,32,3083434,7073
7447,Zahira,F,32,3083466,7819
7448,Zanylah,F,32,3083498,7656
7449,Zaxton,M,32,3083530,7650
7450,Zelena,F,32,3083562,7964
7451,Zyhir,M,32,3083594,7837
7452,Aaiden,M,31,3083625,7530
7453,Ahyan,M,31,3083656,7076
7454,Ailin,F,31,3083687,7734
7455,Aiven,M,31,3083718,7784
7456,Alen,M,31,3083749,7195
7457,Alinah,F,31,3083780,7789
7458,Allura,F,31,3083811,7445
7459,Ameliana,F,31,3083842,7966
7460,Amier,M,31,3083873,7661
7461,An,F,31,3083904,7435
7462,Analaya,F,31,3083935,7007
7463,Anastasiya,F,31,3083966,7844
7464,Annslee,F,31,3083997,7310
7465,Anushka,F,31,3084028,7894
7466,Arush,M,31,3084059,7549
7467,Astro,M,31,3084090,7434
7468,Asuna,F,31,3084121,7141
7469,Athalia,F,31,3084152,7555
7470,Avika,F,31,3084183,7037
7471,Azekiel,M,31,3084214,7996
7472,Baleigh,F,31,3084245,7901
7473,Baltazar,M,31,3084276,7995
7474,Barbie,F,31,3084307,7266
7475,Beautiful,F,31,3084338,7526
7476,Becket,M,31,3084369,7737
7477,Bentleigh,F,31,3084400,7785
7478,Bianka,F,31,3084431,7315
7479,Blaize,M,31,3084462,7296
7480,Brianny,F,31,3084493,7811
7481,Brylen,M,31,3084524,7746
7482,Calina,F,31,3084555,7041
7483,Caylin,F,31,3084586,7801
7484,Celestia,F,31,3084617,7486
7485,Chavy,F,31,3084648,7457
7486,Citlalli,F,31,3084679,7997
7487,Cj,M,31,3084710,7225
7488,Courtland,M,31,3084741,7952
7489,Creighton,M,31,3084772,7065
7490,Cydney,F,31,3084803,7399
7491,Dael,M,31,3084834,7984
7492,Dashel,M,31,3084865,7727
7493,Daxson,M,31,3084896,7173
7494,Daya,F,31,3084927,7558
7495,Defne,F,31,3084958,7278
7496,Dezire,F,31,3084989,7755
7497,Dimas,M,31,3085020,7033
7498,Dirk,M,31,3085051,7994
7499,Easten,M,31,3085082,7588
7500,Eiley,F,31,3085113,7367
7501,Ekaterina,F,31,3085144,7798
7502,Elden,M,31,3085175,7128
7503,Eleina,F,31,3085206,7955
7504,Ellanore,F,31,3085237,7096
7505,Emelina,F,31,3085268,7245
7506,Emlyn,F,31,3085299,7850
7507,Esaias,M,31,3085330,7380
7508,Ethyn,M,31,3085361,7863
7509,Evey,F,31,3085392,7593
7510,Faiza,F,31,3085423,7331
7511,Falyn,F,31,3085454,7463
7512,Favian,M,31,3085485,7880
7513,Freedom,F,31,3085516,7759
7514,Geovani,M,31,3085547,7902
7515,Germany,F,31,3085578,7587
7516,Ginny,F,31,3085609,7002
7517,Hallee,F,31,3085640,7618
7518,Hershel,M,31,3085671,7635
7519,Hilary,F,31,3085702,7579
7520,Hilton,M,31,3085733,7942
7521,Hudsen,M,31,3085764,7158
7522,Idy,F,31,3085795,7542
7523,Jabriel,M,31,3085826,7760
7524,Jacion,M,31,3085857,7857
7525,Jailene,F,31,3085888,7795
7526,Jalia,F,31,3085919,7511
7527,Jalyn,M,31,3085950,7758
7528,Jasen,M,31,3085981,7973
7529,Jaymes,M,31,3086012,7517
7530,Jayshawn,M,31,3086043,7147
7531,Jediah,M,31,3086074,7522
7532,Jeimy,F,31,3086105,7369
7533,Jeriel,M,31,3086136,7105
7534,Jerzie,F,31,3086167,7304
7535,Joab,M,31,3086198,7765
7536,Juel,M,31,3086229,7437
7537,Juwan,M,31,3086260,7038
7538,Kaeli,F,31,3086291,7913
7539,Kaesyn,M,31,3086322,7668
7540,Kailen,M,31,3086353,7394
7541,Kalei,F,31,3086384,7271
7542,Kamaiyah,F,31,3086415,7982
7543,Kambry,F,31,3086446,7023
7544,Kamyah,F,31,3086477,7876
7545,Kashlynn,F,31,3086508,7177
7546,Kassidi,F,31,3086539,7275
7547,Kegan,M,31,3086570,7704
7548,Keston,M,31,3086601,7350
7549,Keva,F,31,3086632,7687
7550,Kymari,M,31,3086663,7121
7551,Lakai,M,31,3086694,7205
7552,Lamya,F,31,3086725,7648
7553,Livy,F,31,3086756,7794
7554,Lyvia,F,31,3086787,7569
7555,Maddelyn,F,31,3086818,7223
7556,Mahnoor,F,31,3086849,7932
7557,Marcie,F,31,3086880,7992
7558,Marietta,F,31,3086911,7319
7559,Matilde,F,31,3086942,7262
7560,Maveryk,M,31,3086973,7303
7561,Mea,F,31,3087004,7295
7562,Meela,F,31,3087035,7686
7563,Mehmet,M,31,3087066,7993
7564,Michal,F,31,3087097,7215
7565,Milli,F,31,3087128,7917
7566,Mirna,F,31,3087159,7821
7567,Mischa,F,31,3087190,7926
7568,Naftuli,M,31,3087221,7097
7569,Nelle,F,31,3087252,7665
7570,Nicodemus,M,31,3087283,7520
7571,Nomi,F,31,3087314,7285
7572,Nylan,M,31,3087345,7701
7573,Odyssey,F,31,3087376,7119
7574,Pearce,M,31,3087407,7144
7575,Perel,F,31,3087438,7538
7576,Poseidon,M,31,3087469,7846
7577,Posey,F,31,3087500,7869
7578,Promyse,F,31,3087531,7168
7579,Raj,M,31,3087562,7920
7580,Raymon,M,31,3087593,7871
7581,Renleigh,F,31,3087624,7483
7582,Riana,F,31,3087655,7113
7583,Rochelle,F,31,3087686,7024
7584,Roisin,F,31,3087717,7120
7585,Ron,M,31,3087748,7493
7586,Roran,M,31,3087779,7031
7587,Rosendo,M,31,3087810,7212
7588,Rylann,F,31,3087841,7647
7589,Saavi,F,31,3087872,7239
7590,Safina,F,31,3087903,7362
7591,Sahib,M,31,3087934,7414
7592,Sammi,F,31,3087965,7903
7593,Sanjay,M,31,3087996,7967
7594,Saylah,F,31,3088027,7111
7595,Seerat,F,31,3088058,7814
7596,Shaw,M,31,3088089,7848
7597,Sheppard,M,31,3088120,7513
7598,Solange,F,31,3088151,7051
7599,Sommer,F,31,3088182,7927
7600,Stoney,M,31,3088213,7874
7601,Sulayman,M,31,3088244,7122
7602,Tahani,F,31,3088275,7366
7603,Tailyn,F,31,3088306,7135
7604,Torben,M,31,3088337,7448
7605,Torryn,M,31,3088368,7001
7606,Twyla,F,31,3088399,7696
7607,Tycen,M,31,3088430,7340
7608,Veyda,F,31,3088461,7711
7609,Windsor,F,31,3088492,7839
7610,Yanely,F,31,3088523,7733
7611,Yareni,F,31,3088554,7003
7612,Yuki,F,31,3088585,7807
7613,Yumi,F,31,3088616,7006
7614,Zailee,F,31,3088647,7059
7615,Zeno,M,31,3088678,7453
7616,Zhaire,M,31,3088709,7630
7617,Zoella,F,31,3088740,7330
7618,Zooey,F,31,3088771,7454
7619,Zulay,F,31,3088802,7617
7620,Adalberto,M,30,3088832,7130
7621,Adham,M,30,3088862,7962
7622,Adrik,M,30,3088892,7918
7623,Adyan,M,30,3088922,7311
7624,Afnan,F,30,3088952,7298
7625,Akeelah,F,30,3088982,7979
7626,Akhil,M,30,3089012,7011
7627,Alasia,F,30,3089042,7241
7628,Alexey,M,30,3089072,7864
7629,Alfonzo,M,30,3089102,7396
7630,Alix,F,30,3089132,7723
7631,Alyssia,F,30,3089162,7604
7632,Amarra,F,30,3089192,7694
7633,Amire,M,30,3089222,7740
7634,Anai,F,30,3089252,7695
7635,Avik,M,30,3089282,7349
7636,Avrie,F,30,3089312,7823
7637,Azriella,F,30,3089342,7468
7638,Bellatrix,F,30,3089372,7010
7639,Bexlee,F,30,3089402,7859
7640,Braleigh,F,30,3089432,7193
7641,Bray,M,30,3089462,7862
7642,Brazil,F,30,3089492,7858
7643,Breeze,F,30,3089522,7159
7644,Caraline,F,30,3089552,7663
7645,Casyn,M,30,3089582,7281
7646,Cate,F,30,3089612,7213
7647,Cathy,F,30,3089642,7585
7648,Chantel,F,30,3089672,7582
7649,Christie,F,30,3089702,7058
7650,Clarisa,F,30,3089732,7550
7651,Corinna,F,30,3089762,7436
7652,Daleysa,F,30,3089792,7999
7653,Davonte,M,30,3089822,7027
7654,Delano,M,30,3089852,7460
7655,Demani,M,30,3089882,7498
7656,Dezirae,F,30,3089912,7309
7657,Domonic,M,30,3089942,7969
7658,Donny,M,30,3089972,7163
7659,Dove,F,30,3090002,7134
7660,Eleonore,F,30,3090032,7753
7661,Elijiah,M,30,3090062,7164
7662,Ellieanna,F,30,3090092,7255
7663,Emy,F,30,3090122,7133
7664,Ethen,M,30,3090152,7772
7665,Evelyne,F,30,3090182,7123
7666,Farid,M,30,3090212,7608
7667,Fatou,F,30,3090242,7754
7668,Finneas,M,30,3090272,7825
7669,Forever,F,30,3090302,7621
7670,Garen,M,30,3090332,7484
7671,Giuliano,M,30,3090362,7419
7672,Habiba,F,30,3090392,7179
7673,Hasset,F,30,3090422,7875
7674,Hazelynn,F,30,3090452,7469
7675,Helios,M,30,3090482,7981
7676,Ianna,F,30,3090512,7934
7677,Ilona,F,30,3090542,7749
7678,Imelda,F,30,3090572,7254
7679,Itzael,M,30,3090602,7186
7680,Ivyanna,F,30,3090632,7305
7681,Ixchel,F,30,3090662,7342
7682,Jaceion,M,30,3090692,7276
7683,Jaleigh,F,30,3090722,7171
7684,Jaleyah,F,30,3090752,7438
7685,Janson,M,30,3090782,7013
7686,Janyah,F,30,3090812,7391
7687,Jayliana,F,30,3090842,7761
7688,Jaymie,F,30,3090872,7444
7689,Jeannette,F,30,3090902,7662
7690,Jenicka,F,30,3090932,7925
7691,Joniel,M,30,3090962,7502
7692,Jorgie,F,30,3090992,7219
7693,Josalyn,F,30,3091022,7824
7694,Julen,M,30,3091052,7387
7695,Kaari,F,30,3091082,7524
7696,Kaavya,F,30,3091112,7768
7697,Kadrian,M,30,3091142,7201
7698,Kailea,F,30,3091172,7887
7699,Kaleena,F,30,3091202,7788
7700,Kamoni,F,30,3091232,7039
7701,Kamori,F,30,3091262,7666
7702,Kareena,F,30,3091292,7629
7703,Kaylon,M,30,3091322,7626
7704,Kemuel,M,30,3091352,7891
7705,Khang,M,30,3091382,7605
7706,Kinzie,F,30,3091412,7104
7707,Kinzleigh,F,30,3091442,7865
7708,Konstantin,M,30,3091472,7465
7709,Korban,M,30,3091502,7731
7710,Kordell,M,30,3091532,7578
7711,Kyliee,F,30,3091562,7170
7712,Lainie,F,30,3091592,7459
7713,Lakely,F,30,3091622,7165
7714,Landis,M,30,3091652,7185
7715,Lareen,F,30,3091682,7332
7716,Leelan,M,30,3091712,7347
7717,Leilana,F,30,3091742,7938
7718,Lumen,F,30,3091772,7718
7719,Lunabelle,F,30,3091802,7539
7720,Macoy,M,30,3091832,7057
7721,Madhav,M,30,3091862,7246
7722,Maiah,F,30,3091892,7849
7723,Malaia,F,30,3091922,7713
7724,Marygrace,F,30,3091952,7600
7725,Mihira,F,30,3091982,7963
7726,Nalayah,F,30,3092012,7651
7727,Nature,F,30,3092042,7836
7728,Nayel,M,30,3092072,7892
7729,Nazier,M,30,3092102,7545
7730,Nero,M,30,3092132,7325
7731,Newton,M,30,3092162,7764
7732,Nirvan,M,30,3092192,7620
7733,Nivea,F,30,3092222,7735
7734,Niyla,F,30,3092252,7441
7735,Nyelle,F,30,3092282,7228
7736,Oceana,F,30,3092312,7683
7737,Odalys,F,30,3092342,7044
7738,Oryan,M,30,3092372,7975
7739,Pascual,M,30,3092402,7307
7740,Queenie,F,30,3092432,7313
7741,Rainier,M,30,3092462,7343
7742,Rayce,M,30,3092492,7019
7743,Rich,M,30,3092522,7945
7744,Riggin,M,30,3092552,7426
7745,Rufus,M,30,3092582,7425
7746,Russel,M,30,3092612,7068
7747,Salwa,F,30,3092642,7196
7748,Scarleth,F,30,3092672,7961
7749,Shaul,M,30,3092702,7577
7750,Shelton,M,30,3092732,7639
7751,Sidharth,M,30,3092762,7641
7752,Sila,F,30,3092792,7249
7753,Skyleigh,F,30,3092822,7968
7754,Sona,F,30,3092852,7054
7755,Spirit,F,30,3092882,7160
7756,Sydni,F,30,3092912,7845
7757,Teague,M,30,3092942,7690
7758,Teodoro,M,30,3092972,7642
7759,Theseus,M,30,3093002,7889
7760,Tj,M,30,3093032,7368
7761,Travion,M,30,3093062,7125
7762,Trinitee,F,30,3093092,7649
7763,Tyrin,M,30,3093122,7049
7764,Tyshaun,M,30,3093152,7835
7765,Tyus,M,30,3093182,7852
7766,Vail,F,30,3093212,7491
7767,Vivan,M,30,3093242,7583
7768,Whitten,M,30,3093272,7689
7769,Xolani,F,30,3093302,7082
7770,Yulia,F,30,3093332,7155
7771,Yurem,M,30,3093362,7070
7772,Zahraa,F,30,3093392,7060
7773,Zaylon,M,30,3093422,7681
7774,Zealand,M,30,3093452,7050
7775,Zerenity,F,30,3093482,7671
7776,Zophia,F,30,3093512,7660
7777,Zuzanna,F,30,3093542,7775
7778,Adaiah,F,29,3093571,7382
7779,Addisen,F,29,3093600,7192
7780,Adian,M,29,3093629,7294
7781,Advith,M,29,3093658,7077
7782,Adyn,M,29,3093687,7977
7783,Ahna,F,29,3093716,7598
7784,Akim,M,29,3093745,7416
7785,Alenna,F,29,3093774,7476
7786,Alizay,F,29,3093803,7004
7787,Alphonse,M,29,3093832,7741
7788,Alta,F,29,3093861,7808
7789,Amer,M,29,3093890,7611
7790,Anavictoria,F,29,3093919,7264
7791,Angelyn,F,29,3093948,7260
7792,Annamaria,F,29,3093977,7793
7793,Arhaan,M,29,3094006,7314
7794,Arish,M,29,3094035,7707
7795,Arleen,F,29,3094064,7822
7796,Arron,M,29,3094093,7947
7797,Artur,M,29,3094122,7000
7798,Aryella,F,29,3094151,7462
7799,Athaliah,F,29,3094180,7860
7800,Aulora,F,29,3094209,7452
7801,Avereigh,F,29,3094238,7339
7802,Avyukth,M,29,3094267,7552
7803,Ayelet,F,29,3094296,7157
7804,Ayyub,M,29,3094325,7355
7805,Azure,F,29,3094354,7941
7806,Basya,F,29,3094383,7348
7807,Bellami,F,29,3094412,7026
7808,Bertha,F,29,3094441,7730
7809,Blade,M,29,3094470,7479
7810,Blimy,F,29,3094499,7527
7811,Braeleigh,F,29,3094528,7573
7812,Braylyn,F,29,3094557,7831
7813,Burhanuddin,M,29,3094586,7664
7814,Cailin,F,29,3094615,7061
7815,Camreigh,F,29,3094644,7703
7816,Casimir,M,29,3094673,7627
7817,Chassidy,F,29,3094702,7210
7818,Christofer,M,29,3094731,7953
7819,Dajuan,M,29,3094760,7817
7820,Dalani,F,29,3094789,7820
7821,Danely,F,29,3094818,7944
7822,Danthony,M,29,3094847,7129
7823,Daven,M,29,3094876,7102
7824,Davidson,M,29,3094905,7872
7825,Dayami,F,29,3094934,7067
7826,Deakon,M,29,3094963,7087
7827,December,F,29,3094992,7971
7828,Demar,M,29,3095021,7047
7829,Dino,M,29,3095050,7980
7830,Eliya,F,29,3095079,7812
7831,Ellanora,F,29,3095108,7071
7832,Ellinor,F,29,3095137,7509
7833,Emaline,F,29,3095166,7803
7834,Emeli,F,29,3095195,7187
7835,Eshaan,M,29,3095224,7016
7836,Eyla,F,29,3095253,7456
7837,Faizan,M,29,3095282,7877
7838,Ferris,M,29,3095311,7354
7839,Franchesca,F,29,3095340,7269
7840,Galileo,M,29,3095369,7657
7841,Geo,M,29,3095398,7153
7842,Georgios,M,29,3095427,7388
7843,Giannah,F,29,3095456,7375
7844,Giles,M,29,3095485,7499
7845,Graci,F,29,3095514,7678
7846,Gwynevere,F,29,3095543,7595
7847,Hali,F,29,3095572,7507
7848,Harlei,F,29,3095601,7965
7849,Hashem,M,29,3095630,7397
7850,Hayze,M,29,3095659,7728
7851,Heavenlee,F,29,3095688,7172
7852,Imaan,F,29,3095717,7998
7853,Ivyonna,F,29,3095746,7705
7854,Ivyrose,F,29,3095775,7094
7855,Jaiari,M,29,3095804,7893
7856,Jakson,M,29,3095833,7601
7857,Jaloni,F,29,3095862,7045
7858,Janayah,F,29,3095891,7721
7859,Jaquelin,F,29,3095920,7879
7860,Javonni,M,29,3095949,7767
7861,Jayceion,M,29,3095978,7114
7862,Jaydyn,M,29,3096007,7495
7863,Jayvien,M,29,3096036,7828
7864,Jemimah,F,29,3096065,7607
7865,Jeremyah,M,29,3096094,7958
7866,Jessenia,F,29,3096123,7106
7867,Josemaria,M,29,3096152,7912
7868,Josyah,M,29,3096181,7150
7869,Kaicen,M,29,3096210,7716
7870,Kailan,M,29,3096239,7467
7871,Kaislyn,F,29,3096268,7921
7872,Kaizley,F,29,3096297,7056
7873,Kaleesi,F,29,3096326,7381
7874,Kaleyah,F,29,3096355,7744
7875,Kamrin,M,29,3096384,7931
7876,Kamyiah,F,29,3096413,7062
7877,Kapri,F,29,3096442,7405
7878,Kattaleya,F,29,3096471,7580
7879,Kelan,M,29,3096500,7413
7880,Keona,F,29,3096529,7584
7881,Khamila,F,29,3096558,7813
7882,Khloie,F,29,3096587,7806
7883,Kiernan,F,29,3096616,7738
7884,Kilani,F,29,3096645,7407
7885,Kobie,M,29,3096674,7417
7886,Koleson,M,29,3096703,7613
7887,Lamarion,M,29,3096732,7333
7888,Lariah,F,29,3096761,7884
7889,Leeba,F,29,3096790,7206
7890,Leighanna,F,29,3096819,7265
7891,Lejla,F,29,3096848,7289
7892,Leonna,F,29,3096877,7763
7893,Liesl,F,29,3096906,7510
7894,Linkyn,M,29,3096935,7288
7895,Luccas,M,29,3096964,7146
7896,Lucienne,F,29,3096993,7365
7897,Lucious,M,29,3097022,7960
7898,Lynnea,F,29,3097051,7323
7899,Lynx,M,29,3097080,7644
7900,Madelaine,F,29,3097109,7427
7901,Maevyn,F,29,3097138,7326
7902,Maila,F,29,3097167,7592
7903,Mailani,F,29,3097196,7904
7904,Marci,F,29,3097225,7614
7905,Mavery,F,29,3097254,7209
7906,Maylie,F,29,3097283,7079
7907,Mckenzi,F,29,3097312,7867
7908,Mekai,M,29,3097341,7312
7909,Merryn,F,29,3097370,7906
7910,Meylin,F,29,3097399,7137
7911,Mikaeel,M,29,3097428,7882
7912,Milarose,F,29,3097457,7093
7913,Miloh,M,29,3097486,7637
7914,Monika,F,29,3097515,7591
7915,Myrical,F,29,3097544,7361
7916,Nadeen,F,29,3097573,7544
7917,Naevia,F,29,3097602,7722
7918,Nahom,M,29,3097631,7564
7919,Nakia,F,29,3097660,7922
7920,Narek,M,29,3097689,7843
7921,Nasser,M,29,3097718,7406
7922,Nataliya,F,29,3097747,7576
7923,Nicholai,M,29,3097776,7018
7924,Nusaybah,F,29,3097805,7847
7925,Oliviana,F,29,3097834,7267
7926,Oslo,M,29,3097863,7261
7927,Prayan,M,29,3097892,7796
7928,Railey,F,29,3097921,7780
7929,Renesmae,F,29,3097950,7567
7930,Rianna,F,29,3097979,7116
7931,Rigo,M,29,3098008,7669
7932,Rishabh,M,29,3098037,7762
7933,Ruairi,M,29,3098066,7148
7934,Ruhan,M,29,3098095,7248
7935,Rune,M,29,3098124,7143
7936,Ruston,M,29,3098153,7609
7937,Ryli,F,29,3098182,7378
7938,Ryne,M,29,3098211,7118
7939,Sabrin,F,29,3098240,7916
7940,Sakari,F,29,3098269,7628
7941,Sarayu,F,29,3098298,7053
7942,Sari,F,29,3098327,7610
7943,Saryah,F,29,3098356,7112
7944,Seanna,F,29,3098385,7710
7945,Shams,F,29,3098414,7048
7946,Shana,F,29,3098443,7949
7947,Shelly,F,29,3098472,7492
7948,Shloma,M,29,3098501,7337
7949,Sicily,F,29,3098530,7575
7950,Soha,F,29,3098559,7905
7951,Tabias,M,29,3098588,7409
7952,Taylan,M,29,3098617,7450
7953,Tehilla,F,29,3098646,7470
7954,Tiger,M,29,3098675,7697
7955,Tinleigh,F,29,3098704,7299
7956,Treazure,F,29,3098733,7712
7957,Vaishnavi,F,29,3098762,7540
7958,Viana,F,29,3098791,7301
7959,Weslie,F,29,3098820,7242
7960,Weylyn,M,29,3098849,7691
7961,Willy,M,29,3098878,7829
7962,Yaneth,F,29,3098907,7834
7963,Yashvi,F,29,3098936,7948
7964,Younes,M,29,3098965,7390
7965,Zada,F,29,3098994,7418
7966,Zymere,M,29,3099023,7809
7967,Aasiyah,F,28,3099051,7329
7968,Abrar,M,28,3099079,7838
7969,Adalena,F,28,3099107,7136
7970,Adanna,F,28,3099135,7773
7971,Adonay,M,28,3099163,7597
7972,Advay,M,28,3099191,7816
7973,Aeryn,F,28,3099219,7178
7974,Ajla,F,28,3099247,7494
7975,Akasha,F,28,3099275,7393
7976,Aline,F,28,3099303,7080
7977,Alp,M,28,3099331,7247
7978,Amanuel,M,28,3099359,7786
7979,Amariyah,F,28,3099387,7279
7980,Amery,F,28,3099415,7708
7981,Amiel,M,28,3099443,7005
7982,Anand,M,28,3099471,7776
7983,Andersyn,F,28,3099499,7117
7984,Anik,M,28,3099527,7897
7985,Anilah,F,28,3099555,7088
7986,Annsley,F,28,3099583,7802
7987,Arnulfo,M,28,3099611,7532
7988,Arshan,M,28,3099639,7640
7989,Assata,F,28,3099667,7571
7990,Averleigh,F,28,3099695,7907
7991,Avielle,F,28,3099723,7181
7992,Azel,M,28,3099751,7720
7993,Aziya,F,28,3099779,7853
7994,Baani,F,28,3099807,7140
7995,Beulah,F,28,3099835,7553
7996,Bill,M,28,3099863,7529
7997,Bodee,M,28,3099891,7936
7998,Bowden,M,28,3099919,7935
7999,Breckin,M,28,3099947,7356
8000,Brix,M,28,3099975,8154
8001,Brixon,M,28,3100003,8902
8002,Caliah,F,28,3100031,8100
8003,Chrissy,F,28,3100059,8377
8004,Christianna,F,28,3100087,8048
8005,Clemente,M,28,3100115,8563
8006,Cort,M,28,3100143,8716
8007,Cosima,F,28,3100171,8363
8008,Daira,F,28,3100199,8161
8009,Dak,M,28,3100227,8835
8010,Damiya,F,28,3100255,8657
8011,Darrel,M,28,3100283,8037
8012,Decklyn,M,28,3100311,8052
8013,Declyn,M,28,3100339,8881
8014,Deema,F,28,3100367,8378
8015,Dejah,F,28,3100395,8867
8016,Demoni,M,28,3100423,8500
8017,Denym,F,28,3100451,8779
8018,Dewey,M,28,3100479,8535
8019,Diem,F,28,3100507,8000
8020,Dynver,F,28,3100535,8169
8021,Elianis,F,28,3100563,8790
8022,Ellyson,F,28,3100591,8632
8023,Emaleigh,F,28,3100619,8651
8024,Emina,F,28,3100647,8984
8025,Emira,F,28,3100675,8847
8026,Emrick,M,28,3100703,8649
8027,Erickson,M,28,3100731,8517
8028,Espen,M,28,3100759,8336
8029,Etienne,M,28,3100787,8965
8030,Exodus,M,28,3100815,8899
8031,Faithlynn,F,28,3100843,8636
8032,Falynn,F,28,3100871,8267
8033,Fatuma,F,28,3100899,8752
8034,Freeman,M,28,3100927,8679
8035,Garret,M,28,3100955,8290
8036,Genisis,F,28,3100983,8681
8037,Geovany,M,28,3101011,8627
8038,Gloriana,F,28,3101039,8913
8039,Griffen,M,28,3101067,8435
8040,Hadrian,M,28,3101095,8680
8041,Harlym,F,28,3101123,8138
8042,Horacio,M,28,3101151,8207
8043,Huntlee,F,28,3101179,8872
8044,Idalia,F,28,3101207,8814
8045,Iniya,F,28,3101235,8262
8046,Isamar,F,28,3101263,8470
8047,Ivelisse,F,28,3101291,8061
8048,Izak,M,28,3101319,8281
8049,Jacee,F,28,3101347,8571
8050,Jacklynn,F,28,3101375,8761
8051,Jacky,M,28,3101403,8859
8052,Jadelynn,F,28,3101431,8033
8053,Jailen,M,28,3101459,8236
8054,Jaiya,F,28,3101487,8766
8055,Jak,M,28,3101515,8746
8056,Jaretzy,F,28,3101543,8640
8057,Jaylie,F,28,3101571,8888
8058,Jayme,F,28,3101599,8776
8059,Jehlani,F,28,3101627,8778
8060,Joachim,M,28,3101655,8385
8061,Jocelyne,F,28,3101683,8256
8062,Joell,M,28,3101711,8031
8063,Johnluke,M,28,3101739,8631
8064,Johnmichael,M,28,3101767,8315
8065,Jovana,F,28,3101795,8895
8066,Kalee,F,28,3101823,8003
8067,Kalista,F,28,3101851,8184
8068,Kamauri,M,28,3101879,8919
8069,Karah,F,28,3101907,8104
8070,Kavish,M,28,3101935,8977
8071,Kayceon,M,28,3101963,8101
8072,Keari,F,28,3101991,8036
8073,Kellyn,F,28,3102019,8591
8074,Kendyll,F,28,3102047,8468
8075,Keshaun,M,28,3102075,8682
8076,Keya,F,28,3102103,8815
8077,Khayden,M,28,3102131,8889
8078,Khylen,M,28,3102159,8851
8079,Kortez,M,28,3102187,8355
8080,Kyllian,M,28,3102215,8014
8081,Kynley,F,28,3102243,8769
8082,Kyrian,M,28,3102271,8670
8083,Leeana,F,28,3102299,8258
8084,Legacie,F,28,3102327,8615
8085,Leobardo,M,28,3102355,8775
8086,Leola,F,28,3102383,8904
8087,Loic,M,28,3102411,8927
8088,Maahi,F,28,3102439,8172
8089,Maclin,M,28,3102467,8370
8090,Madelynne,F,28,3102495,8866
8091,Malanie,F,28,3102523,8007
8092,Marcy,F,28,3102551,8005
8093,Maryah,F,28,3102579,8174
8094,Marykate,F,28,3102607,8479
8095,Mattix,M,28,3102635,8685
8096,Meliah,F,28,3102663,8940
8097,Mena,F,28,3102691,8621
8098,Metztli,F,28,3102719,8495
8099,Mica,M,28,3102747,8486
8100,Michele,F,28,3102775,8076
8101,Mithran,M,28,3102803,8388
8102,Monserrath,F,28,3102831,8043
8103,Nadir,M,28,3102859,8635
8104,Naimah,F,28,3102887,8883
8105,Najma,F,28,3102915,8908
8106,Nandini,F,28,3102943,8997
8107,Nefertari,F,28,3102971,8022
8108,Nikoli,M,28,3102999,8843
8109,Nisa,F,28,3103027,8484
8110,Noreen,F,28,3103055,8567
8111,Nox,M,28,3103083,8109
8112,Nyzir,M,28,3103111,8440
8113,Olly,M,28,3103139,8254
8114,Oumou,F,28,3103167,8091
8115,Prestyn,M,28,3103195,8011
8116,Qais,M,28,3103223,8628
8117,Rachell,F,28,3103251,8643
8118,Rainy,F,28,3103279,8558
8119,Raygan,F,28,3103307,8841
8120,Remmington,M,28,3103335,8754
8121,Remus,M,28,3103363,8783
8122,Reverie,F,28,3103391,8202
8123,Rhyker,M,28,3103419,8064
8124,Riddick,M,28,3103447,8582
8125,Rigby,M,28,3103475,8017
8126,Rin,F,28,3103503,8265
8127,Ripken,M,28,3103531,8427
8128,Rohen,M,28,3103559,8794
8129,Rowena,F,28,3103587,8009
8130,Rudransh,M,28,3103615,8958
8131,Sable,F,28,3103643,8656
8132,Sadia,F,28,3103671,8885
8133,Sameera,F,28,3103699,8467
8134,Sander,M,28,3103727,8299
8135,Sansa,F,28,3103755,8276
8136,Sanya,F,28,3103783,8073
8137,Sayed,M,28,3103811,8639
8138,Sekou,M,28,3103839,8924
8139,Senna,F,28,3103867,8475
8140,September,F,28,3103895,8419
8141,Shakira,F,28,3103923,8978
8142,Shareef,M,28,3103951,8825
8143,Siah,M,28,3103979,8812
8144,Skarlet,F,28,3104007,8802
8145,Tafari,M,28,3104035,8508
8146,Taina,F,28,3104063,8485
8147,Tarek,M,28,3104091,8223
8148,Tatyana,F,28,3104119,8210
8149,Terran,M,28,3104147,8126
8150,Torri,F,28,3104175,8340
8151,Tulip,F,28,3104203,8139
8152,Tyberius,M,28,3104231,8646
8153,Tylor,M,28,3104259,8399
8154,Tyr,M,28,3104287,8727
8155,Ulani,F,28,3104315,8465
8156,Vedh,M,28,3104343,8201
8157,Viha,F,28,3104371,8329
8158,Vihan,M,28,3104399,8331
8159,Vihana,F,28,3104427,8249
8160,Vita,F,28,3104455,8505
8161,Yanira,F,28,3104483,8409
8162,Yarishna,F,28,3104511,8692
8163,Zaidan,M,28,3104539,8248
8164,Zakhari,M,28,3104567,8190
8165,Zalia,F,28,3104595,8434
8166,Zana,F,28,3104623,8324
8167,Zayvier,M,28,3104651,8147
8168,Adrina,F,27,3104678,8897
8169,Aeden,M,27,3104705,8136
8170,Aili,F,27,3104732,8638
8171,Airabella,F,27,3104759,8494
8172,Aissatou,F,27,3104786,8365
8173,Ajah,F,27,3104813,8810
8174,Alesia,F,27,3104840,8454
8175,Alliana,F,27,3104867,8288
8176,Amahia,F,27,3104894,8907
8177,Amberlynn,F,27,3104921,8021
8178,Amity,F,27,3104948,8705
8179,Anaia,F,27,3104975,8909
8180,Antonino,M,27,3105002,8753
8181,Anzal,F,27,3105029,8237
8182,Arcadia,F,27,3105056,8105
8183,Ashe,M,27,3105083,8926
8184,Aubryn,F,27,3105110,8016
8185,Aveya,F,27,3105137,8041
8186,Aveyah,F,27,3105164,8551
8187,Azelie,F,27,3105191,8124
8188,Bashir,M,27,3105218,8326
8189,Bearett,M,27,3105245,8504
8190,Bela,F,27,3105272,8209
8191,Bellah,F,27,3105299,8755
8192,Brailee,F,27,3105326,8348
8193,Brannon,M,27,3105353,8773
8194,Breindy,F,27,3105380,8917
8195,Bryana,F,27,3105407,8103
8196,Calani,F,27,3105434,8120
8197,Calie,F,27,3105461,8443
8198,Camora,F,27,3105488,8711
8199,Can,M,27,3105515,8437
8200,Celena,F,27,3105542,8842
8201,Champ,M,27,3105569,8242
8202,Cherry,F,27,3105596,8569
8203,Chief,M,27,3105623,8970
8204,Christ,M,27,3105650,8832
8205,Coleton,M,27,3105677,8645
8206,Corvin,M,27,3105704,8345
8207,Cyan,F,27,3105731,8381
8208,Dalen,M,27,3105758,8661
8209,Dansby,M,27,3105785,8836
8210,Danylah,F,27,3105812,8665
8211,Darina,F,27,3105839,8819
8212,Darling,F,27,3105866,8644
8213,Dashon,M,27,3105893,8153
8214,Dayson,M,27,3105920,8811
8215,Demonte,M,27,3105947,8514
8216,Desi,F,27,3105974,8957
8217,Dionte,M,27,3106001,8291
8218,Drayce,M,27,3106028,8950
8219,Eamonn,M,27,3106055,8658
8220,Earnest,M,27,3106082,8609
8221,Eilah,F,27,3106109,8887
8222,Elayne,F,27,3106136,8720
8223,Eleyna,F,27,3106163,8960
8224,Elie,M,27,3106190,8831
8225,Ellagrace,F,27,3106217,8697
8226,Elloise,F,27,3106244,8533
8227,Elma,F,27,3106271,8689
8228,Elroy,M,27,3106298,8004
8229,Elya,M,27,3106325,8244
8230,Emon,M,27,3106352,8920
8231,Emylia,F,27,3106379,8394
8232,Esabella,F,27,3106406,8506
8233,Esha,F,27,3106433,8788
8234,Esiah,M,27,3106460,8398
8235,Ethaniel,M,27,3106487,8208
8236,Evolette,F,27,3106514,8898
8237,Falcon,M,27,3106541,8224
8238,Faustina,F,27,3106568,8389
8239,Fausto,M,27,3106595,8916
8240,Favor,F,27,3106622,8583
8241,Filomena,F,27,3106649,8787
8242,Findley,M,27,3106676,8461
8243,Franki,F,27,3106703,8259
8244,Frimet,F,27,3106730,8457
8245,Garry,M,27,3106757,8282
8246,Gaven,M,27,3106784,8972
8247,Grayce,F,27,3106811,8869
8248,Greg,M,27,3106838,8540
8249,Gregor,M,27,3106865,8054
8250,Gwendalyn,F,27,3106892,8706
8251,Hakim,M,27,3106919,8311
8252,Heber,M,27,3106946,8233
8253,Henna,F,27,3106973,8673
8254,Honest,F,27,3107000,8560
8255,Icelynn,F,27,3107027,8659
8256,Isac,M,27,3107054,8613
8257,Jacinta,F,27,3107081,8197
8258,Jacquees,M,27,3107108,8441
8259,Jacy,F,27,3107135,8524
8260,Jah,M,27,3107162,8855
8261,Jahan,M,27,3107189,8930
8262,Jakeem,M,27,3107216,8741
8263,Jaleesa,F,27,3107243,8564
8264,Jancarlos,M,27,3107270,8111
8265,Janine,F,27,3107297,8478
8266,Jannatul,F,27,3107324,8622
8267,Jaymee,F,27,3107351,8588
8268,Jazlene,F,27,3107378,8891
8269,Jerrick,M,27,3107405,8687
8270,Jerson,M,27,3107432,8346
8271,Jhase,M,27,3107459,8428
8272,Joaquim,M,27,3107486,8823
8273,Joely,F,27,3107513,8302
8274,Joplin,F,27,3107540,8123
8275,Julisa,F,27,3107567,8545
8276,Kaelen,M,27,3107594,8853
8277,Kaely,F,27,3107621,8952
8278,Kaili,F,27,3107648,8896
8279,Kairee,M,27,3107675,8739
8280,Kaleth,M,27,3107702,8167
8281,Kasandra,F,27,3107729,8432
8282,Kaspian,M,27,3107756,8724
8283,Katlyn,F,27,3107783,8875
8284,Kaydance,F,27,3107810,8306
8285,Kaylor,F,27,3107837,8666
8286,Kaysin,M,27,3107864,8096
8287,Keiran,M,27,3107891,8472
8288,Kellie,F,27,3107918,8352
8289,Kharma,F,27,3107945,8860
8290,Khyri,M,27,3107972,8117
8291,Khyson,M,27,3107999,8132
8292,Kiarah,F,27,3108026,8572
8293,Kior,F,27,3108053,8531
8294,Kiyara,F,27,3108080,8745
8295,Kohl,M,27,3108107,8137
8296,Kol,M,27,3108134,8953
8297,Kolin,M,27,3108161,8946
8298,Krislynn,F,27,3108188,8182
8299,Kullen,M,27,3108215,8719
8300,Kween,F,27,3108242,8227
8301,Kyanna,F,27,3108269,8586
8302,Lady,F,27,3108296,8900
8303,Leidy,F,27,3108323,8980
8304,Leilanni,F,27,3108350,8598
8305,Lilee,F,27,3108377,8737
8306,Lyndi,F,27,3108404,8584
8307,Lysander,M,27,3108431,8234
8308,Macee,F,27,3108458,8055
8309,Maddalena,F,27,3108485,8406
8310,Madigan,F,27,3108512,8817
8311,Maelle,F,27,3108539,8963
8312,Mahari,F,27,3108566,8088
8313,Maisley,F,27,3108593,8354
8314,Maleyah,F,27,3108620,8453
8315,Mariafernanda,F,27,3108647,8029
8316,Mariely,F,27,3108674,8712
8317,Markayla,F,27,3108701,8992
8318,Marleny,F,27,3108728,8241
8319,Maryan,F,27,3108755,8294
8320,Melanny,F,27,3108782,8922
8321,Mihir,M,27,3108809,8260
8322,Mikal,M,27,3108836,8918
8323,Monse,F,27,3108863,8027
8324,Myers,M,27,3108890,8229
8325,Naiara,F,27,3108917,8390
8326,Naina,F,27,3108944,8251
8327,Neha,F,27,3108971,8882
8328,Nela,F,27,3108998,8039
8329,Nery,M,27,3109025,8292
8330,Nirvi,F,27,3109052,8121
8331,Nitara,F,27,3109079,8809
8332,Nona,F,27,3109106,8599
8333,Norris,M,27,3109133,8058
8334,Nylani,F,27,3109160,8546
8335,Nyles,M,27,3109187,8405
8336,Orlagh,F,27,3109214,8130
8337,Pascal,M,27,3109241,8046
8338,Portia,F,27,3109268,8878
8339,Prosper,M,27,3109295,8183
8340,Quaid,M,27,3109322,8735
8341,Ram,M,27,3109349,8489
8342,Rayn,F,27,3109376,8308
8343,Rayvon,M,27,3109403,8840
8344,Reegan,F,27,3109430,8698
8345,Risha,F,27,3109457,8695
8346,Roselyne,F,27,3109484,8275
8347,Roshan,M,27,3109511,8784
8348,Rozalyn,F,27,3109538,8301
8349,Ruslan,M,27,3109565,8382
8350,Rusty,M,27,3109592,8253
8351,Ryett,M,27,3109619,8667
8352,Ryon,M,27,3109646,8133
8353,Sammuel,M,27,3109673,8852
8354,Samyra,F,27,3109700,8747
8355,Saraiyah,F,27,3109727,8557
8356,Savina,F,27,3109754,8074
8357,Sayla,F,27,3109781,8662
8358,Sebastion,M,27,3109808,8415
8359,Sela,F,27,3109835,8568
8360,Sharlotte,F,27,3109862,8596
8361,Shawna,F,27,3109889,8078
8362,Sheryl,F,27,3109916,8793
8363,Siddhartha,M,27,3109943,8080
8364,Silvio,M,27,3109970,8166
8365,Stark,M,27,3109997,8297
8366,Stewart,M,27,3110024,8594
8367,Storie,F,27,3110051,8700
8368,Suhayla,F,27,3110078,8446
8369,Suleyman,M,27,3110105,8626
8370,Taegan,F,27,3110132,8633
8371,Talha,M,27,3110159,8056
8372,Tamim,M,27,3110186,8165
8373,Tamiyah,F,27,3110213,8025
8374,Tariah,F,27,3110240,8062
8375,Tavin,M,27,3110267,8502
8376,Tayler,F,27,3110294,8911
8377,Taylyn,F,27,3110321,8854
8378,Teaghan,F,27,3110348,8445
8379,Teagyn,F,27,3110375,8925
8380,Tempest,F,27,3110402,8040
8381,Thang,M,27,3110429,8488
8382,Theon,M,27,3110456,8610
8383,Thora,F,27,3110483,8215
8384,Topanga,F,27,3110510,8914
8385,Torrian,M,27,3110537,8024
8386,Townsend,M,27,3110564,8501
8387,Tymber,F,27,3110591,8943
8388,Tyran,M,27,3110618,8122
8389,Tyrique,M,27,3110645,8757
8390,Uriyah,M,27,3110672,8592
8391,Vinson,M,27,3110699,8575
8392,Viridiana,F,27,3110726,8305
8393,Vivi,F,27,3110753,8837
8394,Walton,M,27,3110780,8295
8395,Winsley,F,27,3110807,8845
8396,Xara,F,27,3110834,8270
8397,Yareth,M,27,3110861,8328
8398,Yeimi,F,27,3110888,8309
8399,Yoan,M,27,3110915,8108
8400,Zaeden,M,27,3110942,8214
8401,Zay,M,27,3110969,8799
8402,Zebulon,M,27,3110996,8617
8403,Zionna,F,27,3111023,8335
8404,Zorawar,M,27,3111050,8865
8405,Zyrah,F,27,3111077,8447
8406,Aadhira,F,26,3111103,8496
8407,Aashi,F,26,3111129,8266
8408,Aayra,F,26,3111155,8143
8409,Adali,F,26,3111181,8945
8410,Adhrit,M,26,3111207,8573
8411,Adya,F,26,3111233,8798
8412,Aelin,F,26,3111259,8570
8413,Aidric,M,26,3111285,8903
8414,Aishani,F,26,3111311,8949
8415,Alesha,F,26,3111337,8618
8416,Alliyah,F,26,3111363,8278
8417,Aluna,F,26,3111389,8772
8418,Amazing,F,26,3111415,8601
8419,Anaaya,F,26,3111441,8450
8420,Aras,M,26,3111467,8075
8421,Arjunreddy,M,26,3111493,8642
8422,Arlin,M,26,3111519,8424
8423,Arsen,M,26,3111545,8192
8424,Asra,F,26,3111571,8050
8425,Auburn,F,26,3111597,8941
8426,Ausar,M,26,3111623,8268
8427,Aviyah,F,26,3111649,8232
8428,Axtyn,M,26,3111675,8743
8429,Ayeza,F,26,3111701,8019
8430,Ayomide,M,26,3111727,8316
8431,Aza,F,26,3111753,8641
8432,Azula,F,26,3111779,8813
8433,Bayne,M,26,3111805,8053
8434,Brandyn,M,26,3111831,8362
8435,Brees,M,26,3111857,8683
8436,Brylin,M,26,3111883,8071
8437,Brynne,F,26,3111909,8364
8438,Bryon,M,26,3111935,8777
8439,Camdon,M,26,3111961,8148
8440,Carlin,M,26,3111987,8555
8441,Cashius,M,26,3112013,8205
8442,Cato,M,26,3112039,8333
8443,Chizaram,F,26,3112065,8522
8444,Ciera,F,26,3112091,8964
8445,Cinthia,F,26,3112117,8795
8446,Cliff,M,26,3112143,8995
8447,Connell,M,26,3112169,8516
8448,Corwin,M,26,3112195,8822
8449,Coulson,M,26,3112221,8797
8450,Daizy,F,26,3112247,8469
8451,Damonte,M,26,3112273,8548
8452,Darcey,F,26,3112299,8082
8453,Darielle,F,26,3112325,8245
8454,Davontae,M,26,3112351,8134
8455,Daxten,M,26,3112377,8235
8456,Dayne,M,26,3112403,8285
8457,Daysha,F,26,3112429,8806
8458,Deckard,M,26,3112455,8519
8459,Demiyah,F,26,3112481,8781
8460,Deron,M,26,3112507,8559
8461,Diala,F,26,3112533,8393
8462,Doc,M,26,3112559,8894
8463,Donatello,M,26,3112585,8274
8464,Dontavious,M,26,3112611,8951
8465,Doreen,F,26,3112637,8503
8466,Dreyson,M,26,3112663,8668
8467,Eisa,M,26,3112689,8079
8468,Elaya,F,26,3112715,8796
8469,Elenor,F,26,3112741,8566
8470,Ellana,F,26,3112767,8688
8471,Ellenor,F,26,3112793,8026
8472,Emillia,F,26,3112819,8748
8473,Eshal,F,26,3112845,8347
8474,Ezran,M,26,3112871,8113
8475,Ezren,M,26,3112897,8956
8476,Fanta,F,26,3112923,8530
8477,Fraida,F,26,3112949,8947
8478,Friedrich,M,26,3112975,8180
8479,Grover,M,26,3113001,8938
8480,Gurfateh,M,26,3113027,8750
8481,Gypsy,F,26,3113053,8401
8482,Han,M,26,3113079,8534
8483,Hannia,F,26,3113105,8045
8484,Haydn,M,26,3113131,8634
8485,Hendricks,M,26,3113157,8471
8486,Henslee,F,26,3113183,8142
8487,Hubert,M,26,3113209,8411
8488,Iam,M,26,3113235,8890
8489,Irena,F,26,3113261,8002
8490,Isacc,M,26,3113287,8910
8491,Itzia,F,26,3113313,8975
8492,Ivyana,F,26,3113339,8608
8493,Izaya,M,26,3113365,8886
8494,Jamaria,F,26,3113391,8955
8495,Jameelah,F,26,3113417,8448
8496,Janel,F,26,3113443,8403
8497,Jasmina,F,26,3113469,8317
8498,Jaxtin,M,26,3113495,8303
8499,Jebediah,M,26,3113521,8710
8500,Jeremie,M,26,3113547,8371
8501,Jovian,M,26,3113573,8459
8502,Judas,M,26,3113599,8325
8503,Kaija,F,26,3113625,8768
8504,Kaior,F,26,3113651,8361
8505,Kale,M,26,3113677,8868
8506,Karmella,F,26,3113703,8178
8507,Kasia,F,26,3113729,8824
8508,Kathalina,F,26,3113755,8587
8509,Kayle,F,26,3113781,8736
8510,Kendon,M,26,3113807,8492
8511,Khalea,F,26,3113833,8764
8512,Khushi,F,26,3113859,8654
8513,Kierstyn,F,26,3113885,8372
8514,Kimberley,F,26,3113911,8402
8515,Klover,F,26,3113937,8759
8516,Kowen,M,26,3113963,8884
8517,Krislyn,F,26,3113989,8272
8518,Lareina,F,26,3114015,8498
8519,Lavell,M,26,3114041,8722
8520,Layanna,F,26,3114067,8523
8521,Laylanie,F,26,3114093,8125
8522,Layloni,F,26,3114119,8175
8523,Leeam,M,26,3114145,8044
8524,Lelan,M,26,3114171,8543
8525,Lexus,F,26,3114197,8511
8526,Lilya,F,26,3114223,8738
8527,Livvy,F,26,3114249,8526
8528,Maddon,M,26,3114275,8400
8529,Mahlani,F,26,3114301,8525
8530,Mailyn,F,26,3114327,8107
8531,Makaila,F,26,3114353,8981
8532,Maleena,F,26,3114379,8015
8533,Marly,F,26,3114405,8386
8534,Maxemiliano,M,26,3114431,8358
8535,Mayrin,F,26,3114457,8789
8536,Maysa,F,26,3114483,8426
8537,Meliyah,F,26,3114509,8629
8538,Michel,M,26,3114535,8612
8539,Mikenzie,F,26,3114561,8653
8540,Miliani,F,26,3114587,8480
8541,Miral,F,26,3114613,8690
8542,Miri,F,26,3114639,8593
8543,Mishika,F,26,3114665,8159
8544,Misk,F,26,3114691,8756
8545,Munir,M,26,3114717,8198
8546,Myer,M,26,3114743,8990
8547,Namiko,F,26,3114769,8937
8548,Nasiah,M,26,3114795,8179
8549,Neko,M,26,3114821,8780
8550,Niang,F,26,3114847,8310
8551,Nicola,M,26,3114873,8707
8552,Nuha,F,26,3114899,8173
8553,Nyari,F,26,3114925,8864
8554,Nymir,M,26,3114951,8994
8555,Nyssa,F,26,3114977,8094
8556,Oberon,M,26,3115003,8562
8557,Olan,M,26,3115029,8879
8558,Oleg,M,26,3115055,8420
8559,Orly,F,26,3115081,8375
8560,Oryn,M,26,3115107,8547
8561,Owyn,M,26,3115133,8932
8562,Pinchas,M,26,3115159,8969
8563,Quintus,M,26,3115185,8491
8564,Raegen,F,26,3115211,8942
8565,Raeghan,F,26,3115237,8416
8566,Raisa,F,26,3115263,8068
8567,Rajveer,M,26,3115289,8289
8568,Randolph,M,26,3115315,8521
8569,Reba,F,26,3115341,8144
8570,Rehmat,F,26,3115367,8067
8571,Renner,M,26,3115393,8332
8572,Ripp,M,26,3115419,8035
8573,Rishik,M,26,3115445,8069
8574,Rj,M,26,3115471,8703
8575,Romell,M,26,3115497,8431
8576,Rona,F,26,3115523,8731
8577,Ryken,M,26,3115549,8151
8578,Rylea,F,26,3115575,8576
8579,Saachi,F,26,3115601,8115
8580,Saffron,F,26,3115627,8590
8581,Sania,F,26,3115653,8194
8582,Selin,F,26,3115679,8714
8583,Seline,F,26,3115705,8734
8584,Shaira,F,26,3115731,8433
8585,Shanell,F,26,3115757,8463
8586,Sharif,M,26,3115783,8349
8587,Shayleigh,F,26,3115809,8455
8588,Shriyan,M,26,3115835,8850
8589,Shyloh,F,26,3115861,8261
8590,Sofi,F,26,3115887,8520
8591,Sorin,M,26,3115913,8935
8592,Stryder,M,26,3115939,8458
8593,Sudais,M,26,3115965,8991
8594,Syair,M,26,3115991,8973
8595,Syriah,F,26,3116017,8070
8596,Tadhg,M,26,3116043,8844
8597,Thayne,M,26,3116069,8760
8598,Torian,M,26,3116095,8771
8599,Torrence,M,26,3116121,8247
8600,Tycho,M,26,3116147,8931
8601,Tyreek,M,26,3116173,8436
8602,Webb,M,26,3116199,8084
8603,Wilber,M,26,3116225,8696
8604,Xitlaly,F,26,3116251,8858
8605,Xoey,F,26,3116277,8186
8606,Xzavion,M,26,3116303,8987
8607,Yadriel,M,26,3116329,8204
8608,Yamil,M,26,3116355,8474
8609,Yared,M,26,3116381,8131
8610,Yazmine,F,26,3116407,8383
8611,Yovani,M,26,3116433,8013
8612,Zaidee,F,26,3116459,8751
8613,Zamiah,F,26,3116485,8532
8614,Zeyad,M,26,3116511,8701
8615,Zivah,F,26,3116537,8298
8616,Zohan,M,26,3116563,8833
8617,Zuriah,F,26,3116589,8684
8618,Aarish,M,25,3116614,8218
8619,Aariya,F,25,3116639,8481
8620,Adric,M,25,3116664,8538
8621,Aissata,F,25,3116689,8413
8622,Aiva,F,25,3116714,8083
8623,Aleysha,F,25,3116739,8119
8624,Alida,F,25,3116764,8723
8625,Alizabeth,F,25,3116789,8001
8626,Allena,F,25,3116814,8047
8627,Almir,M,25,3116839,8396
8628,Ama,F,25,3116864,8140
8629,Amador,M,25,3116889,8216
8630,Ameria,F,25,3116914,8128
8631,Anaise,F,25,3116939,8318
8632,Annasophia,F,25,3116964,8553
8633,Aradhya,F,25,3116989,8112
8634,Ardyn,F,25,3117014,8976
8635,Areej,F,25,3117039,8407
8636,Ariam,F,25,3117064,8304
8637,Aristotle,M,25,3117089,8971
8638,Asai,M,25,3117114,8838
8639,Asani,F,25,3117139,8625
8640,Augusto,M,25,3117164,8906
8641,Ayham,M,25,3117189,8669
8642,Azarah,F,25,3117214,8676
8643,Azelia,F,25,3117239,8356
8644,Bensen,M,25,3117264,8417
8645,Bentzion,M,25,3117289,8314
8646,Bintou,F,25,3117314,8395
8647,Blane,M,25,3117339,8032
8648,Brandan,M,25,3117364,8829
8649,Brantly,M,25,3117389,8518
8650,Braxson,M,25,3117414,8418
8651,Braycen,M,25,3117439,8099
8652,Braylan,M,25,3117464,8334
8653,Breanne,F,25,3117489,8966
8654,Brier,M,25,3117514,8699
8655,Broden,M,25,3117539,8863
8656,Buckley,M,25,3117564,8803
8657,Cailynn,F,25,3117589,8155
8658,Camilah,F,25,3117614,8959
8659,Camiya,F,25,3117639,8758
8660,Celestina,F,25,3117664,8671
8661,Chelsy,F,25,3117689,8782
8662,Ciel,M,25,3117714,8544
8663,Cirilla,F,25,3117739,8164
8664,Clancy,M,25,3117764,8996
8665,Clarabelle,F,25,3117789,8828
8666,Clio,F,25,3117814,8264
8667,Daer,M,25,3117839,8619
8668,Daija,F,25,3117864,8211
8669,Damia,F,25,3117889,8444
8670,Darey,M,25,3117914,8157
8671,Darleen,F,25,3117939,8871
8672,Darrien,M,25,3117964,8733
8673,Daysi,F,25,3117989,8221
8674,Dea,F,25,3118014,8846
8675,Deaglan,M,25,3118039,8357
8676,Deante,M,25,3118064,8279
8677,Deluca,M,25,3118089,8397
8678,Demetrios,M,25,3118114,8655
8679,Devlin,M,25,3118139,8343
8680,Devonta,M,25,3118164,8225
8681,Dillion,M,25,3118189,8246
8682,Donavon,M,25,3118214,8944
8683,Dyllan,M,25,3118239,8637
8684,Eliani,F,25,3118264,8537
8685,Eligh,M,25,3118289,8857
8686,Eloah,F,25,3118314,8749
8687,Elyon,M,25,3118339,8239
8688,Embree,F,25,3118364,8219
8689,Emet,M,25,3118389,8536
8690,Emilynn,F,25,3118414,8962
8691,Enrico,M,25,3118439,8477
8692,Erion,M,25,3118464,8509
8693,Ezariah,M,25,3118489,8611
8694,Fionn,M,25,3118514,8089
8695,Flavio,M,25,3118539,8725
8696,Franklyn,M,25,3118564,8152
8697,Garner,M,25,3118589,8464
8698,Garrick,M,25,3118614,8660
8699,Georgette,F,25,3118639,8452
8700,Gil,M,25,3118664,8193
8701,Graycee,F,25,3118689,8989
8702,Hafsah,F,25,3118714,8369
8703,Hajar,F,25,3118739,8541
8704,Hanad,M,25,3118764,8577
8705,Hasani,M,25,3118789,8051
8706,Hawthorne,M,25,3118814,8552
8707,Henrick,M,25,3118839,8038
8708,Henson,M,25,3118864,8273
8709,Huxlee,M,25,3118889,8366
8710,Ibrahima,M,25,3118914,8979
8711,Idaly,F,25,3118939,8018
8712,Isella,F,25,3118964,8721
8713,Jaclynn,F,25,3118989,8339
8714,Jaison,M,25,3119014,8049
8715,Jakayden,M,25,3119039,8188
8716,Jalaysia,F,25,3119064,8226
8717,Jaleigha,F,25,3119089,8581
8718,Jamey,M,25,3119114,8368
8719,Jaxiel,M,25,3119139,8359
8720,Jayon,M,25,3119164,8954
8721,Jaythan,M,25,3119189,8392
8722,Jazlin,F,25,3119214,8097
8723,Jentri,F,25,3119239,8466
8724,Jhoan,M,25,3119264,8087
8725,Jian,M,25,3119289,8672
8726,Jiyah,F,25,3119314,8129
8727,Jori,F,25,3119339,8379
8728,Jorie,F,25,3119364,8127
8729,Joseangel,M,25,3119389,8967
8730,Jotham,M,25,3119414,8090
8731,Joury,F,25,3119439,8231
8732,Jr,M,25,3119464,8718
8733,Kacy,F,25,3119489,8320
8734,Kadynce,F,25,3119514,8585
8735,Kalahni,F,25,3119539,8708
8736,Kamoura,F,25,3119564,8213
8737,Kansas,F,25,3119589,8250
8738,Karlyn,F,25,3119614,8312
8739,Karsynn,F,25,3119639,8028
8740,Kayci,F,25,3119664,8008
8741,Kazi,M,25,3119689,8499
8742,Keagen,M,25,3119714,8556
8743,Kendry,M,25,3119739,8414
8744,Kenson,M,25,3119764,8821
8745,Keylan,M,25,3119789,8081
8746,Khairo,M,25,3119814,8876
8747,Khaloni,F,25,3119839,8283
8748,Kiarra,F,25,3119864,8422
8749,Kingstin,M,25,3119889,8373
8750,Kleo,F,25,3119914,8818
8751,Kloey,F,25,3119939,8187
8752,Korinne,F,25,3119964,8595
8753,Kristal,F,25,3119989,8020
8754,Kriti,F,25,3120014,8602
8755,Kymora,F,25,3120039,8490
8756,Kynzleigh,F,25,3120064,8939
8757,Lamir,M,25,3120089,8578
8758,Laurynn,F,25,3120114,8709
8759,Laykin,F,25,3120139,8929
8760,Leeroy,M,25,3120164,8012
8761,Leira,F,25,3120189,8367
8762,Lio,M,25,3120214,8286
8763,Luiz,M,25,3120239,8410
8764,Lundyn,F,25,3120264,8141
8765,Madi,F,25,3120289,8791
8766,Maebry,F,25,3120314,8086
8767,Maesyn,F,25,3120339,8542
8768,Magdiel,M,25,3120364,8384
8769,Mairead,F,25,3120389,8849
8770,Majesti,F,25,3120414,8429
8771,Makenlee,F,25,3120439,8901
8772,Makynzie,F,25,3120464,8150
8773,Maliq,M,25,3120489,8614
8774,Manning,M,25,3120514,8322
8775,Marah,F,25,3120539,8620
8776,Marshal,M,25,3120564,8808
8777,Mattox,M,25,3120589,8342
8778,Maude,F,25,3120614,8146
8779,Mayven,F,25,3120639,8702
8780,Meah,F,25,3120664,8185
8781,Melonie,F,25,3120689,8063
8782,Merari,F,25,3120714,8515
8783,Mihika,F,25,3120739,8580
8784,Miking,M,25,3120764,8116
8785,Milayah,F,25,3120789,8162
8786,Miyanna,F,25,3120814,8664
8787,Modesty,F,25,3120839,8512
8788,Moon,F,25,3120864,8065
8789,Mulani,F,25,3120889,8023
8790,Mylani,F,25,3120914,8066
8791,Nahara,F,25,3120939,8092
8792,Nailea,F,25,3120964,8528
8793,Nallely,F,25,3120989,8217
8794,Namya,F,25,3121014,8826
8795,Nana,M,25,3121039,8717
8796,Naveyah,F,25,3121064,8439
8797,Neiko,M,25,3121089,8257
8798,Niva,F,25,3121114,8507
8799,Noely,F,25,3121139,8442
8800,Oaken,M,25,3121164,8102
8801,Odell,M,25,3121189,8805
8802,Olvin,M,25,3121214,8057
8803,Othman,M,25,3121239,8933
8804,Ottilie,F,25,3121264,8767
8805,Parisa,F,25,3121289,8200
8806,Parrish,M,25,3121314,8807
8807,Paxtyn,M,25,3121339,8691
8808,Pheobe,F,25,3121364,8816
8809,Philippe,M,25,3121389,8561
8810,Rayhan,M,25,3121414,8287
8811,Reeves,M,25,3121439,8195
8812,Rolland,M,25,3121464,8968
8813,Rosaly,F,25,3121489,8999
8814,Roseanna,F,25,3121514,8156
8815,Roza,F,25,3121539,8170
8816,Ruhaan,M,25,3121564,8694
8817,Ryler,M,25,3121589,8230
8818,Salih,M,25,3121614,8307
8819,Saxton,M,25,3121639,8177
8820,Sehaj,F,25,3121664,8704
8821,Seren,F,25,3121689,8862
8822,Seylah,F,25,3121714,8892
8823,Sidrah,F,25,3121739,8792
8824,Soledad,F,25,3121764,8255
8825,Sufyan,M,25,3121789,8327
8826,Suhani,F,25,3121814,8663
8827,Suhayb,M,25,3121839,8321
8828,Talulah,F,25,3121864,8674
8829,Talynn,F,25,3121889,8928
8830,Tamiya,F,25,3121914,8527
8831,Tauren,M,25,3121939,8030
8832,Tommi,F,25,3121964,8539
8833,Torrin,M,25,3121989,8510
8834,Torsten,M,25,3122014,8983
8835,Tracey,F,25,3122039,8600
8836,Tynlee,F,25,3122064,8425
8837,Tyrie,M,25,3122089,8060
8838,Vasilisa,F,25,3122114,8912
8839,Vella,F,25,3122139,8603
8840,Wesleigh,F,25,3122164,8986
8841,Whittaker,M,25,3122189,8228
8842,Wilfred,M,25,3122214,8550
8843,Xayvion,M,25,3122239,8936
8844,Yannick,M,25,3122264,8077
8845,Yohannes,M,25,3122289,8786
8846,Yuriel,M,25,3122314,8337
8847,Zamaria,F,25,3122339,8597
8848,Zamiya,F,25,3122364,8196
8849,Zayed,M,25,3122389,8742
8850,Zeek,M,25,3122414,8095
8851,Zehra,F,25,3122439,8269
8852,Zoriah,F,25,3122464,8729
8853,Adalin,F,24,3122488,8168
8854,Aemon,M,24,3122512,8856
8855,Ahmani,F,24,3122536,8607
8856,Ahnaf,M,24,3122560,8998
8857,Ailynn,F,24,3122584,8961
8858,Aitanna,F,24,3122608,8482
8859,Aivah,F,24,3122632,8770
8860,Akshar,M,24,3122656,8360
8861,Alaynna,F,24,3122680,8834
8862,Alysa,F,24,3122704,8993
8863,Alyx,F,24,3122728,8923
8864,Amjad,M,24,3122752,8344
8865,Amyia,F,24,3122776,8181
8866,Anapaula,F,24,3122800,8800
8867,Angelika,F,24,3122824,8554
8868,Annalea,F,24,3122848,8765
8869,Anthonella,F,24,3122872,8240
8870,Anyah,F,24,3122896,8212
8871,Arisa,F,24,3122920,8982
8872,Arriana,F,24,3122944,8730
8873,Ascher,M,24,3122968,8412
8874,Ashby,M,24,3122992,8827
8875,Aundrea,F,24,3123016,8149
8876,Aurea,F,24,3123040,8762
8877,Aurorah,F,24,3123064,8487
8878,Austynn,F,24,3123088,8624
8879,Avleen,F,24,3123112,8493
8880,Avnoor,F,24,3123136,8010
8881,Avram,M,24,3123160,8203
8882,Behr,M,24,3123184,8606
8883,Bindi,F,24,3123208,8430
8884,Blu,M,24,3123232,8630
8885,Boruch,M,24,3123256,8110
8886,Bosco,M,24,3123280,8820
8887,Braxon,M,24,3123304,8740
8888,Brazen,M,24,3123328,8675
8889,Brecklynn,F,24,3123352,8574
8890,Brexlee,F,24,3123376,8222
8891,Brianda,F,24,3123400,8921
8892,Briany,F,24,3123424,8145
8893,Bright,M,24,3123448,8988
8894,Brodee,M,24,3123472,8449
8895,Burton,M,24,3123496,8893
8896,Cage,M,24,3123520,8085
8897,Camry,F,24,3123544,8059
8898,Camrynn,F,24,3123568,8693
8899,Carden,M,24,3123592,8072
8900,Cass,M,24,3123616,8376
8901,Chaitra,F,24,3123640,8985
8902,Cheikh,M,24,3123664,8839
8903,Cheskel,M,24,3123688,8948
8904,Coulter,M,24,3123712,8006
8905,Daiana,F,24,3123736,8199
8906,Danelly,F,24,3123760,8934
8907,Darrian,M,24,3123784,8549
8908,Davianna,F,24,3123808,8118
8909,Dawud,M,24,3123832,8189
8910,Dayani,F,24,3123856,8565
8911,Dayvon,M,24,3123880,8220
8912,Devynn,F,24,3123904,8529
8913,Dexton,M,24,3123928,8861
8914,Donato,M,24,3123952,8351
8915,Donta,M,24,3123976,8763
8916,Dorcas,F,24,3124000,8915
8917,Dreux,M,24,3124024,8650
8918,Dunya,F,24,3124048,8338
8919,Edahi,M,24,3124072,8423
8920,Eduard,M,24,3124096,8874
8921,Elanie,F,24,3124120,8293
8922,Elektra,F,24,3124144,8686
8923,Eliyas,M,24,3124168,8460
8924,Elizaveta,F,24,3124192,8380
8925,Elyzabeth,F,24,3124216,8284
8926,Emalie,F,24,3124240,8513
8927,Emmerie,F,24,3124264,8341
8928,Eshan,M,24,3124288,8408
8929,Exavier,M,24,3124312,8277
8930,Hamad,M,24,3124336,8271
8931,Haneen,F,24,3124360,8191
8932,Harmon,M,24,3124384,8873
8933,Honora,F,24,3124408,8263
8934,Hutch,M,24,3124432,8880
8935,Hutton,M,24,3124456,8238
8936,Ilsa,F,24,3124480,8728
8937,Irlanda,F,24,3124504,8135
8938,Jacorey,M,24,3124528,8605
8939,Jadah,F,24,3124552,8774
8940,Jaheem,M,24,3124576,8848
8941,Jaidan,M,24,3124600,8098
8942,Jakyla,F,24,3124624,8678
8943,Jakyrie,M,24,3124648,8732
8944,Jamyah,F,24,3124672,8391
8945,Jarren,M,24,3124696,8252
8946,Jermany,F,24,3124720,8677
8947,Jewelz,F,24,3124744,8830
8948,Jhonatan,M,24,3124768,8652
8949,Jihad,M,24,3124792,8300
8950,Johnna,F,24,3124816,8106
8951,Josiel,M,24,3124840,8726
8952,Kadeem,M,24,3124864,8804
8953,Kalan,M,24,3124888,8042
8954,Kalin,M,24,3124912,8353
8955,Kamdon,M,24,3124936,8473
8956,Kariah,F,24,3124960,8476
8957,Karishma,F,24,3124984,8648
8958,Kariyah,F,24,3125008,8093
8959,Karliah,F,24,3125032,8350
8960,Karver,M,24,3125056,8456
8961,Karyme,F,24,3125080,8870
8962,Kattaleia,F,24,3125104,8319
8963,Kayana,F,24,3125128,8905
8964,Kaylan,F,24,3125152,8323
8965,Kaziah,F,24,3125176,8160
8966,Keane,M,24,3125200,8163
8967,Keiden,M,24,3125224,8877
8968,Keigan,M,24,3125248,8034
8969,Kelley,F,24,3125272,8176
8970,Kemper,M,24,3125296,8330
8971,Keyari,F,24,3125320,8421
8972,Keylee,F,24,3125344,8462
8973,Keyra,F,24,3125368,8114
8974,Khalila,F,24,3125392,8404
8975,Khiara,F,24,3125416,8158
8976,Khristopher,M,24,3125440,8243
8977,Khyro,M,24,3125464,8801
8978,Kolbi,F,24,3125488,8374
8979,Kroy,M,24,3125512,8744
8980,Kyrielle,F,24,3125536,8171
8981,Laiba,F,24,3125560,8713
8982,Laiden,M,24,3125584,8579
8983,Lakshmi,F,24,3125608,8280
8984,Langley,F,24,3125632,8451
8985,Laveah,F,24,3125656,8438
8986,Leina,F,24,3125680,8623
8987,Lelia,F,24,3125704,8604
8988,Lenni,F,24,3125728,8387
8989,Livianna,F,24,3125752,8715
8990,Loralie,F,24,3125776,8974
8991,Lunah,F,24,3125800,8589
8992,Lyndsey,F,24,3125824,8206
8993,Maaz,M,24,3125848,8296
8994,Macklyn,F,24,3125872,8616
8995,Mackson,M,24,3125896,8313
8996,Maddyson,F,24,3125920,8647
8997,Mahika,F,24,3125944,8483
8998,Mako,M,24,3125968,8785
8999,Malana,F,24,3125992,8497
9000,Marylin,F,24,3126016,9833
9001,Mckinsley,F,24,3126040,9625
9002,Mehr,F,24,3126064,9042
9003,Melchizedek,M,24,3126088,9629
9004,Melrose,F,24,3126112,9617
9005,Mikko,M,24,3126136,9331
9006,Miklo,M,24,3126160,9463
9007,Million,M,24,3126184,9184
9008,Mister,M,24,3126208,9039
9009,Miyana,F,24,3126232,9002
9010,Moksh,M,24,3126256,9310
9011,Mora,F,24,3126280,9700
9012,Mose,M,24,3126304,9215
9013,Muslima,F,24,3126328,9797
9014,Nabiha,F,24,3126352,9147
9015,Naod,M,24,3126376,9520
9016,Naseem,M,24,3126400,9411
9017,Neomi,F,24,3126424,9428
9018,Niki,F,24,3126448,9440
9019,Nithya,F,24,3126472,9299
9020,Noemie,F,24,3126496,9951
9021,Norielle,F,24,3126520,9825
9022,Octavious,M,24,3126544,9785
9023,Odyn,M,24,3126568,9862
9024,Oliviah,F,24,3126592,9202
9025,Olsen,M,24,3126616,9972
9026,Paden,M,24,3126640,9924
9027,Payslee,F,24,3126664,9774
9028,Pennelope,F,24,3126688,9271
9029,Quinnlyn,F,24,3126712,9760
9030,Raigan,F,24,3126736,9770
9031,Raynor,M,24,3126760,9352
9032,Reena,F,24,3126784,9655
9033,Refael,M,24,3126808,9189
9034,Remmie,F,24,3126832,9883
9035,Rhen,F,24,3126856,9200
9036,Rhyland,M,24,3126880,9206
9037,Rivkah,F,24,3126904,9811
9038,Riyana,F,24,3126928,9931
9039,Robby,M,24,3126952,9935
9040,Roselie,F,24,3126976,9915
9041,Rumaysa,F,24,3127000,9581
9042,Ruqayyah,F,24,3127024,9131
9043,Safaa,F,24,3127048,9921
9044,Saida,F,24,3127072,9045
9045,Savon,M,24,3127096,9021
9046,Shayden,M,24,3127120,9956
9047,Shaylin,F,24,3127144,9305
9048,Shekinah,F,24,3127168,9869
9049,Shivaan,M,24,3127192,9875
9050,Shrey,M,24,3127216,9683
9051,Solveig,F,24,3127240,9987
9052,Soul,M,24,3127264,9609
9053,Syon,M,24,3127288,9217
9054,Takari,M,24,3127312,9540
9055,Tamya,F,24,3127336,9678
9056,Tazanna,F,24,3127360,9595
9057,Tiernan,M,24,3127384,9194
9058,Tigran,M,24,3127408,9529
9059,Tito,M,24,3127432,9333
9060,Torrance,M,24,3127456,9322
9061,Toryn,F,24,3127480,9258
9062,Trust,M,24,3127504,9933
9063,Walid,M,24,3127528,9459
9064,Waylyn,M,24,3127552,9077
9065,Woodson,M,24,3127576,9174
9066,Xane,M,24,3127600,9904
9067,Yan,M,24,3127624,9460
9068,Yanelly,F,24,3127648,9659
9069,Yaziel,M,24,3127672,9086
9070,Yoselyn,F,24,3127696,9330
9071,Yosiah,M,24,3127720,9269
9072,Zaelyn,F,24,3127744,9981
9073,Zahmir,M,24,3127768,9619
9074,Zair,M,24,3127792,9507
9075,Zamar,M,24,3127816,9439
9076,Zaviyar,M,24,3127840,9185
9077,Zayveon,M,24,3127864,9006
9078,Zemora,F,24,3127888,9699
9079,Zenia,F,24,3127912,9388
9080,Aadhav,M,23,3127935,9308
9081,Aadhvik,M,23,3127958,9903
9082,Aalani,F,23,3127981,9517
9083,Abdulloh,M,23,3128004,9631
9084,Abriel,M,23,3128027,9616
9085,Ainoha,F,23,3128050,9153
9086,Alasdair,M,23,3128073,9193
9087,Aleenah,F,23,3128096,9690
9088,Alitza,F,23,3128119,9197
9089,Alura,F,23,3128142,9847
9090,Amais,M,23,3128165,9400
9091,Amaura,F,23,3128188,9312
9092,Amr,M,23,3128211,9533
9093,Anaika,F,23,3128234,9634
9094,Anav,M,23,3128257,9228
9095,Andee,F,23,3128280,9778
9096,Aneesa,F,23,3128303,9084
9097,Ariani,F,23,3128326,9889
9098,Arilyn,F,23,3128349,9320
9099,Arnoldo,M,23,3128372,9236
9100,Artemio,M,23,3128395,9163
9101,Audrielle,F,23,3128418,9503
9102,Axiel,M,23,3128441,9885
9103,Azan,M,23,3128464,9001
9104,Azarias,M,23,3128487,9764
9105,Bahar,F,23,3128510,9295
9106,Berl,M,23,3128533,9513
9107,Bibiana,F,23,3128556,9410
9108,Blessings,F,23,3128579,9644
9109,Bleu,M,23,3128602,9713
9110,Brixtyn,F,23,3128625,9864
9111,Bryelle,F,23,3128648,9944
9112,Caidence,F,23,3128671,9512
9113,Caisley,F,23,3128694,9584
9114,Caston,M,23,3128717,9314
9115,Catalia,F,23,3128740,9574
9116,Chanell,F,23,3128763,9800
9117,Christiano,M,23,3128786,9284
9118,Cloud,M,23,3128809,9640
9119,Conall,M,23,3128832,9730
9120,Conlan,M,23,3128855,9019
9121,Corbett,M,23,3128878,9857
9122,Corie,F,23,3128901,9092
9123,Courtlyn,F,23,3128924,9950
9124,Cozette,F,23,3128947,9588
9125,Cristel,F,23,3128970,9610
9126,Cyra,F,23,3128993,9041
9127,Daila,F,23,3129016,9447
9128,Damario,M,23,3129039,9977
9129,Dartagnan,M,23,3129062,9635
9130,Davante,M,23,3129085,9339
9131,Dawit,M,23,3129108,9286
9132,Dawsen,M,23,3129131,9738
9133,Debbie,F,23,3129154,9473
9134,Demetrio,M,23,3129177,9957
9135,Derik,M,23,3129200,9704
9136,Derrion,M,23,3129223,9970
9137,Devany,F,23,3129246,9848
9138,Dondre,M,23,3129269,9493
9139,Dorien,M,23,3129292,9091
9140,Drea,F,23,3129315,9321
9141,Eh,M,23,3129338,9702
9142,Ehan,M,23,3129361,9676
9143,Elazar,M,23,3129384,9403
9144,Elija,M,23,3129407,9510
9145,Emileigh,F,23,3129430,9293
9146,Emmalyne,F,23,3129453,9666
9147,Endia,F,23,3129476,9218
9148,Enya,F,23,3129499,9720
9149,Eriel,F,23,3129522,9546
9150,Erina,F,23,3129545,9222
9151,Errol,M,23,3129568,9083
9152,Escher,M,23,3129591,9840
9153,Ethel,F,23,3129614,9122
9154,Evelia,F,23,3129637,9088
9155,Everlea,F,23,3129660,9280
9156,Evvie,F,23,3129683,9502
9157,Findlay,M,23,3129706,9784
9158,Frady,F,23,3129729,9292
9159,Freida,F,23,3129752,9022
9160,Galia,F,23,3129775,9135
9161,Gerrit,M,23,3129798,9650
9162,Giacomo,M,23,3129821,9213
9163,Gimena,F,23,3129844,9243
9164,Ginevra,F,23,3129867,9592
9165,Gorgeous,F,23,3129890,9768
9166,Greycen,M,23,3129913,9246
9167,Griffyn,M,23,3129936,9767
9168,Gweneth,F,23,3129959,9115
9169,Hale,M,23,3129982,9877
9170,Harmani,F,23,3130005,9945
9171,Hartlee,F,23,3130028,9549
9172,Havilah,F,23,3130051,9721
9173,Homer,M,23,3130074,9923
9174,Homero,M,23,3130097,9874
9175,Huey,M,23,3130120,9724
9176,Iliza,F,23,3130143,9394
9177,Irfan,M,23,3130166,9705
9178,Irha,F,23,3130189,9325
9179,Iza,F,23,3130212,9053
9180,Jahiem,M,23,3130235,9777
9181,Jahkai,M,23,3130258,9208
9182,Jahsai,M,23,3130281,9201
9183,Jaia,F,23,3130304,9104
9184,Jajuan,M,23,3130327,9335
9185,Jakaiden,M,23,3130350,9714
9186,Jakhai,M,23,3130373,9368
9187,Jakobie,M,23,3130396,9169
9188,Jamerson,M,23,3130419,9786
9189,Janay,F,23,3130442,9219
9190,Janvi,F,23,3130465,9101
9191,Jasean,M,23,3130488,9973
9192,Jassiah,M,23,3130511,9929
9193,Javeon,M,23,3130534,9452
9194,Jazara,F,23,3130557,9373
9195,Jeanluc,M,23,3130580,9586
9196,Jens,M,23,3130603,9803
9197,Jesenia,F,23,3130626,9106
9198,Jewell,F,23,3130649,9003
9199,Jlynn,F,23,3130672,9048
9200,Jolena,F,23,3130695,9927
9201,Jona,M,23,3130718,9665
9202,Joscelyn,F,23,3130741,9180
9203,Juni,F,23,3130764,9959
9204,Jusiah,M,23,3130787,9488
9205,Kacper,M,23,3130810,9689
9206,Kady,F,23,3130833,9079
9207,Kairav,M,23,3130856,9739
9208,Kalleigh,F,23,3130879,9051
9209,Kanoa,M,23,3130902,9152
9210,Karrigan,F,23,3130925,9126
9211,Kayan,M,23,3130948,9062
9212,Kaylanni,F,23,3130971,9359
9213,Kayzlee,F,23,3130994,9056
9214,Kelsy,F,23,3131017,9876
9215,Kerr,M,23,3131040,9121
9216,Keyanna,F,23,3131063,9526
9217,Khaliya,F,23,3131086,9575
9218,Khloey,F,23,3131109,9926
9219,Klyde,M,23,3131132,9125
9220,Koryn,F,23,3131155,9025
9221,Koy,M,23,3131178,9712
9222,Kyana,F,23,3131201,9242
9223,Kyiah,F,23,3131224,9435
9224,Kyli,F,23,3131247,9844
9225,Kyri,M,23,3131270,9190
9226,Lakynn,F,23,3131293,9405
9227,Lamees,F,23,3131316,9861
9228,Lehlani,F,23,3131339,9607
9229,Leliana,F,23,3131362,9641
9230,Lemon,F,23,3131385,9916
9231,Leylanie,F,23,3131408,9178
9232,Liem,M,23,3131431,9709
9233,Linken,M,23,3131454,9632
9234,Lochlyn,F,23,3131477,9011
9235,Madalena,F,23,3131500,9111
9236,Madysen,F,23,3131523,9964
9237,Magali,F,23,3131546,9317
9238,Magdalen,F,23,3131569,9223
9239,Mahsa,F,23,3131592,9726
9240,Maile,F,23,3131615,9364
9241,Mailey,F,23,3131638,9798
9242,Maily,F,23,3131661,9346
9243,Malick,M,23,3131684,9445
9244,Malu,F,23,3131707,9129
9245,Mana,F,23,3131730,9860
9246,Mansour,M,23,3131753,9494
9247,Manuella,F,23,3131776,9067
9248,Marsha,F,23,3131799,9899
9249,Martell,M,23,3131822,9383
9250,Maryanna,F,23,3131845,9855
9251,Marylou,F,23,3131868,9338
9252,Mase,M,23,3131891,9294
9253,Matan,M,23,3131914,9446
9254,Matthieu,M,23,3131937,9509
9255,Mavryk,M,23,3131960,9703
9256,Maysie,F,23,3131983,9979
9257,Md,M,23,3132006,9583
9258,Meagan,F,23,3132029,9753
9259,Mehreen,F,23,3132052,9906
9260,Michaella,F,23,3132075,9816
9261,Mitchel,M,23,3132098,9319
9262,Moxon,M,23,3132121,9672
9263,Muntaha,F,23,3132144,9651
9264,Naarah,F,23,3132167,9858
9265,Nahiara,F,23,3132190,9548
9266,Nailani,F,23,3132213,9257
9267,Nason,M,23,3132236,9880
9268,Natalyn,F,23,3132259,9272
9269,Natalynn,F,23,3132282,9120
9270,Nation,M,23,3132305,9381
9271,Natnael,M,23,3132328,9653
9272,Nautica,F,23,3132351,9211
9273,Niana,F,23,3132374,9687
9274,Niccolo,M,23,3132397,9105
9275,Novak,M,23,3132420,9145
9276,Nyeli,F,23,3132443,9363
9277,Osbaldo,M,23,3132466,9081
9278,Osiah,M,23,3132489,9329
9279,Pace,M,23,3132512,9952
9280,Paislyn,F,23,3132535,9752
9281,Parsa,M,23,3132558,9978
9282,Philopater,M,23,3132581,9557
9283,Princeston,M,23,3132604,9758
9284,Prophet,M,23,3132627,9345
9285,Radha,F,23,3132650,9437
9286,Rainah,F,23,3132673,9766
9287,Rainbow,F,23,3132696,9612
9288,Rayana,F,23,3132719,9030
9289,Rayelle,F,23,3132742,9576
9290,Reginae,F,23,3132765,9697
9291,Reighn,F,23,3132788,9323
9292,Rexford,M,23,3132811,9622
9293,Reyden,M,23,3132834,9209
9294,Rhemi,F,23,3132857,9409
9295,Rhydian,M,23,3132880,9879
9296,Ridhi,F,23,3132903,9579
9297,Rock,M,23,3132926,9922
9298,Rocket,M,23,3132949,9807
9299,Rondell,M,23,3132972,9719
9300,Rosina,F,23,3132995,9416
9301,Rudi,M,23,3133018,9543
9302,Ryen,F,23,3133041,9462
9303,Ryn,F,23,3133064,9570
9304,Saharsh,M,23,3133087,9823
9305,Salena,F,23,3133110,9639
9306,Sarita,F,23,3133133,9162
9307,Seeley,M,23,3133156,9881
9308,Sera,F,23,3133179,9264
9309,Sevin,M,23,3133202,9801
9310,Shanice,F,23,3133225,9326
9311,Shantal,F,23,3133248,9573
9312,Shayaan,M,23,3133271,9679
9313,Sheamus,M,23,3133294,9759
9314,Shep,M,23,3133317,9348
9315,Shloime,M,23,3133340,9151
9316,Shreyansh,M,23,3133363,9263
9317,Simi,F,23,3133386,9142
9318,Soham,M,23,3133409,9138
9319,Soliyana,F,23,3133432,9558
9320,Srihaan,M,23,3133455,9203
9321,Sriyan,M,23,3133478,9399
9322,Sylar,M,23,3133501,9722
9323,Syler,M,23,3133524,9932
9324,Talyn,M,23,3133547,9740
9325,Teighan,F,23,3133570,9949
9326,Tilian,M,23,3133593,9787
9327,Tino,M,23,3133616,9176
9328,Tremayne,M,23,3133639,9986
9329,Trigg,M,23,3133662,9492
9330,Trina,F,23,3133685,9275
9331,Trinidad,M,23,3133708,9954
9332,Trudy,F,23,3133731,9565
9333,Twila,F,23,3133754,9171
9334,Tylon,M,23,3133777,9990
9335,Tzivia,F,23,3133800,9133
9336,Uthman,M,23,3133823,9682
9337,Venba,F,23,3133846,9995
9338,Virlan,M,23,3133869,9618
9339,Vittorio,M,23,3133892,9484
9340,Yanet,F,23,3133915,9827
9341,Yehudah,M,23,3133938,9419
9342,Yossi,M,23,3133961,9976
9343,Yousra,F,23,3133984,9947
9344,Zaccai,M,23,3134007,9095
9345,Zaryiah,F,23,3134030,9066
9346,Zaydyn,M,23,3134053,9717
9347,Zebadiah,M,23,3134076,9075
9348,Ziana,F,23,3134099,9249
9349,Zoi,F,23,3134122,9259
9350,Zunaira,F,23,3134145,9948
9351,Zylan,M,23,3134168,9302
9352,Aalijah,M,22,3134190,9813
9353,Aamiyah,F,22,3134212,9478
9354,Aanav,M,22,3134234,9806
9355,Abdulmalik,M,22,3134256,9589
9356,Able,M,22,3134278,9279
9357,Adalene,F,22,3134300,9260
9358,Adama,F,22,3134322,9068
9359,Adelyna,F,22,3134344,9175
9360,Adeya,F,22,3134366,9350
9361,Adon,M,22,3134388,9144
9362,Ailish,F,22,3134410,9378
9363,Aime,F,22,3134432,9093
9364,Ajooni,F,22,3134454,9087
9365,Akemi,F,22,3134476,9835
9366,Alegend,M,22,3134498,9372
9367,Alisia,F,22,3134520,9318
9368,Aliz,F,22,3134542,9037
9369,Alizeh,F,22,3134564,9518
9370,Alorah,F,22,3134586,9430
9371,Alphonso,M,22,3134608,9362
9372,Amaar,M,22,3134630,9199
9373,Amil,M,22,3134652,9920
9374,Amilliana,F,22,3134674,9230
9375,Andreya,F,22,3134696,9307
9376,Andria,F,22,3134718,9123
9377,Annah,F,22,3134740,9963
9378,Antonina,F,22,3134762,9809
9379,Anvith,M,22,3134784,9150
9380,Anyiah,F,22,3134806,9554
9381,Anyssa,F,22,3134828,9297
9382,Apryl,F,22,3134850,9402
9383,Aqsa,F,22,3134872,9960
9384,Arjen,M,22,3134894,9590
9385,Armond,M,22,3134916,9110
9386,Aubry,F,22,3134938,9961
9387,Audriella,F,22,3134960,9438
9388,Augie,M,22,3134982,9454
9389,Aurie,F,22,3135004,9267
9390,Avangeline,F,22,3135026,9232
9391,Avenir,M,22,3135048,9166
9392,Avina,F,22,3135070,9069
9393,Avir,M,22,3135092,9895
9394,Avneet,F,22,3135114,9391
9395,Avrum,M,22,3135136,9436
9396,Badr,M,22,3135158,9453
9397,Banyan,M,22,3135180,9519
9398,Beauregard,M,22,3135202,9985
9399,Blayklee,F,22,3135224,9412
9400,Boubacar,M,22,3135246,9902
9401,Bradleigh,F,22,3135268,9303
9402,Braxley,M,22,3135290,9668
9403,Briza,F,22,3135312,9624
9404,Callyn,F,22,3135334,9788
9405,Camarion,M,22,3135356,9845
9406,Captain,M,22,3135378,9633
9407,Cari,F,22,3135400,9141
9408,Carlyle,M,22,3135422,9268
9409,Castor,M,22,3135444,9082
9410,Cayne,M,22,3135466,9191
9411,Celestine,F,22,3135488,9524
9412,Chason,M,22,3135510,9417
9413,Che,M,22,3135532,9802
9414,Chrislyn,F,22,3135554,9486
9415,Cobi,M,22,3135576,9971
9416,Cortland,M,22,3135598,9458
9417,Cotton,M,22,3135620,9377
9418,Creek,M,22,3135642,9085
9419,Crispin,M,22,3135664,9164
9420,Daegan,M,22,3135686,9736
9421,Dalvin,M,22,3135708,9757
9422,Dameon,M,22,3135730,9444
9423,Dariya,F,22,3135752,9347
9424,Davey,M,22,3135774,9775
9425,Delara,F,22,3135796,9229
9426,Deniro,M,22,3135818,9134
9427,Deric,M,22,3135840,9790
9428,Deshon,M,22,3135862,9530
9429,Dessa,F,22,3135884,9782
9430,Dhiya,F,22,3135906,9908
9431,Didier,M,22,3135928,9160
9432,Diyan,M,22,3135950,9010
9433,Dominga,F,22,3135972,9071
9434,Dreyden,M,22,3135994,9674
9435,Dynasti,F,22,3136016,9968
9436,Eastin,M,22,3136038,9746
9437,Eivin,M,22,3136060,9536
9438,Elaia,F,22,3136082,9608
9439,Eleonor,F,22,3136104,9654
9440,Ellamarie,F,22,3136126,9064
9441,Elleana,F,22,3136148,9367
9442,Emilly,F,22,3136170,9061
9443,Emmalina,F,22,3136192,9781
9444,Erykah,F,22,3136214,9183
9445,Fareed,M,22,3136236,9395
9446,Fenton,M,22,3136258,9913
9447,Fia,F,22,3136280,9856
9448,Gaius,M,22,3136302,9049
9449,Gioia,F,22,3136324,9465
9450,Girl,F,22,3136346,9038
9451,Giulio,M,22,3136368,9235
9452,Glenda,F,22,3136390,9623
9453,Gotham,M,22,3136412,9943
9454,Gracee,F,22,3136434,9238
9455,Gracy,F,22,3136456,9099
9456,Graylynn,F,22,3136478,9282
9457,Griffey,M,22,3136500,9707
9458,Gryphon,M,22,3136522,9671
9459,Gurnoor,F,22,3136544,9808
9460,Haily,F,22,3136566,9154
9461,Hamid,M,22,3136588,9301
9462,Hanalei,F,22,3136610,9266
9463,Hanifa,F,22,3136632,9564
9464,Hazael,M,22,3136654,9277
9465,Hazeleigh,F,22,3136676,9762
9466,Hazelyn,F,22,3136698,9771
9467,Hinata,F,22,3136720,9449
9468,Holiday,F,22,3136742,9555
9469,Holten,M,22,3136764,9886
9470,Horace,M,22,3136786,9204
9471,Iana,F,22,3136808,9112
9472,Icelyn,F,22,3136830,9065
9473,Ismaeel,M,22,3136852,9636
9474,Israella,F,22,3136874,9534
9475,Ivonne,F,22,3136896,9027
9476,Ivori,F,22,3136918,9645
9477,Iyonna,F,22,3136940,9694
9478,Izekiel,M,22,3136962,9603
9479,Izik,M,22,3136984,9600
9480,Jabez,M,22,3137006,9810
9481,Jabir,M,22,3137028,9036
9482,Jacinda,F,22,3137050,9311
9483,Jaliya,F,22,3137072,9033
9484,Jameela,F,22,3137094,9058
9485,Jamichael,M,22,3137116,9098
9486,Janiyla,F,22,3137138,9516
9487,Javeah,F,22,3137160,9007
9488,Jaxxson,M,22,3137182,9167
9489,Jaykob,M,22,3137204,9401
9490,Jaynie,F,22,3137226,9404
9491,Jayonna,F,22,3137248,9306
9492,Jayquan,M,22,3137270,9613
9493,Jeannie,F,22,3137292,9158
9494,Jenessa,F,22,3137314,9826
9495,Jill,F,22,3137336,9734
9496,Jodeci,M,22,3137358,9599
9497,Jomar,M,22,3137380,9221
9498,Jordany,M,22,3137402,9495
9499,Jossiah,M,22,3137424,9849
9500,Joud,M,22,3137446,9370
9501,Jovon,M,22,3137468,9850
9502,Jumana,F,22,3137490,9031
9503,Jurni,F,22,3137512,9469
9504,Jyaire,M,22,3137534,9541
9505,Kacyn,M,22,3137556,9928
9506,Kaelan,M,22,3137578,9109
9507,Kaid,M,22,3137600,9128
9508,Kaide,M,22,3137622,9013
9509,Kalum,M,22,3137644,9527
9510,Kamelia,F,22,3137666,9637
9511,Kamry,F,22,3137688,9728
9512,Kamylah,F,22,3137710,9685
9513,Kannan,M,22,3137732,9834
9514,Karaline,F,22,3137754,9161
9515,Kassian,M,22,3137776,9522
9516,Kataleia,F,22,3137798,9376
9517,Katerin,F,22,3137820,9749
9518,Kathia,F,22,3137842,9464
9519,Kayanna,F,22,3137864,9966
9520,Kaylahni,F,22,3137886,9044
9521,Kaytlyn,F,22,3137908,9278
9522,Kayvion,M,22,3137930,9076
9523,Keasia,F,22,3137952,9896
9524,Keelyn,F,22,3137974,9360
9525,Kei,M,22,3137996,9580
9526,Keir,M,22,3138018,9256
9527,Kelahni,F,22,3138040,9604
9528,Kendalynn,F,22,3138062,9148
9529,Keniel,M,22,3138084,9328
9530,Keven,M,22,3138106,9113
9531,Khaleah,F,22,3138128,9063
9532,Khalifa,M,22,3138150,9100
9533,Khaliq,M,22,3138172,9479
9534,Khan,M,22,3138194,9572
9535,Khoi,M,22,3138216,9814
9536,Khyla,F,22,3138238,9116
9537,Kilynn,F,22,3138260,9168
9538,Kimari,M,22,3138282,9343
9539,Kinnick,M,22,3138304,9732
9540,Kiptyn,M,22,3138326,9357
9541,Klaudia,F,22,3138348,9673
9542,Koe,M,22,3138370,9982
9543,Kolston,M,22,3138392,9182
9544,Kristi,F,22,3138414,9054
9545,Kyre,M,22,3138436,9791
9546,Labella,F,22,3138458,9912
9547,Lamari,M,22,3138480,9566
9548,Langdon,M,22,3138502,9568
9549,Leightyn,F,22,3138524,9353
9550,Lianne,F,22,3138546,9355
9551,Lissette,F,22,3138568,9192
9552,Logann,F,22,3138590,9251
9553,Logen,M,22,3138612,9779
9554,Lonzo,M,22,3138634,9316
9555,Lorene,F,22,3138656,9387
9556,Lujain,F,22,3138678,9371
9557,Macsen,M,22,3138700,9725
9558,Madani,F,22,3138722,9424
9559,Maizee,F,22,3138744,9839
9560,Majid,M,22,3138766,9470
9561,Makenzee,F,22,3138788,9559
9562,Maksymilian,M,22,3138810,9867
9563,Mamie,F,22,3138832,9988
9564,Mansa,M,22,3138854,9773
9565,Mariamawit,F,22,3138876,9466
9566,Maui,M,22,3138898,9822
9567,Maveryck,M,22,3138920,9456
9568,Merle,M,22,3138942,9341
9569,Meryl,F,22,3138964,9975
9570,Mianna,F,22,3138986,9426
9571,Milos,M,22,3139008,9596
9572,Mimi,F,22,3139030,9796
9573,Mirel,F,22,3139052,9059
9574,Myia,F,22,3139074,9628
9575,Naheem,M,22,3139096,9442
9576,Nahia,F,22,3139118,9009
9577,Najah,F,22,3139140,9173
9578,Nas,M,22,3139162,9118
9579,Nayan,M,22,3139184,9772
9580,Negan,M,22,3139206,9413
9581,Nelli,F,22,3139228,9733
9582,Neyla,F,22,3139250,9474
9583,Nikole,F,22,3139272,9231
9584,Nivan,M,22,3139294,9577
9585,Nnamdi,M,22,3139316,9737
9586,Nolin,M,22,3139338,9017
9587,Nymeria,F,22,3139360,9157
9588,Nyree,F,22,3139382,9587
9589,Ole,M,22,3139404,9878
9590,Oliva,F,22,3139426,9149
9591,Olyver,M,22,3139448,9397
9592,Orian,M,22,3139470,9521
9593,Orlaith,F,22,3139492,9894
9594,Orli,F,22,3139514,9652
9595,Pranavi,F,22,3139536,9467
9596,Quan,M,22,3139558,9755
9597,Quenton,M,22,3139580,9255
9598,Raelin,F,22,3139602,9969
9599,Rafi,M,22,3139624,9741
9600,Rahel,F,22,3139646,9334
9601,Ramesses,M,22,3139668,9887
9602,Ramy,M,22,3139690,9569
9603,Renesme,F,22,3139712,9515
9604,Reno,M,22,3139734,9620
9605,Rhian,F,22,3139756,9425
9606,Riah,F,22,3139778,9898
9607,Roper,M,22,3139800,9745
9608,Rosaria,F,22,3139822,9663
9609,Rowland,M,22,3139844,9300
9610,Rynn,F,22,3139866,9525
9611,Samanta,F,22,3139888,9552
9612,Samanvi,F,22,3139910,9186
9613,Samina,F,22,3139932,9205
9614,Sandro,M,22,3139954,9005
9615,Sarenity,F,22,3139976,9441
9616,Sathvik,M,22,3139998,9681
9617,Saulo,M,22,3140020,9289
9618,Semira,F,22,3140042,9561
9619,Seneca,M,22,3140064,9626
9620,Seraphine,F,22,3140086,9248
9621,Sereen,F,22,3140108,9647
9622,Shraddha,F,22,3140130,9535
9623,Sisira,F,22,3140152,9669
9624,Skadi,F,22,3140174,9523
9625,Sofija,F,22,3140196,9374
9626,Sohum,M,22,3140218,9984
9627,Styles,M,22,3140240,9941
9628,Suhaylah,F,22,3140262,9688
9629,Sundus,F,22,3140284,9662
9630,Suzie,F,22,3140306,9457
9631,Sylvi,F,22,3140328,9551
9632,Syris,M,22,3140350,9871
9633,Taliya,F,22,3140372,9511
9634,Tayven,M,22,3140394,9907
9635,Taz,M,22,3140416,9172
9636,Teyanna,F,22,3140438,9940
9637,Thelma,F,22,3140460,9621
9638,Torah,F,22,3140482,9560
9639,Valente,M,22,3140504,9731
9640,Vedika,F,22,3140526,9288
9641,Verna,F,22,3140548,9664
9642,Vishnu,M,22,3140570,9852
9643,Vladislav,M,22,3140592,9214
9644,Waseem,M,22,3140614,9139
9645,Wassim,M,22,3140636,9501
9646,Westly,M,22,3140658,9366
9647,Witt,M,22,3140680,9680
9648,Yahshua,M,22,3140702,9601
9649,Yaniel,M,22,3140724,9832
9650,Yaritzi,F,22,3140746,9340
9651,Yazlyn,F,22,3140768,9181
9652,Yeiden,M,22,3140790,9735
9653,Ysabel,F,22,3140812,9296
9654,Yulisa,F,22,3140834,9406
9655,Zaharah,F,22,3140856,9052
9656,Zai,M,22,3140878,9936
9657,Zailynn,F,22,3140900,9156
9658,Zakhi,M,22,3140922,9605
9659,Zarek,M,22,3140944,9455
9660,Zaven,M,22,3140966,9179
9661,Zaynah,F,22,3140988,9660
9662,Zeena,F,22,3141010,9018
9663,Zendayah,F,22,3141032,9804
9664,Zhara,F,22,3141054,9244
9665,Zharia,F,22,3141076,9265
9666,Zoila,F,22,3141098,9841
9667,Zuria,F,22,3141120,9276
9668,Zurie,F,22,3141142,9472
9669,Zyheir,M,22,3141164,9237
9670,Aaditya,M,21,3141185,9918
9671,Abeer,M,21,3141206,9831
9672,Abrahm,M,21,3141227,9994
9673,Adeena,F,21,3141248,9843
9674,Advit,M,21,3141269,9901
9675,Aeliana,F,21,3141290,9872
9676,Afia,F,21,3141311,9582
9677,Ahmaad,M,21,3141332,9819
9678,Ailah,F,21,3141353,9900
9679,Ailen,F,21,3141374,9842
9680,Ainoah,F,21,3141395,9821
9681,Ainsleigh,F,21,3141416,9482
9682,Ajax,M,21,3141437,9708
9683,Akilah,F,21,3141458,9043
9684,Akshaya,F,21,3141479,9398
9685,Alaylah,F,21,3141500,9998
9686,Aleiya,F,21,3141521,9938
9687,Alilah,F,21,3141542,9499
9688,Alitzel,F,21,3141563,9392
9689,Alvina,F,21,3141584,9868
9690,Alyra,F,21,3141605,9846
9691,Amayrani,F,21,3141626,9776
9692,Amena,F,21,3141647,9763
9693,Amiliana,F,21,3141668,9567
9694,Amra,F,21,3141689,9480
9695,Amri,F,21,3141710,9140
9696,Amyas,M,21,3141731,9890
9697,Anette,F,21,3141752,9078
9698,Angelic,F,21,3141773,9132
9699,Angelita,F,21,3141794,9074
9700,Antione,M,21,3141815,9765
9701,Areya,F,21,3141836,9365
9702,Ariston,M,21,3141857,9096
9703,Armonie,F,21,3141878,9528
9704,Arsalan,M,21,3141899,9240
9705,Art,M,21,3141920,9433
9706,Artin,M,21,3141941,9046
9707,Arun,M,21,3141962,9313
9708,Ashrith,M,21,3141983,9812
9709,Avelynn,F,21,3142004,9646
9710,Averlee,F,21,3142025,9937
9711,Aylla,F,21,3142046,9578
9712,Aysen,M,21,3142067,9553
9713,Azora,F,21,3142088,9254
9714,Azrielle,F,21,3142109,9420
9715,Banx,M,21,3142130,9342
9716,Beaumont,M,21,3142151,9117
9717,Belladonna,F,21,3142172,9233
9718,Bellamie,F,21,3142193,9648
9719,Braeson,M,21,3142214,9143
9720,Bret,M,21,3142235,9792
9721,Breyden,M,21,3142256,9870
9722,Brooklin,F,21,3142277,9504
9723,Bryndle,F,21,3142298,9897
9724,Caitlynn,F,21,3142319,9701
9725,Candelaria,F,21,3142340,9606
9726,Carnell,M,21,3142361,9505
9727,Catriona,F,21,3142382,9023
9728,Cecile,F,21,3142403,9891
9729,Celso,M,21,3142424,9911
9730,Chrislynn,F,21,3142445,9448
9731,Christan,M,21,3142466,9563
9732,Cire,M,21,3142487,9196
9733,Codie,F,21,3142508,9642
9734,Damier,M,21,3142529,9882
9735,Darah,F,21,3142550,9718
9736,Dariah,F,21,3142571,9477
9737,Darlin,F,21,3142592,9658
9738,Davie,F,21,3142613,9562
9739,Davy,M,21,3142634,9743
9740,Deaaron,M,21,3142655,9481
9741,Deaire,M,21,3142676,9748
9742,Delfina,F,21,3142697,9544
9743,Delores,F,21,3142718,9028
9744,Demetric,M,21,3142739,9369
9745,Destiney,F,21,3142760,9485
9746,Devi,F,21,3142781,9227
9747,Dhyan,M,21,3142802,9073
9748,Ditya,F,21,3142823,9710
9749,Edris,M,21,3142844,9165
9750,Elenore,F,21,3142865,9991
9751,Ellasyn,F,21,3142886,9418
9752,Elley,F,21,3142907,9611
9753,Ellijah,M,21,3142928,9983
9754,Elnathan,M,21,3142949,9281
9755,Emmalin,F,21,3142970,9828
9756,Eniyah,F,21,3142991,9675
9757,Esmay,F,21,3143012,9696
9758,Esra,F,21,3143033,9483
9759,Evaline,F,21,3143054,9542
9760,Eyan,M,21,3143075,9761
9761,Fin,M,21,3143096,9989
9762,Future,M,21,3143117,9691
9763,Geremiah,M,21,3143138,9851
9764,Ghaith,M,21,3143159,9953
9765,Giovany,M,21,3143180,9351
9766,Gisella,F,21,3143201,9298
9767,Hal,M,21,3143222,9747
9768,Hanley,F,21,3143243,9917
9769,Hansen,M,21,3143264,9686
9770,Hilario,M,21,3143285,9114
9771,Huzaifa,M,21,3143306,9155
9772,Ibrohim,M,21,3143327,9946
9773,Ireoluwa,F,21,3143348,9055
9774,Israa,F,21,3143369,9385
9775,Ivania,F,21,3143390,9245
9776,Iyah,F,21,3143411,9434
9777,Jaasiel,M,21,3143432,9955
9778,Jadalynn,F,21,3143453,9020
9779,Jahmere,M,21,3143474,9389
9780,Jalal,M,21,3143495,9177
9781,Jamarius,M,21,3143516,9597
9782,Jamyra,F,21,3143537,9824
9783,Janis,F,21,3143558,9863
9784,Janyiah,F,21,3143579,9794
9785,Japji,F,21,3143600,9210
9786,Jasani,F,21,3143621,9614
9787,Jaylei,F,21,3143642,9108
9788,Jayli,F,21,3143663,9384
9789,Jayline,F,21,3143684,9506
9790,Jayvyn,M,21,3143705,9354
9791,Jazaria,F,21,3143726,9799
9792,Jencarlos,M,21,3143747,9496
9793,Jerrod,M,21,3143768,9220
9794,Jess,M,21,3143789,9408
9795,Jhalil,M,21,3143810,9649
9796,Jianni,M,21,3143831,9837
9797,Jiyan,M,21,3143852,9396
9798,Jizelle,F,21,3143873,9487
9799,Johnhenry,M,21,3143894,9974
9800,Juliann,F,21,3143915,9829
9801,July,M,21,3143936,9638
9802,Junaid,M,21,3143957,9212
9803,Kaelin,F,21,3143978,9892
9804,Kaisa,F,21,3143999,9207
9805,Kalil,M,21,3144020,9893
9806,Kannen,M,21,3144041,9107
9807,Karlo,M,21,3144062,9958
9808,Karston,M,21,3144083,9285
9809,Kasin,M,21,3144104,9187
9810,Kaston,M,21,3144125,9999
9811,Katalia,F,21,3144146,9102
9812,Kattleya,F,21,3144167,9195
9813,Kayani,F,21,3144188,9490
9814,Kayra,F,21,3144209,9379
9815,Kaysan,M,21,3144230,9550
9816,Kaysie,F,21,3144251,9667
9817,Kemar,M,21,3144272,9047
9818,Kennadie,F,21,3144293,9015
9819,Kennedie,F,21,3144314,9538
9820,Kenyan,M,21,3144335,9304
9821,Keontae,M,21,3144356,9432
9822,Kepler,M,21,3144377,9769
9823,Kevion,M,21,3144398,9097
9824,Keyonna,F,21,3144419,9471
9825,Kharis,F,21,3144440,9170
9826,Khi,M,21,3144461,9431
9827,Kimi,M,21,3144482,9024
9828,Kinan,M,21,3144503,9993
9829,Klarity,F,21,3144524,9873
9830,Korver,M,21,3144545,9793
9831,Kylia,F,21,3144566,9050
9832,Kynslie,F,21,3144587,9910
9833,Laksh,M,21,3144608,9591
9834,Lanaya,F,21,3144629,9656
9835,Lanna,F,21,3144650,9089
9836,Larkyn,F,21,3144671,9103
9837,Lashawn,M,21,3144692,9539
9838,Lavi,M,21,3144713,9291
9839,Layani,F,21,3144734,9146
9840,Layke,M,21,3144755,9344
9841,Leasia,F,21,3144776,9270
9842,Lebron,M,21,3144797,9630
9843,Leelah,F,21,3144818,9247
9844,Leiland,M,21,3144839,9805
9845,Leondre,M,21,3144860,9500
9846,Levii,M,21,3144881,9698
9847,Leyland,M,21,3144902,9853
9848,Lianny,F,21,3144923,9060
9849,Lilianne,F,21,3144944,9980
9850,Lilyth,F,21,3144965,9080
9851,Lucus,M,21,3144986,9225
9852,Lunna,F,21,3145007,9188
9853,Lynnette,F,21,3145028,9820
9854,Maddalyn,F,21,3145049,9996
9855,Maddy,F,21,3145070,9497
9856,Madilynne,F,21,3145091,9729
9857,Mads,M,21,3145112,9332
9858,Maeli,F,21,3145133,9226
9859,Maely,F,21,3145154,9261
9860,Maevis,F,21,3145175,9489
9861,Mahkai,M,21,3145196,9859
9862,Maijor,M,21,3145217,9159
9863,Maikel,M,21,3145238,9034
9864,Maisha,F,21,3145259,9012
9865,Maiyah,F,21,3145280,9451
9866,Makbel,M,21,3145301,9004
9867,Margeaux,F,21,3145322,9715
9868,Margie,F,21,3145343,9423
9869,Mariangel,F,21,3145364,9884
9870,Markos,M,21,3145385,9627
9871,Matai,M,21,3145406,9677
9872,Matea,F,21,3145427,9815
9873,Mathayus,M,21,3145448,9287
9874,Matix,M,21,3145469,9817
9875,Mattia,M,21,3145490,9716
9876,Mckinzie,F,21,3145511,9224
9877,Mckoy,M,21,3145532,9253
9878,Meili,F,21,3145553,9127
9879,Mercedez,F,21,3145574,9040
9880,Mert,M,21,3145595,9838
9881,Meyah,F,21,3145616,9382
9882,Micha,M,21,3145637,9273
9883,Mills,M,21,3145658,9836
9884,Minka,F,21,3145679,9070
9885,Miqueas,M,21,3145700,9547
9886,Miroslava,F,21,3145721,9072
9887,Myking,M,21,3145742,9124
9888,Naleah,F,21,3145763,9000
9889,Nandi,F,21,3145784,9356
9890,Nashly,F,21,3145805,9643
9891,Naveed,M,21,3145826,9537
9892,Nayana,F,21,3145847,9349
9893,Nevada,F,21,3145868,9594
9894,Nevayah,F,21,3145889,9035
9895,Noach,M,21,3145910,9514
9896,Noctis,M,21,3145931,9315
9897,Noriah,F,21,3145952,9727
9898,Oaklin,M,21,3145973,9393
9899,Osborne,M,21,3145994,9571
9900,Oswin,M,21,3146015,9925
9901,Otoniel,M,21,3146036,9421
9902,Ousman,M,21,3146057,9361
9903,Ousmane,M,21,3146078,9602
9904,Ozan,M,21,3146099,9358
9905,Paislie,F,21,3146120,9942
9906,Pari,F,21,3146141,9029
9907,Payne,M,21,3146162,9508
9908,Perl,F,21,3146183,9380
9909,Phenix,F,21,3146204,9137
9910,Pinchus,M,21,3146225,9239
9911,Platon,M,21,3146246,9090
9912,Quinlee,F,21,3146267,9661
9913,Ra,M,21,3146288,9695
9914,Ramone,M,21,3146309,9468
9915,Rayansh,M,21,3146330,9789
9916,Rayonna,F,21,3146351,9670
9917,Reanna,F,21,3146372,9830
9918,Reeve,M,21,3146393,9475
9919,Reia,F,21,3146414,9094
9920,Renn,F,21,3146435,9693
9921,Rigel,M,21,3146456,9422
9922,Rinoa,F,21,3146477,9905
9923,Rithvik,M,21,3146498,9216
9924,Rowin,M,21,3146519,9427
9925,Royaltee,F,21,3146540,9498
9926,Rui,M,21,3146561,9290
9927,Rupert,M,21,3146582,9556
9928,Ryaan,M,21,3146603,9751
9929,Sachin,M,21,3146624,9531
9930,Sahas,M,21,3146645,9888
9931,Sakai,M,21,3146666,9337
9932,Sakani,M,21,3146687,9919
9933,Samora,F,21,3146708,9783
9934,Samyah,F,21,3146729,9854
9935,Scottlynn,F,21,3146750,9742
9936,Seleste,F,21,3146771,9692
9937,Shraga,M,21,3146792,9252
9938,Sid,M,21,3146813,9818
9939,Siona,F,21,3146834,9119
9940,Slayde,M,21,3146855,9283
9941,Slayton,M,21,3146876,9407
9942,Solei,F,21,3146897,9429
9943,Storii,F,21,3146918,9026
9944,Sully,M,21,3146939,9593
9945,Svetlana,F,21,3146960,9136
9946,Swayzee,F,21,3146981,9723
9947,Swayzie,F,21,3147002,9476
9948,Tallon,M,21,3147023,9684
9949,Tamsin,F,21,3147044,9414
9950,Tana,F,21,3147065,9967
9951,Taylah,F,21,3147086,9274
9952,Tevita,M,21,3147107,9532
9953,Thais,F,21,3147128,9795
9954,Tommaso,M,21,3147149,9309
9955,Torey,M,21,3147170,9324
9956,Trayson,M,21,3147191,9032
9957,Treshawn,M,21,3147212,9615
9958,Trip,M,21,3147233,9262
9959,Tuesday,F,21,3147254,9711
9960,Tylah,F,21,3147275,9250
9961,Tylar,F,21,3147296,9450
9962,Tylynn,F,21,3147317,9756
9963,Ubaldo,M,21,3147338,9744
9964,Ursula,F,21,3147359,9750
9965,Vidalia,F,21,3147380,9657
9966,Viviane,F,21,3147401,9461
9967,Vy,F,21,3147422,9057
9968,Wake,M,21,3147443,9390
9969,Whitt,M,21,3147464,9585
9970,Xavior,M,21,3147485,9014
9971,Yajaira,F,21,3147506,9962
9972,Yarah,F,21,3147527,9375
9973,Yatzil,F,21,3147548,9865
9974,Yeray,M,21,3147569,9997
9975,Yerick,M,21,3147590,9706
9976,Yesly,F,21,3147611,9198
9977,Zakir,M,21,3147632,9780
9978,Zanyah,F,21,3147653,9934
9979,Zaydrian,M,21,3147674,9545
9980,Zein,M,21,3147695,9415
9981,Zeinab,F,21,3147716,9008
9982,Zema,F,21,3147737,9327
9983,Zuleyma,F,21,3147758,9241
9984,Zylen,M,21,3147779,9130
9985,Aadam,M,20,3147799,9386
9986,Aara,F,20,3147819,9914
9987,Aaryav,M,20,3147839,9491
9988,Abran,M,20,3147859,9336
9989,Adarius,M,20,3147879,9992
9990,Adayah,F,20,3147899,9234
9991,Ala,F,20,3147919,9443
9992,Alainah,F,20,3147939,9866
9993,Alania,F,20,3147959,9939
9994,Alanii,F,20,3147979,9909
9995,Alanys,F,20,3147999,9016
9996,Aldair,M,20,3148019,9965
9997,Alicen,F,20,3148039,9930
9998,Alima,F,20,3148059,9754
9999,Allyssa,F,20,3148079,9598
10000,Alon,M,20,3148099,10818
10001,Alyan,M,20,3148119,10163
10002,Alyssandra,F,20,3148139,10975
10003,Amai,F,20,3148159,10180
10004,Amala,F,20,3148179,10938
10005,Anala,F,20,3148199,10601
10006,Analiese,F,20,3148219,10126
10007,Angelise,F,20,3148239,10009
10008,Anijah,F,20,3148259,10411
10009,Annali,F,20,3148279,10492
10010,Arhan,M,20,3148299,10324
10011,Ariannah,F,20,3148319,10165
10012,Ariyon,M,20,3148339,10227
10013,Arna,F,20,3148359,10123
10014,Arsh,M,20,3148379,10202
10015,Asmaa,F,20,3148399,10296
10016,Athen,M,20,3148419,10381
10017,Audric,M,20,3148439,10853
10018,Avari,F,20,3148459,10778
10019,Aviannah,F,20,3148479,10523
10020,Aylinn,F,20,3148499,10539
10021,Ayonna,F,20,3148519,10884
10022,Azaliah,F,20,3148539,10877
10023,Becker,M,20,3148559,10693
10024,Blas,M,20,3148579,10438
10025,Bodin,M,20,3148599,10867
10026,Brando,M,20,3148619,10382
10027,Braydyn,M,20,3148639,10299
10028,Braylie,F,20,3148659,10311
10029,Brazos,M,20,3148679,10483
10030,Breya,F,20,3148699,10375
10031,Briasia,F,20,3148719,10292
10032,Bricen,M,20,3148739,10456
10033,Britain,F,20,3148759,10440
10034,Caileigh,F,20,3148779,10174
10035,Calianna,F,20,3148799,10455
10036,Calin,M,20,3148819,10112
10037,Camri,F,20,3148839,10269
10038,Carlyn,F,20,3148859,10433
10039,Chadwick,M,20,3148879,10791
10040,Chantal,F,20,3148899,10579
10041,Charvi,F,20,3148919,10957
10042,Cherokee,F,20,3148939,10001
10043,Chiamaka,F,20,3148959,10798
10044,Cleveland,M,20,3148979,10328
10045,Coast,M,20,3148999,10723
10046,Copper,M,20,3149019,10615
10047,Coraleigh,F,20,3149039,10509
10048,Courtlynn,F,20,3149059,10759
10049,Cuauhtemoc,M,20,3149079,10499
10050,Curren,M,20,3149099,10473
10051,Daijah,F,20,3149119,10657
10052,Daire,M,20,3149139,10127
10053,Dalyn,M,20,3149159,10833
10054,Damauri,M,20,3149179,10203
10055,Darvin,M,20,3149199,10498
10056,Daryn,M,20,3149219,10629
10057,Davinci,M,20,3149239,10609
10058,Daylani,F,20,3149259,10429
10059,Deana,F,20,3149279,10678
10060,Deliyah,F,20,3149299,10997
10061,Delmar,M,20,3149319,10238
10062,Deniyah,F,20,3149339,10881
10063,Deonna,F,20,3149359,10287
10064,Deonta,M,20,3149379,10801
10065,Deziyah,F,20,3149399,10969
10066,Dilara,F,20,3149419,10687
10067,Dmitry,M,20,3149439,10065
10068,Dylon,M,20,3149459,10176
10069,Ebrahim,M,20,3149479,10802
10070,Elihu,M,20,3149499,10837
10071,Elize,F,20,3149519,10718
10072,Ellarie,F,20,3149539,10181
10073,Elleanna,F,20,3149559,10673
10074,Emmah,F,20,3149579,10679
10075,Erich,M,20,3149599,10620
10076,Erma,F,20,3149619,10423
10077,Evany,F,20,3149639,10691
10078,Everliegh,F,20,3149659,10965
10079,Evita,F,20,3149679,10551
10080,Ezreal,M,20,3149699,10141
10081,Faustino,M,20,3149719,10887
10082,Ferdinand,M,20,3149739,10771
10083,Gabrianna,F,20,3149759,10809
10084,Gaddiel,M,20,3149779,10600
10085,Gaines,M,20,3149799,10343
10086,Garland,M,20,3149819,10628
10087,Gavino,M,20,3149839,10855
10088,Gianmarco,M,20,3149859,10923
10089,Giavana,F,20,3149879,10151
10090,Graylyn,F,20,3149899,10542
10091,Hamdan,M,20,3149919,10996
10092,Hammad,M,20,3149939,10756
10093,Hanah,F,20,3149959,10111
10094,Haniel,M,20,3149979,10690
10095,Hargun,F,20,3149999,10063
10096,Hari,M,20,3150019,10146
10097,Harmoney,F,20,3150039,10232
10098,Hayzen,M,20,3150059,10251
10099,Hazyl,F,20,3150079,10758
10100,Heavenleigh,F,20,3150099,10717
10101,Heavyn,F,20,3150119,10431
10102,Hermes,M,20,3150139,10714
10103,Hisham,M,20,3150159,10733
10104,Ikaika,M,20,3150179,10745
10105,Ilian,M,20,3150199,10239
10106,Ilijah,M,20,3150219,10267
10107,Inna,F,20,3150239,10132
10108,Irwin,M,20,3150259,10769
10109,Isidore,M,20,3150279,10318
10110,Itai,M,20,3150299,10604
10111,Itzamara,F,20,3150319,10831
10112,Jackelyn,F,20,3150339,10622
10113,Jacksen,M,20,3150359,10904
10114,Jacobe,M,20,3150379,10003
10115,Jaeger,M,20,3150399,10983
10116,Jahking,M,20,3150419,10605
10117,Jaidah,F,20,3150439,10574
10118,Jakira,F,20,3150459,10252
10119,Jamesyn,M,20,3150479,10762
10120,Janilah,F,20,3150499,10533
10121,Jaselle,F,20,3150519,10316
10122,Jaziya,F,20,3150539,10627
10123,Jenae,F,20,3150559,10426
10124,Jenifer,F,20,3150579,10614
10125,Jeremi,M,20,3150599,10662
10126,Jeyson,M,20,3150619,10282
10127,Jezabel,F,20,3150639,10790
10128,Johndavid,M,20,3150659,10364
10129,Jood,F,20,3150679,10995
10130,Josemanuel,M,20,3150699,10512
10131,Jostin,M,20,3150719,10100
10132,Journiee,F,20,3150739,10259
10133,Joya,F,20,3150759,10685
10134,Jozef,M,20,3150779,10365
10135,Judea,F,20,3150799,10060
10136,Jun,M,20,3150819,10279
10137,Juvia,F,20,3150839,10903
10138,Kaela,F,20,3150859,10644
10139,Kaisleigh,F,20,3150879,10918
10140,Kala,F,20,3150899,10554
10141,Kaleel,M,20,3150919,10763
10142,Kamir,M,20,3150939,10346
10143,Kanai,M,20,3150959,10326
10144,Kandace,F,20,3150979,10485
10145,Karizma,F,20,3150999,10734
10146,Karlei,F,20,3151019,10513
10147,Kaseem,M,20,3151039,10257
10148,Kastiel,M,20,3151059,10237
10149,Kayda,F,20,3151079,10525
10150,Kaylina,F,20,3151099,10229
10151,Kayn,M,20,3151119,10157
10152,Kaynan,M,20,3151139,10153
10153,Kayslin,F,20,3151159,10952
10154,Kc,M,20,3151179,10955
10155,Keelie,F,20,3151199,10800
10156,Kehlanie,F,20,3151219,10577
10157,Kemani,F,20,3151239,10899
10158,Kemora,F,20,3151259,10631
10159,Kensly,F,20,3151279,10515
10160,Kerrington,F,20,3151299,10428
10161,Keyara,F,20,3151319,10466
10162,Khaden,M,20,3151339,10808
10163,Khaiden,M,20,3151359,10743
10164,Kharisma,F,20,3151379,10472
10165,Khiry,M,20,3151399,10658
10166,Kien,M,20,3151419,10891
10167,Kimoni,M,20,3151439,10200
10168,Kinza,F,20,3151459,10548
10169,Kitzia,F,20,3151479,10619
10170,Kmari,M,20,3151499,10415
10171,Knoah,M,20,3151519,10871
10172,Ladd,M,20,3151539,10882
10173,Laelia,F,20,3151559,10245
10174,Laelynn,F,20,3151579,10221
10175,Lakin,F,20,3151599,10749
10176,Lando,M,20,3151619,10576
10177,Laszlo,M,20,3151639,10929
10178,Lavern,M,20,3151659,10207
10179,Legion,M,20,3151679,10834
10180,Leone,M,20,3151699,10342
10181,Liangelo,M,20,3151719,10511
10182,Loriana,F,20,3151739,10384
10183,Loryn,F,20,3151759,10848
10184,Luxton,M,20,3151779,10137
10185,Lyah,F,20,3151799,10874
10186,Lyfe,M,20,3151819,10939
10187,Maanvi,F,20,3151839,10567
10188,Mackenzee,F,20,3151859,10376
10189,Maclan,M,20,3151879,10543
10190,Maela,F,20,3151899,10830
10191,Maeven,F,20,3151919,10177
10192,Maevry,F,20,3151939,10403
10193,Mahala,F,20,3151959,10122
10194,Malakye,M,20,3151979,10148
10195,Malayia,F,20,3151999,10814
10196,Manasseh,M,20,3152019,10192
10197,Marcellous,M,20,3152039,10410
10198,Marquese,M,20,3152059,10255
10199,Mathilde,F,20,3152079,10817
10200,Maxximus,M,20,3152099,10051
10201,Maysen,F,20,3152119,10491
10202,Mckinsey,F,20,3152139,10856
10203,Meghna,F,20,3152159,10822
10204,Mele,F,20,3152179,10235
10205,Menno,M,20,3152199,10281
10206,Michaelangelo,M,20,3152219,10184
10207,Mikaella,F,20,3152239,10812
10208,Milano,M,20,3152259,10213
10209,Montae,M,20,3152279,10195
10210,Mouhamadou,M,20,3152299,10059
10211,Muriel,F,20,3152319,10797
10212,Myanna,F,20,3152339,10344
10213,Nabeel,M,20,3152359,10304
10214,Nadira,F,20,3152379,10418
10215,Nainoa,M,20,3152399,10840
10216,Nari,F,20,3152419,10308
10217,Nasim,M,20,3152439,10520
10218,Nasya,F,20,3152459,10380
10219,Naszir,M,20,3152479,10660
10220,Naudia,F,20,3152499,10359
10221,Neah,F,20,3152519,10534
10222,Neeva,F,20,3152539,10090
10223,Nesanel,M,20,3152559,10575
10224,Nicklaus,M,20,3152579,10368
10225,Nicolina,F,20,3152599,10850
10226,Nils,M,20,3152619,10143
10227,Nixie,F,20,3152639,10936
10228,Noni,F,20,3152659,10224
10229,Norie,F,20,3152679,10197
10230,Nur,F,20,3152699,10402
10231,Oliviagrace,F,20,3152719,10787
10232,Oliviarose,F,20,3152739,10417
10233,Orlin,M,20,3152759,10922
10234,Parris,F,20,3152779,10474
10235,Payzlee,F,20,3152799,10707
10236,Paz,F,20,3152819,10894
10237,Quamir,M,20,3152839,10204
10238,Quetzali,F,20,3152859,10206
10239,Quinlyn,F,20,3152879,10766
10240,Quinlynn,F,20,3152899,10095
10241,Raelle,F,20,3152919,10596
10242,Randal,M,20,3152939,10223
10243,Rashaun,M,20,3152959,10826
10244,Rayann,F,20,3152979,10933
10245,Rea,F,20,3152999,10036
10246,Redmond,M,20,3153019,10056
10247,Reilynn,F,20,3153039,10168
10248,Renezmae,F,20,3153059,10241
10249,Reymundo,M,20,3153079,10649
10250,Rhyett,M,20,3153099,10225
10251,Richmond,M,20,3153119,10413
10252,Risa,F,20,3153139,10892
10253,Rishav,M,20,3153159,10133
10254,Romari,M,20,3153179,10263
10255,Romario,M,20,3153199,10910
10256,Rosamund,F,20,3153219,10373
10257,Rosealynn,F,20,3153239,10233
10258,Rosslyn,F,20,3153259,10827
10259,Rozalynn,F,20,3153279,10357
10260,Ryelle,F,20,3153299,10563
10261,Saara,F,20,3153319,10597
10262,Sadiya,F,20,3153339,10991
10263,Sahaj,M,20,3153359,10950
10264,Sanayah,F,20,3153379,10715
10265,Sarena,F,20,3153399,10847
10266,Sarim,M,20,3153419,10018
10267,Satvik,M,20,3153439,10293
10268,Sedrick,M,20,3153459,10150
10269,Sheridan,F,20,3153479,10038
10270,Sicilia,F,20,3153499,10419
10271,Souleymane,M,20,3153519,10608
10272,Sriram,M,20,3153539,10518
10273,Sriyaan,M,20,3153559,10681
10274,Stacie,F,20,3153579,10703
10275,Stefon,M,20,3153599,10031
10276,Tahira,F,20,3153619,10535
10277,Tavaris,M,20,3153639,10908
10278,Tayleigh,F,20,3153659,10962
10279,Taylie,F,20,3153679,10397
10280,Temple,F,20,3153699,10566
10281,Theodosia,F,20,3153719,10562
10282,Tilley,F,20,3153739,10954
10283,Torvi,F,20,3153759,10767
10284,Tracen,M,20,3153779,10670
10285,Tressa,F,20,3153799,10037
10286,Treyvion,M,20,3153819,10081
10287,Tsion,F,20,3153839,10645
10288,Tyreese,M,20,3153859,10671
10289,Uzziel,M,20,3153879,10167
10290,Vani,F,20,3153899,10182
10291,Waylin,M,20,3153919,10524
10292,Whitleigh,F,20,3153939,10728
10293,Wrenna,F,20,3153959,10295
10294,Xian,M,20,3153979,10559
10295,Yazeed,M,20,3153999,10008
10296,Yida,M,20,3154019,10764
10297,Yoshua,M,20,3154039,10394
10298,Yui,F,20,3154059,10154
10299,Yulieth,F,20,3154079,10590
10300,Yumna,F,20,3154099,10087
10301,Yuvin,M,20,3154119,10602
10302,Zailyn,F,20,3154139,10459
10303,Zaleah,F,20,3154159,10876
10304,Zalman,M,20,3154179,10076
10305,Zalmen,M,20,3154199,10516
10306,Zlata,F,20,3154219,10635
10307,Zymier,M,20,3154239,10897
10308,Aairah,F,19,3154258,10810
10309,Aariah,F,19,3154277,10217
10310,Aashir,M,19,3154296,10325
10311,Abdimalik,M,19,3154315,10529
10312,Ademide,M,19,3154334,10517
10313,Adessa,F,19,3154353,10058
10314,Adi,M,19,3154372,10680
10315,Adom,M,19,3154391,10737
10316,Aemilia,F,19,3154410,10552
10317,Agata,F,19,3154429,10050
10318,Agustina,F,19,3154448,10943
10319,Aishah,F,19,3154467,10989
10320,Akio,M,19,3154486,10323
10321,Alanzo,M,19,3154505,10736
10322,Aleksey,M,19,3154524,10666
10323,Aliannah,F,19,3154543,10091
10324,Alyviah,F,19,3154562,10643
10325,Amel,F,19,3154581,10361
10326,Amelio,M,19,3154600,10350
10327,Amiir,M,19,3154619,10611
10328,Amine,M,19,3154638,10244
10329,Amreen,F,19,3154657,10390
10330,Amylah,F,19,3154676,10305
10331,Analis,F,19,3154695,10152
10332,Andony,M,19,3154714,10116
10333,Andree,M,19,3154733,10250
10334,Anila,F,19,3154752,10407
10335,Anisia,F,19,3154771,10493
10336,Annaclaire,F,19,3154790,10828
10337,Annarose,F,19,3154809,10626
10338,Aquila,F,19,3154828,10888
10339,Arda,M,19,3154847,10110
10340,Arianah,F,19,3154866,10254
10341,Arilynn,F,19,3154885,10144
10342,Armanii,F,19,3154904,10327
10343,Ase,F,19,3154923,10306
10344,Ashden,M,19,3154942,10312
10345,Assad,M,19,3154961,10196
10346,Asser,M,19,3154980,10016
10347,Attikus,M,19,3154999,10868
10348,Aunesty,F,19,3155018,10114
10349,Avana,F,19,3155037,10655
10350,Aviahna,F,19,3155056,10471
10351,Avigdor,M,19,3155075,10020
10352,Avira,F,19,3155094,10334
10353,Avon,M,19,3155113,10916
10354,Axten,M,19,3155132,10173
10355,Axxel,M,19,3155151,10043
10356,Ayrah,F,19,3155170,10290
10357,Ayza,F,19,3155189,10587
10358,Azad,M,19,3155208,10055
10359,Azalee,F,19,3155227,10999
10360,Basma,F,19,3155246,10010
10361,Benjiman,M,19,3155265,10838
10362,Beric,M,19,3155284,10389
10363,Bert,M,19,3155303,10089
10364,Bohdan,M,19,3155322,10948
10365,Bora,M,19,3155341,10527
10366,Braedon,M,19,3155360,10218
10367,Bralynn,F,19,3155379,10811
10368,Brekken,M,19,3155398,10692
10369,Brixley,F,19,3155417,10768
10370,Brodi,M,19,3155436,10713
10371,Brynli,F,19,3155455,10278
10372,Callaghan,M,19,3155474,10103
10373,Camella,F,19,3155493,10470
10374,Camya,F,19,3155512,10211
10375,Canton,M,19,3155531,10420
10376,Cardell,M,19,3155550,10905
10377,Carlynn,F,19,3155569,10784
10378,Caron,M,19,3155588,10338
10379,Casandra,F,19,3155607,10941
10380,Castle,M,19,3155626,10131
10381,Chancelor,M,19,3155645,10860
10382,Chapman,M,19,3155664,10088
10383,Charlea,F,19,3155683,10815
10384,Copelan,M,19,3155702,10475
10385,Corah,F,19,3155721,10084
10386,Cord,M,19,3155740,10240
10387,Corynn,F,19,3155759,10696
10388,Crixus,M,19,3155778,10297
10389,Dace,M,19,3155797,10547
10390,Daivik,M,19,3155816,10461
10391,Dalal,F,19,3155835,10700
10392,Damar,M,19,3155854,10961
10393,Daphnie,F,19,3155873,10993
10394,Dawood,M,19,3155892,10161
10395,Deagan,M,19,3155911,10015
10396,Decari,M,19,3155930,10265
10397,Delana,F,19,3155949,10315
10398,Delbert,M,19,3155968,10160
10399,Delton,M,19,3155987,10416
10400,Derrell,M,19,3156006,10494
10401,Devion,M,19,3156025,10852
10402,Dierks,M,19,3156044,10000
10403,Dilynn,F,19,3156063,10106
10404,Diora,F,19,3156082,10099
10405,Dodge,M,19,3156101,10401
10406,Domonique,M,19,3156120,10593
10407,Drayven,M,19,3156139,10925
10408,Dulcemaria,F,19,3156158,10301
10409,Eleena,F,19,3156177,10490
10410,Elianys,F,19,3156196,10277
10411,Ellaina,F,19,3156215,10078
10412,Ellanie,F,19,3156234,10441
10413,Ellerie,F,19,3156253,10369
10414,Ellise,F,19,3156272,10291
10415,Elnora,F,19,3156291,10780
10416,Emad,M,19,3156310,10486
10417,Emelynn,F,19,3156329,10591
10418,Emeree,F,19,3156348,10298
10419,Emerlynn,F,19,3156367,10782
10420,Emmerich,M,19,3156386,10288
10421,Enmanuel,M,19,3156405,10902
10422,Eriksen,M,19,3156424,10480
10423,Esmerelda,F,19,3156443,10129
10424,Evani,F,19,3156462,10391
10425,Everitt,M,19,3156481,10354
10426,Ezmeralda,F,19,3156500,10496
10427,Faelynn,F,19,3156519,10457
10428,Falon,F,19,3156538,10039
10429,Fatiha,F,19,3156557,10915
10430,Favour,F,19,3156576,10843
10431,Feliciano,M,19,3156595,10594
10432,Finnlee,M,19,3156614,10434
10433,Florencia,F,19,3156633,10932
10434,Fradel,F,19,3156652,10187
10435,Francia,F,19,3156671,10599
10436,Ganon,M,19,3156690,10555
10437,Garren,M,19,3156709,10704
10438,Gauri,F,19,3156728,10162
10439,Gautham,M,19,3156747,10698
10440,Gennaro,M,19,3156766,10270
10441,Giancarlos,M,19,3156785,10436
10442,Gracelynne,F,19,3156804,10720
10443,Graceyn,F,19,3156823,10134
10444,Greyden,M,19,3156842,10724
10445,Grier,F,19,3156861,10309
10446,Hadasa,F,19,3156880,10612
10447,Hailyn,F,19,3156899,10073
10448,Haizel,F,19,3156918,10985
10449,Halina,F,19,3156937,10967
10450,Harlin,M,19,3156956,10171
10451,Haydon,M,19,3156975,10807
10452,Hazelgrace,F,19,3156994,10702
10453,Helaina,F,19,3157013,10399
10454,Hesston,M,19,3157032,10504
10455,Hiyab,F,19,3157051,10667
10456,Huckleberry,M,19,3157070,10007
10457,Ikhlas,F,19,3157089,10606
10458,Ione,F,19,3157108,10179
10459,Ita,F,19,3157127,10572
10460,Iya,F,19,3157146,10546
10461,Izamar,F,19,3157165,10340
10462,Jacinto,M,19,3157184,10940
10463,Jacori,M,19,3157203,10878
10464,Jadriel,M,19,3157222,10432
10465,Jaimeson,M,19,3157241,10113
10466,Jamon,M,19,3157260,10588
10467,Jaquez,M,19,3157279,10873
10468,Jardani,M,19,3157298,10617
10469,Javaughn,M,19,3157317,10048
10470,Jayko,M,19,3157336,10247
10471,Jaymar,M,19,3157355,10041
10472,Jaysa,F,19,3157374,10121
10473,Jayvin,M,19,3157393,10014
10474,Jeanna,F,19,3157412,10468
10475,Jeb,M,19,3157431,10719
10476,Jedi,M,19,3157450,10320
10477,Jenica,F,19,3157469,10294
10478,Jezreel,M,19,3157488,10329
10479,Jhonathan,M,19,3157507,10082
10480,Joash,M,19,3157526,10573
10481,Joshlynn,F,19,3157545,10875
10482,Josilyn,F,19,3157564,10845
10483,Jozlyn,F,19,3157583,10757
10484,Julianny,F,19,3157602,10592
10485,Kadiatou,F,19,3157621,10460
10486,Kaiel,M,19,3157640,10215
10487,Kailor,M,19,3157659,10439
10488,Kais,M,19,3157678,10226
10489,Kaislynn,F,19,3157697,10869
10490,Kaiyan,M,19,3157716,10676
10491,Kalianna,F,19,3157735,10901
10492,Kana,F,19,3157754,10068
10493,Karena,F,19,3157773,10570
10494,Kassia,F,19,3157792,10580
10495,Kathrine,F,19,3157811,10773
10496,Kayah,F,19,3157830,10683
10497,Keana,F,19,3157849,10289
10498,Kelaya,F,19,3157868,10139
10499,Kelby,F,19,3157887,10271
10500,Kemoni,F,19,3157906,10484
10501,Kennan,M,19,3157925,10450
10502,Kennidi,F,19,3157944,10689
10503,Kesler,M,19,3157963,10201
10504,Kestrel,F,19,3157982,10536
10505,Kevyn,M,19,3158001,10109
10506,Keyvon,M,19,3158020,10613
10507,Khyan,M,19,3158039,10661
10508,Khyrin,M,19,3158058,10337
10509,Kiansh,M,19,3158077,10970
10510,Kina,F,19,3158096,10286
10511,Kinslie,F,19,3158115,10987
10512,Kj,M,19,3158134,10779
10513,Klein,M,19,3158153,10959
10514,Kloie,F,19,3158172,10169
10515,Kutler,M,19,3158191,10623
10516,Kwabena,M,19,3158210,10155
10517,Ky,M,19,3158229,10839
10518,Lama,F,19,3158248,10021
10519,Lamarr,M,19,3158267,10862
10520,Lamiya,F,19,3158286,10973
10521,Laniah,F,19,3158305,10510
10522,Lavelle,M,19,3158324,10363
10523,Lavonte,M,19,3158343,10583
10524,Leandre,M,19,3158362,10208
10525,Leiani,F,19,3158381,10319
10526,Lexton,M,19,3158400,10739
10527,Liliann,F,19,3158419,10330
10528,Lilibeth,F,19,3158438,10159
10529,Liliya,F,19,3158457,10886
10530,Lita,F,19,3158476,10025
10531,Loni,F,19,3158495,10454
10532,Loreal,F,19,3158514,10647
10533,Lorielle,F,19,3158533,10914
10534,Lucila,F,19,3158552,10917
10535,Lukasz,M,19,3158571,10071
10536,Lynnex,F,19,3158590,10978
10537,Lyrical,F,19,3158609,10140
10538,Maayan,F,19,3158628,10866
10539,Maebel,F,19,3158647,10889
10540,Maevery,F,19,3158666,10522
10541,Mahayla,F,19,3158685,10793
10542,Makaylee,F,19,3158704,10349
10543,Makinlee,F,19,3158723,10684
10544,Makinsley,F,19,3158742,10709
10545,Malahni,F,19,3158761,10446
10546,Malaina,F,19,3158780,10556
10547,Malikye,M,19,3158799,10097
10548,Marlyn,F,19,3158818,10578
10549,Marquell,M,19,3158837,10464
10550,Maryelizabeth,F,19,3158856,10663
10551,Mataya,F,19,3158875,10477
10552,Matei,M,19,3158894,10531
10553,Matty,F,19,3158913,10621
10554,Maximino,M,19,3158932,10183
10555,Maylynn,F,19,3158951,10115
10556,Mehdi,M,19,3158970,10175
10557,Meliodas,M,19,3158989,10951
10558,Menashe,M,19,3159008,10772
10559,Mercie,F,19,3159027,10694
10560,Merek,M,19,3159046,10508
10561,Miana,F,19,3159065,10449
10562,Milanni,F,19,3159084,10398
10563,Mirakle,F,19,3159103,10561
10564,Mireille,F,19,3159122,10332
10565,Miron,M,19,3159141,10610
10566,Mirra,F,19,3159160,10958
10567,Misa,F,19,3159179,10430
10568,Mithra,F,19,3159198,10721
10569,Moksha,F,19,3159217,10972
10570,Mostafa,M,19,3159236,10481
10571,Mousa,M,19,3159255,10907
10572,Muaz,M,19,3159274,10896
10573,Murdo,M,19,3159293,10988
10574,Murtaza,M,19,3159312,10927
10575,Mykayla,F,19,3159331,10672
10576,Mykell,M,19,3159350,10467
10577,Myrna,F,19,3159369,10960
10578,Nadiyah,F,19,3159388,10652
10579,Nahlani,F,19,3159407,10345
10580,Naji,M,19,3159426,10102
10581,Nathania,F,19,3159445,10409
10582,Naysa,F,19,3159464,10047
10583,Nazaria,F,19,3159483,10854
10584,Neville,M,19,3159502,10062
10585,Nikolaj,M,19,3159521,10125
10586,Nizhoni,F,19,3159540,10040
10587,Nysa,F,19,3159559,10928
10588,Oaks,M,19,3159578,10479
10589,Odalis,F,19,3159597,10425
10590,Olina,F,19,3159616,10262
10591,Oseias,M,19,3159635,10230
10592,Owais,M,19,3159654,10353
10593,Pacey,M,19,3159673,10625
10594,Pasha,M,19,3159692,10935
10595,Paxson,M,19,3159711,10011
10596,Petrona,F,19,3159730,10331
10597,Prairie,F,19,3159749,10986
10598,Quillan,M,19,3159768,10085
10599,Raeann,F,19,3159787,10859
10600,Rael,M,19,3159806,10406
10601,Raileigh,F,19,3159825,10911
10602,Rainie,F,19,3159844,10558
10603,Rainn,F,19,3159863,10246
10604,Raiyan,M,19,3159882,10443
10605,Rawlings,M,19,3159901,10108
10606,Reighlynn,F,19,3159920,10823
10607,Rizwan,M,19,3159939,10136
10608,Roark,M,19,3159958,10708
10609,Rosali,F,19,3159977,10653
10610,Rowe,M,19,3159996,10388
10611,Rubyrose,F,19,3160015,10488
10612,Ryman,M,19,3160034,10898
10613,Ryot,M,19,3160053,10124
10614,Saba,F,19,3160072,10586
10615,Saina,F,19,3160091,10400
10616,Saiya,F,19,3160110,10863
10617,Sallie,F,19,3160129,10821
10618,Sartaj,M,19,3160148,10387
10619,Sarthak,M,19,3160167,10083
10620,Saskia,F,19,3160186,10581
10621,Sejal,F,19,3160205,10093
10622,Sevynn,F,19,3160224,10761
10623,Shade,M,19,3160243,10669
10624,Shanel,F,19,3160262,10372
10625,Shani,F,19,3160281,10205
10626,Shaniah,F,19,3160300,10070
10627,Shantel,F,19,3160319,10371
10628,Shivaansh,M,19,3160338,10872
10629,Shon,M,19,3160357,10280
10630,Sigrid,F,19,3160376,10541
10631,Sinan,M,19,3160395,10949
10632,Sirus,M,19,3160414,10383
10633,Siyah,F,19,3160433,10447
10634,Skyelynn,F,19,3160452,10774
10635,Srihan,M,19,3160471,10052
10636,Sriya,F,19,3160490,10253
10637,Stavros,M,19,3160509,10199
10638,Stevi,F,19,3160528,10804
10639,Sura,F,19,3160547,10501
10640,Symere,M,19,3160566,10228
10641,Taelor,F,19,3160585,10544
10642,Taisley,F,19,3160604,10783
10643,Tamari,F,19,3160623,10023
10644,Tameem,M,19,3160642,10706
10645,Tanyla,F,19,3160661,10642
10646,Tatianna,F,19,3160680,10530
10647,Tea,F,19,3160699,10188
10648,Teal,F,19,3160718,10035
10649,Tenaya,F,19,3160737,10469
10650,Thaily,F,19,3160756,10268
10651,Thien,M,19,3160775,10276
10652,Thierno,M,19,3160794,10117
10653,Thierry,M,19,3160813,10030
10654,Timoteo,M,19,3160832,10077
10655,Torrey,M,19,3160851,10900
10656,Trayden,M,19,3160870,10963
10657,Trista,F,19,3160889,10452
10658,Trulee,F,19,3160908,10946
10659,Tyana,F,19,3160927,10521
10660,Tyleah,F,19,3160946,10805
10661,Tyleigh,F,19,3160965,10219
10662,Tyrel,M,19,3160984,10740
10663,Tzirel,F,19,3161003,10912
10664,Vansh,M,19,3161022,10335
10665,Varnika,F,19,3161041,10086
10666,Vayla,F,19,3161060,10482
10667,Viransh,M,19,3161079,10427
10668,Wael,M,19,3161098,10130
10669,Winslet,F,19,3161117,10186
10670,Xariah,F,19,3161136,10906
10671,Xayne,M,19,3161155,10348
10672,Yacoub,M,19,3161174,10193
10673,Yaffa,F,19,3161193,10321
10674,Yashika,F,19,3161212,10835
10675,Yostin,M,19,3161231,10688
10676,Zadok,M,19,3161250,10618
10677,Zaevion,M,19,3161269,10462
10678,Zailah,F,19,3161288,10630
10679,Zaiyah,F,19,3161307,10990
10680,Zanovia,F,19,3161326,10646
10681,Zaydon,M,19,3161345,10421
10682,Zaylan,M,19,3161364,10028
10683,Zenaya,F,19,3161383,10760
10684,Zeriah,F,19,3161402,10616
10685,Ziara,F,19,3161421,10367
10686,Ziare,M,19,3161440,10033
10687,Zlatan,M,19,3161459,10451
10688,Zymeir,M,19,3161478,10274
10689,Aalaya,F,18,3161496,10966
10690,Aaliah,F,18,3161514,10846
10691,Aaminah,F,18,3161532,10634
10692,Aaren,M,18,3161550,10310
10693,Abdulahi,M,18,3161568,10942
10694,Abdurahman,M,18,3161586,10705
10695,Aboubacar,M,18,3161604,10981
10696,Adaeze,F,18,3161622,10885
10697,Adalei,F,18,3161640,10096
10698,Adams,M,18,3161658,10352
10699,Adisyn,F,18,3161676,10825
10700,Adithya,M,18,3161694,10506
10701,Adonias,M,18,3161712,10980
10702,Adonijah,M,18,3161730,10243
10703,Adylene,F,18,3161748,10105
10704,Aeneas,M,18,3161766,10976
10705,Aerilyn,F,18,3161784,10336
10706,Aerolynn,F,18,3161802,10953
10707,Aeron,M,18,3161820,10013
10708,Aeva,F,18,3161838,10711
10709,Ahmina,F,18,3161856,10170
10710,Aidel,F,18,3161874,10019
10711,Alauna,F,18,3161892,10726
10712,Aldin,M,18,3161910,10189
10713,Alecia,F,18,3161928,10851
10714,Aleem,M,18,3161946,10751
10715,Alexiana,F,18,3161964,10806
10716,Alexie,F,18,3161982,10422
10717,Alexsander,M,18,3162000,10937
10718,Allanah,F,18,3162018,10746
10719,Allyana,F,18,3162036,10054
10720,Alydia,F,18,3162054,10844
10721,Amarius,M,18,3162072,10092
10722,Amberleigh,F,18,3162090,10982
10723,Ameliarose,F,18,3162108,10732
10724,Ammy,F,18,3162126,10656
10725,Analayah,F,18,3162144,10636
10726,Analea,F,18,3162162,10582
10727,Analiz,F,18,3162180,10017
10728,Anastassia,F,18,3162198,10849
10729,Andraya,F,18,3162216,10209
10730,Andry,M,18,3162234,10956
10731,Anel,F,18,3162252,10435
10732,Anhad,M,18,3162270,10775
10733,Aolanis,F,18,3162288,10249
10734,Apollonia,F,18,3162306,10307
10735,Arayna,F,18,3162324,10006
10736,Areen,F,18,3162342,10528
10737,Areg,M,18,3162360,10198
10738,Arieanna,F,18,3162378,10785
10739,Ariellah,F,18,3162396,10322
10740,Arielys,F,18,3162414,10366
10741,Arii,F,18,3162432,10540
10742,Arleny,F,18,3162450,10190
10743,Armiah,F,18,3162468,10741
10744,Arrianna,F,18,3162486,10370
10745,Asriel,M,18,3162504,10919
10746,Astra,F,18,3162522,10135
10747,Athanasius,M,18,3162540,10216
10748,Auriel,F,18,3162558,10665
10749,Avaline,F,18,3162576,10731
10750,Averey,F,18,3162594,10072
10751,Averyana,F,18,3162612,10819
10752,Avinash,M,18,3162630,10934
10753,Aviya,F,18,3162648,10149
10754,Ayrton,M,18,3162666,10893
10755,Aytana,F,18,3162684,10156
10756,Azeem,M,18,3162702,10994
10757,Azia,F,18,3162720,10128
10758,Bani,F,18,3162738,10079
10759,Bassam,M,18,3162756,10507
10760,Batya,F,18,3162774,10385
10761,Beauty,F,18,3162792,10360
10762,Belal,M,18,3162810,10565
10763,Belky,F,18,3162828,10347
10764,Benjamyn,M,18,3162846,10444
10765,Bensyn,M,18,3162864,10984
10766,Bodey,M,18,3162882,10101
10767,Bow,M,18,3162900,10355
10768,Braelee,F,18,3162918,10178
10769,Bransyn,M,18,3162936,10356
10770,Braydan,M,18,3162954,10300
10771,Braydin,M,18,3162972,10142
10772,Breyon,M,18,3162990,10002
10773,Brezlyn,F,18,3163008,10495
10774,Briarrose,F,18,3163026,10519
10775,Brightyn,F,18,3163044,10191
10776,Britany,F,18,3163062,10803
10777,Briyah,F,18,3163080,10448
10778,Broc,M,18,3163098,10816
10779,Brynlea,F,18,3163116,10164
10780,Buddy,M,18,3163134,10722
10781,Caiya,F,18,3163152,10378
10782,Calee,F,18,3163170,10526
10783,Camber,F,18,3163188,10777
10784,Camilia,F,18,3163206,10677
10785,Camree,F,18,3163224,10553
10786,Cana,F,18,3163242,10333
10787,Carey,M,18,3163260,10537
10788,Carmina,F,18,3163278,10212
10789,Carolyne,F,18,3163296,10841
10790,Catalyna,F,18,3163314,10730
10791,Chantelle,F,18,3163332,10674
10792,Charlei,F,18,3163350,10870
10793,Cherie,F,18,3163368,10222
10794,Chi,F,18,3163386,10944
10795,China,F,18,3163404,10538
10796,Chipper,M,18,3163422,10564
10797,Chloie,F,18,3163440,10445
10798,Circe,F,18,3163458,10377
10799,Cobain,M,18,3163476,10098
10800,Consuelo,F,18,3163494,10120
10801,Corra,F,18,3163512,10442
10802,Credence,M,18,3163530,10285
10803,Cyler,M,18,3163548,10339
10804,Daily,F,18,3163566,10979
10805,Daisha,F,18,3163584,10699
10806,Dalida,F,18,3163602,10648
10807,Danitza,F,18,3163620,10284
10808,Darious,M,18,3163638,10147
10809,Daris,M,18,3163656,10813
10810,Daryan,M,18,3163674,10654
10811,Dasean,M,18,3163692,10094
10812,Dashiel,M,18,3163710,10034
10813,Daviana,F,18,3163728,10747
10814,Daymian,M,18,3163746,10738
10815,Deklen,M,18,3163764,10557
10816,Deliah,F,18,3163782,10569
10817,Demauri,M,18,3163800,10273
10818,Demitrius,M,18,3163818,10393
10819,Dez,M,18,3163836,10945
10820,Dianne,F,18,3163854,10505
10821,Dominica,F,18,3163872,10659
10822,Donavin,M,18,3163890,10924
10823,Dovie,F,18,3163908,10607
10824,Draylen,M,18,3163926,10930
10825,Dreya,F,18,3163944,10585
10826,Drue,M,18,3163962,10424
10827,Eduar,M,18,3163980,10046
10828,Eider,M,18,3163998,10836
10829,Eilee,F,18,3164016,10880
10830,Eirene,F,18,3164034,10314
10831,Elah,F,18,3164052,10682
10832,Eline,F,18,3164070,10977
10833,Elinore,F,18,3164088,10463
10834,Elis,F,18,3164106,10242
10835,Elisabet,F,18,3164124,10921
10836,Ellarae,F,18,3164142,10603
10837,Ellianah,F,18,3164160,10650
10838,Elliyana,F,18,3164178,10500
10839,Elyn,F,18,3164196,10964
10840,Emitt,M,18,3164214,10374
10841,Emmajane,F,18,3164232,10532
10842,Emmalia,F,18,3164250,10104
10843,England,F,18,3164268,10029
10844,Ernie,M,18,3164286,10256
10845,Esben,M,18,3164304,10194
10846,Eston,M,18,3164322,10595
10847,Evalena,F,18,3164340,10026
10848,Evalynne,F,18,3164358,10883
10849,Evamarie,F,18,3164376,10012
10850,Everlei,F,18,3164394,10379
10851,Evi,F,18,3164412,10701
10852,Ezeriah,M,18,3164430,10725
10853,Fanny,F,18,3164448,10066
10854,Finnleigh,F,18,3164466,10752
10855,Freda,F,18,3164484,10651
10856,Garett,M,18,3164502,10641
10857,Gaston,M,18,3164520,10789
10858,Genavieve,F,18,3164538,10458
10859,Ghazal,F,18,3164556,10786
10860,Graelynn,F,18,3164574,10686
10861,Graesyn,M,18,3164592,10119
10862,Graison,M,18,3164610,10067
10863,Gurleen,F,18,3164628,10487
10864,Hajra,F,18,3164646,10992
10865,Hawken,M,18,3164664,10788
10866,Haynes,M,18,3164682,10931
10867,Hazelle,F,18,3164700,10974
10868,Helina,F,18,3164718,10145
10869,Hikari,F,18,3164736,10049
10870,Hina,F,18,3164754,10571
10871,Hirving,M,18,3164772,10074
10872,Huckson,M,18,3164790,10476
10873,Hyatt,M,18,3164808,10857
10874,Imara,F,18,3164826,10260
10875,Inari,F,18,3164844,10214
10876,Ioannis,M,18,3164862,10890
10877,Isak,M,18,3164880,10138
10878,Itzayanna,F,18,3164898,10022
10879,Iyan,M,18,3164916,10792
10880,Iymona,F,18,3164934,10107
10881,Izadora,F,18,3164952,10568
10882,Jackston,M,18,3164970,10185
10883,Jaedon,M,18,3164988,10560
10884,Jahki,M,18,3165006,10489
10885,Jahmeir,M,18,3165024,10824
10886,Jaiven,M,18,3165042,10735
10887,Jakaylah,F,18,3165060,10351
10888,Jalon,M,18,3165078,10283
10889,Jalyssa,F,18,3165096,10913
10890,Jamylah,F,18,3165114,10750
10891,Jasey,F,18,3165132,10748
10892,Jashaun,M,18,3165150,10248
10893,Jatziry,F,18,3165168,10404
10894,Javaris,M,18,3165186,10118
10895,Jaylianna,F,18,3165204,10781
10896,Jaysean,M,18,3165222,10710
10897,Jeanine,F,18,3165240,10637
10898,Jeri,F,18,3165258,10053
10899,Jersie,F,18,3165276,10729
10900,Jhayden,M,18,3165294,10317
10901,Jonnie,F,18,3165312,10502
10902,Jordani,M,18,3165330,10514
10903,Jorel,M,18,3165348,10712
10904,Joslin,F,18,3165366,10004
10905,Joss,M,18,3165384,10045
10906,Josslynn,F,18,3165402,10234
10907,Juda,M,18,3165420,10861
10908,Justis,M,18,3165438,10497
10909,Kahealani,F,18,3165456,10453
10910,Kahmari,M,18,3165474,10158
10911,Kaidance,F,18,3165492,10624
10912,Kaidon,M,18,3165510,10947
10913,Kailana,F,18,3165528,10465
10914,Kaileah,F,18,3165546,10503
10915,Kaio,M,18,3165564,10024
10916,Kaizlee,F,18,3165582,10864
10917,Kaled,M,18,3165600,10272
10918,Kamarie,F,18,3165618,10926
10919,Kamrie,F,18,3165636,10550
10920,Kani,M,18,3165654,10754
10921,Karsin,M,18,3165672,10266
10922,Kashlyn,F,18,3165690,10236
10923,Kassim,M,18,3165708,10668
10924,Kataleyah,F,18,3165726,10172
10925,Kaulder,M,18,3165744,10392
10926,Kaveer,M,18,3165762,10832
10927,Kaven,M,18,3165780,10920
10928,Kayslee,F,18,3165798,10220
10929,Keiko,F,18,3165816,10858
10930,Keldon,M,18,3165834,10632
10931,Kemarion,M,18,3165852,10998
10932,Kenda,F,18,3165870,10261
10933,Kenedi,F,18,3165888,10303
10934,Kento,M,18,3165906,10166
10935,Kenzli,F,18,3165924,10075
10936,Kera,F,18,3165942,10675
10937,Kerri,F,18,3165960,10795
10938,Kilee,F,18,3165978,10753
10939,Kingjames,M,18,3165996,10865
10940,Kirill,M,18,3166014,10799
10941,Koltin,M,18,3166032,10412
10942,Koral,F,18,3166050,10414
10943,Kourtni,F,18,3166068,10032
10944,Krithi,F,18,3166086,10744
10945,Ksenia,F,18,3166104,10549
10946,Kush,M,18,3166122,10765
10947,Kyleena,F,18,3166140,10057
10948,Kynlei,F,18,3166158,10005
10949,Kynzley,F,18,3166176,10069
10950,Kynzlie,F,18,3166194,10820
10951,Laisha,F,18,3166212,10231
10952,Laker,M,18,3166230,10598
10953,Lamaya,F,18,3166248,10909
10954,Lamonte,M,18,3166266,10716
10955,Larisa,F,18,3166284,10341
10956,Latham,M,18,3166302,10437
10957,Laurent,M,18,3166320,10302
10958,Leiya,F,18,3166338,10584
10959,Leyana,F,18,3166356,10879
10960,Lilinoe,F,18,3166374,10755
10961,Lilley,F,18,3166392,10264
10962,Lillyonna,F,18,3166410,10386
10963,Lilou,F,18,3166428,10080
10964,Lliam,M,18,3166446,10405
10965,Lojain,F,18,3166464,10258
10966,Loralai,F,18,3166482,10895
10967,Lord,M,18,3166500,10042
10968,Lucilla,F,18,3166518,10027
10969,Lunabella,F,18,3166536,10776
10970,Lyndee,F,18,3166554,10044
10971,Lynnix,F,18,3166572,10968
10972,Mabelle,F,18,3166590,10210
10973,Mackenzi,F,18,3166608,10395
10974,Maddi,F,18,3166626,10695
10975,Madisen,F,18,3166644,10478
10976,Madix,M,18,3166662,10727
10977,Mahdiya,F,18,3166680,10842
10978,Maheen,F,18,3166698,10794
10979,Maize,F,18,3166716,10396
10980,Majour,M,18,3166734,10633
10981,Makenzy,F,18,3166752,10638
10982,Maksym,M,18,3166770,10362
10983,Malaynah,F,18,3166788,10545
10984,Maleya,F,18,3166806,10664
10985,Maliek,M,18,3166824,10697
10986,Marelyn,F,18,3166842,10742
10987,Mariposa,F,18,3166860,10589
10988,Mariska,F,18,3166878,10061
10989,Marit,F,18,3166896,10829
10990,Marquan,M,18,3166914,10064
10991,Marvella,F,18,3166932,10639
10992,Master,M,18,3166950,10275
10993,Mattheo,M,18,3166968,10640
10994,Maximillion,M,18,3166986,10408
10995,Maybelline,F,18,3167004,10313
10996,Mccall,F,18,3167022,10796
10997,Mekhai,M,18,3167040,10971
10998,Mel,F,18,3167058,10358
10999,Melaina,F,18,3167076,10770
11000,Metzli,F,18,3167094,11895
11001,Michelina,F,18,3167112,11342
11002,Mikkel,M,18,3167130,11900
11003,Milanie,F,18,3167148,11530
11004,Milaya,F,18,3167166,11474
11005,Milayna,F,18,3167184,11315
11006,Mirah,F,18,3167202,11162
11007,Moishy,M,18,3167220,11576
11008,Moriyah,F,18,3167238,11970
11009,Mysha,F,18,3167256,11592
11010,Nachman,M,18,3167274,11640
11011,Nadav,M,18,3167292,11210
11012,Nahzir,M,18,3167310,11538
11013,Naliah,F,18,3167328,11144
11014,Nam,M,18,3167346,11894
11015,Natania,F,18,3167364,11858
11016,Navah,F,18,3167382,11946
11017,Nazar,M,18,3167400,11869
11018,Neeko,M,18,3167418,11426
11019,Nefertiti,F,18,3167436,11664
11020,Nettie,F,18,3167454,11260
11021,Nilani,F,18,3167472,11761
11022,Nishka,F,18,3167490,11009
11023,Novalei,F,18,3167508,11890
11024,Nuria,F,18,3167526,11034
11025,Oberyn,M,18,3167544,11235
11026,Odinn,M,18,3167562,11940
11027,Olivander,M,18,3167580,11839
11028,Oluwadarasimi,F,18,3167598,11188
11029,Oshun,F,18,3167616,11862
11030,Ostin,M,18,3167634,11001
11031,Page,F,18,3167652,11301
11032,Paxon,M,18,3167670,11856
11033,Prim,F,18,3167688,11930
11034,Priyanka,F,18,3167706,11817
11035,Qamar,F,18,3167724,11831
11036,Qusai,M,18,3167742,11615
11037,Rainna,F,18,3167760,11243
11038,Raja,M,18,3167778,11924
11039,Raneem,F,18,3167796,11376
11040,Reinaldo,M,18,3167814,11932
11041,Reylynn,F,18,3167832,11132
11042,Reymond,M,18,3167850,11467
11043,Rhyann,F,18,3167868,11202
11044,Riven,F,18,3167886,11030
11045,Riverlee,F,18,3167904,11952
11046,Robel,M,18,3167922,11026
11047,Rolan,M,18,3167940,11405
11048,Romelia,F,18,3167958,11230
11049,Rosely,F,18,3167976,11435
11050,Rubin,M,18,3167994,11698
11051,Rylo,M,18,3168012,11656
11052,Sadee,F,18,3168030,11309
11053,Safiyya,F,18,3168048,11059
11054,Saliyah,F,18,3168066,11755
11055,Samad,M,18,3168084,11458
11056,Samayah,F,18,3168102,11513
11057,Samayra,F,18,3168120,11683
11058,Sanav,M,18,3168138,11428
11059,Sanford,M,18,3168156,11567
11060,Sanjana,F,18,3168174,11290
11061,Serafin,M,18,3168192,11601
11062,Serra,F,18,3168210,11308
11063,Servando,M,18,3168228,11512
11064,Sevan,M,18,3168246,11441
11065,Shanti,F,18,3168264,11049
11066,Shaylynn,F,18,3168282,11015
11067,Shemar,M,18,3168300,11660
11068,Shevy,F,18,3168318,11708
11069,Shianne,F,18,3168336,11732
11070,Shivaay,M,18,3168354,11094
11071,Shiven,M,18,3168372,11336
11072,Shneur,M,18,3168390,11193
11073,Shree,F,18,3168408,11778
11074,Sibyl,F,18,3168426,11891
11075,Sivan,F,18,3168444,11692
11076,Siyana,F,18,3168462,11024
11077,Skarlette,F,18,3168480,11713
11078,Sohan,M,18,3168498,11282
11079,Sokhna,F,18,3168516,11077
11080,Soliha,F,18,3168534,11700
11081,Sorayah,F,18,3168552,11268
11082,Stephania,F,18,3168570,11875
11083,Strider,M,18,3168588,11224
11084,Sumaiya,F,18,3168606,11453
11085,Suraiya,F,18,3168624,11371
11086,Suzy,F,18,3168642,11444
11087,Taksh,M,18,3168660,11045
11088,Talib,M,18,3168678,11503
11089,Tauriel,F,18,3168696,11526
11090,Tavia,F,18,3168714,11523
11091,Thanos,M,18,3168732,11887
11092,Thaxton,M,18,3168750,11884
11093,Tiahna,F,18,3168768,11152
11094,Tiwatope,F,18,3168786,11564
11095,Tobi,F,18,3168804,11176
11096,Trapper,M,18,3168822,11063
11097,Trayce,M,18,3168840,11722
11098,Trenity,F,18,3168858,11396
11099,Trenten,M,18,3168876,11365
11100,Tyasia,F,18,3168894,11557
11101,Uziah,M,18,3168912,11460
11102,Vela,F,18,3168930,11929
11103,Videl,F,18,3168948,11967
11104,Vilma,F,18,3168966,11124
11105,Vivia,F,18,3168984,11085
11106,Waris,M,18,3169002,11494
11107,Wilkes,M,18,3169020,11153
11108,Willian,M,18,3169038,11247
11109,Xayah,F,18,3169056,11299
11110,Ximenna,F,18,3169074,11810
11111,Xuri,F,18,3169092,11951
11112,Xyaire,M,18,3169110,11039
11113,Yann,M,18,3169128,11919
11114,Yanni,M,18,3169146,11023
11115,Yaser,M,18,3169164,11597
11116,Yazen,M,18,3169182,11649
11117,Yogi,M,18,3169200,11321
11118,Yuritzi,F,18,3169218,11418
11119,Zachari,M,18,3169236,11204
11120,Zahari,F,18,3169254,11694
11121,Zarielle,F,18,3169272,11846
11122,Zaryan,M,18,3169290,11987
11123,Zaydee,F,18,3169308,11914
11124,Zeniyah,F,18,3169326,11033
11125,Zenovia,F,18,3169344,11968
11126,Zhane,M,18,3169362,11950
11127,Ziyana,F,18,3169380,11724
11128,Zosia,F,18,3169398,11975
11129,Zyriah,F,18,3169416,11109
11130,Aadyn,M,17,3169433,11585
11131,Aakash,M,17,3169450,11118
11132,Aaleah,F,17,3169467,11457
11133,Aamira,F,17,3169484,11052
11134,Aanaya,F,17,3169501,11102
11135,Aanika,F,17,3169518,11543
11136,Aaralyn,F,17,3169535,11186
11137,Abeeha,F,17,3169552,11411
11138,Abisai,M,17,3169569,11635
11139,Acsa,F,17,3169586,11254
11140,Adalai,F,17,3169603,11257
11141,Adalaide,F,17,3169620,11285
11142,Addalee,F,17,3169637,11472
11143,Addilee,F,17,3169654,11596
11144,Aerial,F,17,3169671,11253
11145,Ahren,M,17,3169688,11446
11146,Aidy,F,17,3169705,11844
11147,Aiken,M,17,3169722,11064
11148,Airess,F,17,3169739,11716
11149,Aivy,F,17,3169756,11609
11150,Aiyah,F,17,3169773,11245
11151,Akhari,M,17,3169790,11075
11152,Akoni,M,17,3169807,11425
11153,Akshaj,M,17,3169824,11514
11154,Alaiia,F,17,3169841,11826
11155,Alayza,F,17,3169858,11814
11156,Aletta,F,17,3169875,11908
11157,Alexandru,M,17,3169892,11237
11158,Alistar,M,17,3169909,11740
11159,Aloysius,M,17,3169926,11935
11160,Alucard,M,17,3169943,11095
11161,Alyaan,M,17,3169960,11147
11162,Amana,F,17,3169977,11270
11163,Amberle,F,17,3169994,11928
11164,Ameira,F,17,3170011,11349
11165,Amilcar,M,17,3170028,11623
11166,Amiliano,M,17,3170045,11972
11167,Amilio,M,17,3170062,11733
11168,Amirra,F,17,3170079,11258
11169,Amouri,F,17,3170096,11591
11170,Anavi,F,17,3170113,11741
11171,Andreana,F,17,3170130,11944
11172,Anduin,M,17,3170147,11240
11173,Aneliz,F,17,3170164,11845
11174,Anishka,F,17,3170181,11394
11175,Anjana,F,17,3170198,11000
11176,Anjel,M,17,3170215,11562
11177,Anova,F,17,3170232,11772
11178,Anshika,F,17,3170249,11958
11179,Antonios,M,17,3170266,11746
11180,Anubis,M,17,3170283,11922
11181,Anuhea,F,17,3170300,11637
11182,Anvay,M,17,3170317,11155
11183,Aphrodite,F,17,3170334,11420
11184,Aquiles,M,17,3170351,11541
11185,Areesha,F,17,3170368,11068
11186,Arial,F,17,3170385,11857
11187,Arias,M,17,3170402,11065
11188,Arika,F,17,3170419,11519
11189,Ario,M,17,3170436,11598
11190,Armonii,F,17,3170453,11777
11191,Arno,M,17,3170470,11168
11192,Arwin,M,17,3170487,11559
11193,Aryam,F,17,3170504,11158
11194,Aryelle,F,17,3170521,11016
11195,Asaph,M,17,3170538,11485
11196,Ashon,M,17,3170555,11099
11197,Ashraf,M,17,3170572,11217
11198,Ashtynn,F,17,3170589,11043
11199,Atziri,F,17,3170606,11021
11200,Aurelie,F,17,3170623,11007
11201,Auriana,F,17,3170640,11758
11202,Aury,F,17,3170657,11566
11203,Autymn,F,17,3170674,11532
11204,Avanna,F,17,3170691,11334
11205,Aveon,M,17,3170708,11010
11206,Avigayil,F,17,3170725,11695
11207,Avyn,M,17,3170742,11196
11208,Aws,M,17,3170759,11478
11209,Aymen,M,17,3170776,11725
11210,Azim,M,17,3170793,11111
11211,Azlaan,M,17,3170810,11726
11212,Baby,M,17,3170827,11384
11213,Barnabas,M,17,3170844,11032
11214,Benuel,M,17,3170861,11029
11215,Bernabe,M,17,3170878,11303
11216,Betania,F,17,3170895,11057
11217,Bexton,M,17,3170912,11117
11218,Bibi,F,17,3170929,11227
11219,Bladimir,M,17,3170946,11274
11220,Blessen,F,17,3170963,11624
11221,Bluma,F,17,3170980,11246
11222,Braelin,M,17,3170997,11002
11223,Brelyn,F,17,3171014,11807
11224,Brendyn,M,17,3171031,11402
11225,Brenner,M,17,3171048,11241
11226,Brienna,F,17,3171065,11423
11227,Brinnley,F,17,3171082,11920
11228,Brocha,F,17,3171099,11602
11229,Cabella,F,17,3171116,11175
11230,Caira,F,17,3171133,11801
11231,Calynn,F,17,3171150,11898
11232,Cambry,F,17,3171167,11035
11233,Camiah,F,17,3171184,11470
11234,Camyla,F,17,3171201,11808
11235,Cane,M,17,3171218,11372
11236,Canek,M,17,3171235,11368
11237,Carlotta,F,17,3171252,11544
11238,Carma,F,17,3171269,11828
11239,Carrick,M,17,3171286,11454
11240,Cavin,M,17,3171303,11883
11241,Cayleb,M,17,3171320,11525
11242,Celestino,M,17,3171337,11326
11243,Chapel,F,17,3171354,11339
11244,Charmaine,F,17,3171371,11340
11245,Chevel,F,17,3171388,11067
11246,Christelle,F,17,3171405,11682
11247,Chyanne,F,17,3171422,11115
11248,Courage,M,17,3171439,11284
11249,Daelan,M,17,3171456,11286
11250,Daisey,F,17,3171473,11369
11251,Dalaya,F,17,3171490,11054
11252,Damontae,M,17,3171507,11551
11253,Danai,F,17,3171524,11232
11254,Darely,F,17,3171541,11134
11255,Dathan,M,17,3171558,11517
11256,Davyn,M,17,3171575,11830
11257,Dayan,M,17,3171592,11038
11258,Daymon,M,17,3171609,11918
11259,Deari,F,17,3171626,11192
11260,Dearia,F,17,3171643,11912
11261,Debanhi,F,17,3171660,11239
11262,Deirdre,F,17,3171677,11595
11263,Dejon,M,17,3171694,11962
11264,Deng,M,17,3171711,11374
11265,Denzell,M,17,3171728,11710
11266,Dheeran,M,17,3171745,11666
11267,Diamante,M,17,3171762,11151
11268,Dontay,M,17,3171779,11450
11269,Ehsan,M,17,3171796,11855
11270,Eily,F,17,3171813,11142
11271,Elanna,F,17,3171830,11629
11272,Eliane,F,17,3171847,11455
11273,Ellaria,F,17,3171864,11638
11274,Elliet,F,17,3171881,11181
11275,Elspeth,F,17,3171898,11164
11276,Elyan,M,17,3171915,11641
11277,Emanuela,F,17,3171932,11659
11278,Emberli,F,17,3171949,11275
11279,Emerlyn,F,17,3171966,11836
11280,Emiya,F,17,3171983,11634
11281,Emmajean,F,17,3172000,11998
11282,Emmaus,M,17,3172017,11627
11283,Emunah,F,17,3172034,11242
11284,Enna,F,17,3172051,11663
11285,Ensleigh,F,17,3172068,11028
11286,Enzlee,F,17,3172085,11743
11287,Erabella,F,17,3172102,11141
11288,Erasmo,M,17,3172119,11960
11289,Eretria,F,17,3172136,11300
11290,Estuardo,M,17,3172153,11347
11291,Evah,F,17,3172170,11031
11292,Evaleigh,F,17,3172187,11092
11293,Evellyn,F,17,3172204,11400
11294,Ezabella,F,17,3172221,11744
11295,Faizah,F,17,3172238,11101
11296,Faraz,M,17,3172255,11902
11297,Fawaz,M,17,3172272,11289
11298,Fawn,F,17,3172289,11669
11299,Filippo,M,17,3172306,11410
11300,Fraya,F,17,3172323,11643
11301,Gaelle,F,17,3172340,11412
11302,Gennesis,F,17,3172357,11198
11303,Gershon,M,17,3172374,11873
11304,Gionna,F,17,3172391,11915
11305,Giorgia,F,17,3172408,11166
11306,Gisel,F,17,3172425,11008
11307,Godric,M,17,3172442,11110
11308,Godwin,M,17,3172459,11811
11309,Gracin,M,17,3172476,11203
11310,Grae,M,17,3172493,11066
11311,Greenlee,F,17,3172510,11760
11312,Greysin,M,17,3172527,11901
11313,Guilherme,M,17,3172544,11579
11314,Haileigh,F,17,3172561,11419
11315,Hailynn,F,17,3172578,11319
11316,Hanvika,F,17,3172595,11486
11317,Harini,F,17,3172612,11816
11318,Harnoor,F,17,3172629,11050
11319,Haru,M,17,3172646,11654
11320,Hays,M,17,3172663,11936
11321,Hazlee,F,17,3172680,11668
11322,Heily,F,17,3172697,11407
11323,Hewitt,M,17,3172714,11766
11324,Iann,M,17,3172731,11565
11325,Idan,M,17,3172748,11138
11326,Iden,M,17,3172765,11536
11327,Ilyanna,F,17,3172782,11498
11328,Inessa,F,17,3172799,11249
11329,Inioluwa,F,17,3172816,11948
11330,Iriana,F,17,3172833,11086
11331,Iroh,M,17,3172850,11187
11332,Iskender,M,17,3172867,11228
11333,Issachar,M,17,3172884,11859
11334,Itali,F,17,3172901,11265
11335,Iviona,F,17,3172918,11114
11336,Ivorie,F,17,3172935,11943
11337,Jaaziel,M,17,3172952,11291
11338,Jahkari,M,17,3172969,11921
11339,Jaimee,F,17,3172986,11939
11340,Jakori,M,17,3173003,11510
11341,Jalaiyah,F,17,3173020,11852
11342,Jalea,F,17,3173037,11506
11343,Jalena,F,17,3173054,11070
11344,Jalina,F,17,3173071,11757
11345,Jamarri,M,17,3173088,11779
11346,Jameria,F,17,3173105,11689
11347,Jamileth,F,17,3173122,11677
11348,Jamire,M,17,3173139,11815
11349,Janina,F,17,3173156,11358
11350,Jarely,F,17,3173173,11323
11351,Jasher,M,17,3173190,11899
11352,Jasson,M,17,3173207,11504
11353,Jaxxton,M,17,3173224,11377
11354,Jaye,F,17,3173241,11072
11355,Jazz,F,17,3173258,11665
11356,Jd,M,17,3173275,11658
11357,Jernee,F,17,3173292,11865
11358,Jersei,F,17,3173309,11493
11359,Jersi,F,17,3173326,11185
11360,Jerusalem,F,17,3173343,11933
11361,Jessika,F,17,3173360,11417
11362,Jeylin,F,17,3173377,11238
11363,Jezelle,F,17,3173394,11221
11364,Jiah,F,17,3173411,11328
11365,Jibran,M,17,3173428,11157
11366,Jiovani,M,17,3173445,11535
11367,Jiyaan,M,17,3173462,11794
11368,Jj,M,17,3173479,11646
11369,Jolette,F,17,3173496,11135
11370,Joriel,M,17,3173513,11813
11371,Josefine,F,17,3173530,11511
11372,Jowell,M,17,3173547,11014
11373,Juanjose,M,17,3173564,11471
11374,Juri,F,17,3173581,11652
11375,Jurnie,F,17,3173598,11126
11376,Kaeleigh,F,17,3173615,11969
11377,Kaesen,M,17,3173632,11178
11378,Kamaiya,F,17,3173649,11825
11379,Kamilo,M,17,3173666,11073
11380,Kamirah,F,17,3173683,11003
11381,Kamiri,M,17,3173700,11389
11382,Kano,M,17,3173717,11583
11383,Kareli,F,17,3173734,11877
11384,Karin,F,17,3173751,11421
11385,Karmin,F,17,3173768,11639
11386,Kashden,M,17,3173785,11941
11387,Katalea,F,17,3173802,11482
11388,Kataleah,F,17,3173819,11705
11389,Katty,F,17,3173836,11614
11390,Kavari,M,17,3173853,11984
11391,Kaveh,M,17,3173870,11588
11392,Kavir,M,17,3173887,11364
11393,Kaylonni,F,17,3173904,11611
11394,Kaysha,F,17,3173921,11218
11395,Keara,F,17,3173938,11769
11396,Kelia,F,17,3173955,11991
11397,Kemiyah,F,17,3173972,11913
11398,Kendriel,M,17,3173989,11910
11399,Kenli,F,17,3174006,11867
11400,Kenshin,M,17,3174023,11488
11401,Kenzly,F,17,3174040,11431
11402,Kessler,M,17,3174057,11473
11403,Keyler,M,17,3174074,11818
11404,Keysha,F,17,3174091,11508
11405,Khalan,M,17,3174108,11981
11406,Khalon,M,17,3174125,11346
11407,Khamora,F,17,3174142,11163
11408,Kimball,M,17,3174159,11702
11409,Kingdavid,M,17,3174176,11390
11410,Kiyanne,F,17,3174193,11849
11411,Kiyon,M,17,3174210,11575
11412,Kizer,M,17,3174227,11404
11413,Kona,F,17,3174244,11261
11414,Kristoff,M,17,3174261,11739
11415,Krystina,F,17,3174278,11632
11416,Kulture,F,17,3174295,11568
11417,Kyce,M,17,3174312,11338
11418,Kycen,M,17,3174329,11784
11419,Kyia,F,17,3174346,11773
11420,Kyion,M,17,3174363,11461
11421,Kyliah,F,17,3174380,11440
11422,Kynli,F,17,3174397,11343
11423,Kynlie,F,17,3174414,11608
11424,Kynsli,F,17,3174431,11262
11425,Kyriee,M,17,3174448,11462
11426,Ladon,M,17,3174465,11570
11427,Laiah,F,17,3174482,11005
11428,Lailoni,F,17,3174499,11881
11429,Landrey,F,17,3174516,11337
11430,Laquan,M,17,3174533,11205
11431,Leda,F,17,3174550,11706
11432,Legendary,M,17,3174567,11685
11433,Leiloni,F,17,3174584,11756
11434,Lennie,F,17,3174601,11137
11435,Lestat,M,17,3174618,11154
11436,Liel,F,17,3174635,11445
11437,Lilymae,F,17,3174652,11234
11438,Lindley,F,17,3174669,11489
11439,Liviya,F,17,3174686,11573
11440,Lovella,F,17,3174703,11098
11441,Luanna,F,17,3174720,11542
11442,Luisangel,M,17,3174737,11264
11443,Lydiah,F,17,3174754,11957
11444,Lyllian,F,17,3174771,11603
11445,Macarena,F,17,3174788,11121
11446,Machai,M,17,3174805,11619
11447,Macyn,F,17,3174822,11252
11448,Maegan,F,17,3174839,11194
11449,Maelys,F,17,3174856,11255
11450,Magdalyn,F,17,3174873,11280
11451,Magic,M,17,3174890,11829
11452,Mahogani,F,17,3174907,11546
11453,Maikol,M,17,3174924,11341
11454,Mailee,F,17,3174941,11780
11455,Makel,M,17,3174958,11409
11456,Makennah,F,17,3174975,11942
11457,Makhari,M,17,3174992,11587
11458,Makynzi,F,17,3175009,11277
11459,Malasia,F,17,3175026,11100
11460,Malayla,F,17,3175043,11889
11461,Malikhi,M,17,3175060,11256
11462,Malin,F,17,3175077,11550
11463,Mannix,M,17,3175094,11633
11464,Marilee,F,17,3175111,11317
11465,Maryellen,F,17,3175128,11971
11466,Maryrose,F,17,3175145,11785
11467,Masiyah,M,17,3175162,11436
11468,Masud,M,17,3175179,11456
11469,Matvey,M,17,3175196,11062
11470,Maxtyn,M,17,3175213,11753
11471,Maybree,F,17,3175230,11500
11472,Maycol,M,17,3175247,11833
11473,Mckinnley,F,17,3175264,11497
11474,Medha,F,17,3175281,11589
11475,Mehkai,M,17,3175298,11071
11476,Melayah,F,17,3175315,11325
11477,Mellie,F,17,3175332,11823
11478,Melodee,F,17,3175349,11477
11479,Menucha,F,17,3175366,11408
11480,Merliah,F,17,3175383,11116
11481,Merry,F,17,3175400,11594
11482,Mikenna,F,17,3175417,11496
11483,Millee,F,17,3175434,11082
11484,Minnah,F,17,3175451,11620
11485,Mourad,M,17,3175468,11366
11486,Mumtaz,F,17,3175485,11938
11487,Mylene,F,17,3175502,11527
11488,Naidelyn,F,17,3175519,11122
11489,Naryah,F,17,3175536,11662
11490,Naviah,F,17,3175553,11442
11491,Navin,M,17,3175570,11737
11492,Nawaf,M,17,3175587,11231
11493,Naylea,F,17,3175604,11604
11494,Nayra,F,17,3175621,11330
11495,Nayvie,F,17,3175638,11563
11496,Netanel,M,17,3175655,11148
11497,Nevaeha,F,17,3175672,11945
11498,Nickson,M,17,3175689,11123
11499,Nieve,F,17,3175706,11013
11500,Nihit,M,17,3175723,11892
11501,Nikolay,M,17,3175740,11259
11502,Nilson,M,17,3175757,11788
11503,Nisha,F,17,3175774,11505
11504,Noeli,F,17,3175791,11006
11505,Noland,M,17,3175808,11717
11506,Norbert,M,17,3175825,11443
11507,Norberto,M,17,3175842,11728
11508,Oakes,M,17,3175859,11167
11509,Ogden,M,17,3175876,11091
11510,Oksana,F,17,3175893,11502
11511,Olivya,F,17,3175910,11795
11512,Omir,M,17,3175927,11430
11513,Oriah,F,17,3175944,11882
11514,Osias,M,17,3175961,11367
11515,Osmin,M,17,3175978,11593
11516,Paisly,F,17,3175995,11061
11517,Paizleigh,F,17,3176012,11824
11518,Phaedra,F,17,3176029,11934
11519,Piero,M,17,3176046,11414
11520,Raegyn,F,17,3176063,11127
11521,Rahil,M,17,3176080,11378
11522,Rahman,M,17,3176097,11917
11523,Railee,F,17,3176114,11113
11524,Raphaella,F,17,3176131,11438
11525,Raquan,M,17,3176148,11296
11526,Raylene,F,17,3176165,11974
11527,Rebeka,F,17,3176182,11159
11528,Rehaan,M,17,3176199,11190
11529,Rhianna,F,17,3176216,11834
11530,Rhonda,F,17,3176233,11424
11531,Rifka,F,17,3176250,11201
11532,Riyad,M,17,3176267,11736
11533,Riyanshi,F,17,3176284,11083
11534,Rodger,M,17,3176301,11534
11535,Roi,M,17,3176318,11422
11536,Romir,M,17,3176335,11832
11537,Rosalin,F,17,3176352,11226
11538,Rosealee,F,17,3176369,11742
11539,Rosmery,F,17,3176386,11465
11540,Ruthann,F,17,3176403,11977
11541,Ryle,M,17,3176420,11985
11542,Ryzen,M,17,3176437,11804
11543,Saadiq,M,17,3176454,11501
11544,Saahir,M,17,3176471,11864
11545,Salice,F,17,3176488,11719
11546,Sanvika,F,17,3176505,11621
11547,Satori,F,17,3176522,11671
11548,Savayah,F,17,3176539,11179
11549,Sayra,F,17,3176556,11992
11550,Schuyler,M,17,3176573,11375
11551,Seher,F,17,3176590,11380
11552,Shariyah,F,17,3176607,11949
11553,Sheily,F,17,3176624,11886
11554,Shine,F,17,3176641,11269
11555,Shivay,M,17,3176658,11655
11556,Shoshanna,F,17,3176675,11452
11557,Shreeya,F,17,3176692,11531
11558,Shylee,F,17,3176709,11561
11559,Sieanna,F,17,3176726,11973
11560,Silvestre,M,17,3176743,11395
11561,Solace,M,17,3176760,11647
11562,Sophya,F,17,3176777,11314
11563,Soriyah,F,17,3176794,11051
11564,Stefani,F,17,3176811,11391
11565,Stirling,M,17,3176828,11363
11566,Stokely,M,17,3176845,11675
11567,Success,F,17,3176862,11316
11568,Symir,M,17,3176879,11011
11569,Taavi,M,17,3176896,11997
11570,Tad,M,17,3176913,11463
11571,Tage,M,17,3176930,11509
11572,Taitum,F,17,3176947,11413
11573,Talal,M,17,3176964,11749
11574,Tamarion,M,17,3176981,11897
11575,Tasha,F,17,3176998,11229
11576,Tavish,M,17,3177015,11089
11577,Tej,M,17,3177032,11053
11578,Teryn,F,17,3177049,11318
11579,Thad,M,17,3177066,11427
11580,Thia,F,17,3177083,11311
11581,Tillman,M,17,3177100,11966
11582,Tinsleigh,F,17,3177117,11084
11583,Treyden,M,17,3177134,11475
11584,Tricia,F,17,3177151,11387
11585,Tylie,F,17,3177168,11120
11586,Tyonna,F,17,3177185,11106
11587,Tyrian,M,17,3177202,11651
11588,Tyshon,M,17,3177219,11745
11589,Valley,F,17,3177236,11449
11590,Valorie,F,17,3177253,11738
11591,Vanity,F,17,3177270,11476
11592,Veeksha,F,17,3177287,11548
11593,Vincente,M,17,3177304,11853
11594,Vinicio,M,17,3177321,11331
11595,Warrick,M,17,3177338,11729
11596,Wilbert,M,17,3177355,11093
11597,Winner,M,17,3177372,11279
11598,Wrenleigh,F,17,3177389,11964
11599,Wynnie,F,17,3177406,11087
11600,Xaiver,M,17,3177423,11248
11601,Xenovia,F,17,3177440,11432
11602,Xylia,F,17,3177457,11356
11603,Xylie,F,17,3177474,11183
11604,Yago,M,17,3177491,11995
11605,Yalani,F,17,3177508,11195
11606,Yani,F,17,3177525,11345
11607,Yarelis,F,17,3177542,11233
11608,Yatziry,F,17,3177559,11764
11609,Yiannis,M,17,3177576,11600
11610,Yovanni,M,17,3177593,11574
11611,Yussuf,M,17,3177610,11466
11612,Zaahir,M,17,3177627,11965
11613,Zabrina,F,17,3177644,11361
11614,Zahlia,F,17,3177661,11590
11615,Zale,M,17,3177678,11220
11616,Zamyra,F,17,3177695,11076
11617,Zania,F,17,3177712,11673
11618,Zanna,F,17,3177729,11322
11619,Zanyiah,F,17,3177746,11618
11620,Zaveah,F,17,3177763,11796
11621,Zaylyn,F,17,3177780,11199
11622,Zayvien,M,17,3177797,11302
11623,Zebediah,M,17,3177814,11599
11624,Zekiah,M,17,3177831,11723
11625,Zelia,F,17,3177848,11606
11626,Zoraya,F,17,3177865,11537
11627,Zula,F,17,3177882,11522
11628,Zylee,F,17,3177899,11809
11629,Aadil,M,16,3177915,11909
11630,Adael,M,16,3177931,11905
11631,Addi,F,16,3177947,11108
11632,Addilynne,F,16,3177963,11868
11633,Addisynn,F,16,3177979,11693
11634,Adir,M,16,3177995,11004
11635,Adithi,F,16,3178011,11448
11636,Adriella,F,16,3178027,11382
11637,Adyline,F,16,3178043,11516
11638,Aelyn,F,16,3178059,11626
11639,Ahava,F,16,3178075,11848
11640,Ahlaya,F,16,3178091,11820
11641,Ainslie,F,16,3178107,11750
11642,Aizlyn,F,16,3178123,11802
11643,Akiyah,F,16,3178139,11731
11644,Alaisha,F,16,3178155,11244
11645,Alexys,F,16,3178171,11139
11646,Aliciana,F,16,3178187,11979
11647,Alissandra,F,16,3178203,11827
11648,Alyiah,F,16,3178219,11112
11649,Amarissa,F,16,3178235,11861
11650,Amaro,M,16,3178251,11055
11651,Ambrielle,F,16,3178267,11352
11652,Amell,M,16,3178283,11885
11653,Amilyah,F,16,3178299,11379
11654,Amogh,M,16,3178315,11703
11655,Amran,F,16,3178331,11774
11656,Analeia,F,16,3178347,11182
11657,Analyn,F,16,3178363,11219
11658,Anam,F,16,3178379,11490
11659,Andra,F,16,3178395,11012
11660,Andrez,M,16,3178411,11840
11661,Andriana,F,16,3178427,11847
11662,Andrik,M,16,3178443,11507
11663,Anfernee,M,16,3178459,11307
11664,Angelis,F,16,3178475,11776
11665,Angelly,F,16,3178491,11547
11666,Anjolaoluwa,F,16,3178507,11711
11667,Anneli,F,16,3178523,11173
11668,Annia,F,16,3178539,11429
11669,Anorah,F,16,3178555,11056
11670,Anthem,M,16,3178571,11160
11671,Anuj,M,16,3178587,11373
11672,Anusha,F,16,3178603,11171
11673,Anvitha,F,16,3178619,11327
11674,Apple,F,16,3178635,11433
11675,Arath,M,16,3178651,11580
11676,Ariabella,F,16,3178667,11631
11677,Arkan,M,16,3178683,11080
11678,Arlow,M,16,3178699,11215
11679,Arsenio,M,16,3178715,11273
11680,Artis,M,16,3178731,11617
11681,Artyom,M,16,3178747,11353
11682,Arvid,M,16,3178763,11798
11683,Aryel,F,16,3178779,11569
11684,Arynn,F,16,3178795,11648
11685,Ashlie,F,16,3178811,11860
11686,Asmara,F,16,3178827,11172
11687,Ata,M,16,3178843,11841
11688,Aubrii,F,16,3178859,11721
11689,Audria,F,16,3178875,11019
11690,Auggie,M,16,3178891,11131
11691,Auguste,M,16,3178907,11305
11692,Avalynne,F,16,3178923,11469
11693,Ave,F,16,3178939,11610
11694,Avianah,F,16,3178955,11267
11695,Aviella,F,16,3178971,11866
11696,Avital,F,16,3178987,11851
11697,Aviyana,F,16,3179003,11451
11698,Avonte,M,16,3179019,11105
11699,Avory,F,16,3179035,11464
11700,Avy,F,16,3179051,11416
11701,Avyukt,M,16,3179067,11125
11702,Awab,M,16,3179083,11911
11703,Aydrian,M,16,3179099,11212
11704,Ayumi,F,16,3179115,11313
11705,Azani,F,16,3179131,11926
11706,Azion,M,16,3179147,11397
11707,Azzam,M,16,3179163,11759
11708,Baer,M,16,3179179,11281
11709,Bailei,F,16,3179195,11161
11710,Balian,M,16,3179211,11492
11711,Bereket,M,16,3179227,11528
11712,Beretta,F,16,3179243,11988
11713,Berlynn,F,16,3179259,11206
11714,Bethlehem,F,16,3179275,11025
11715,Beyla,F,16,3179291,11983
11716,Boomer,M,16,3179307,11146
11717,Braidyn,M,16,3179323,11360
11718,Brandin,M,16,3179339,11793
11719,Bravery,M,16,3179355,11499
11720,Breann,F,16,3179371,11225
11721,Breckon,M,16,3179387,11990
11722,Breland,M,16,3179403,11468
11723,Bri,F,16,3179419,11060
11724,Briel,F,16,3179435,11383
11725,Brilyn,F,16,3179451,11674
11726,Brithany,F,16,3179467,11251
11727,Brodrick,M,16,3179483,11333
11728,Brylon,M,16,3179499,11821
11729,Bryna,F,16,3179515,11775
11730,Brynnly,F,16,3179531,11735
11731,Cable,M,16,3179547,11037
11732,Cady,F,16,3179563,11214
11733,Caedyn,M,16,3179579,11036
11734,Calayah,F,16,3179595,11133
11735,Calem,M,16,3179611,11288
11736,Caliber,M,16,3179627,11976
11737,Calise,F,16,3179643,11871
11738,Callee,F,16,3179659,11781
11739,Camara,F,16,3179675,11320
11740,Cameren,M,16,3179691,11822
11741,Camrin,M,16,3179707,11612
11742,Caoimhe,F,16,3179723,11653
11743,Cassi,F,16,3179739,11707
11744,Caylen,F,16,3179755,11520
11745,Cece,F,16,3179771,11880
11746,Cerys,F,16,3179787,11040
11747,Chaney,F,16,3179803,11806
11748,Chesky,M,16,3179819,11572
11749,Chiron,M,16,3179835,11020
11750,Christen,F,16,3179851,11787
11751,Christon,M,16,3179867,11484
11752,Chukwuemeka,M,16,3179883,11165
11753,Claribel,F,16,3179899,11730
11754,Clarkson,M,16,3179915,11294
11755,Cobie,F,16,3179931,11119
11756,Colsyn,M,16,3179947,11763
11757,Coltan,M,16,3179963,11495
11758,Corabelle,F,16,3179979,11554
11759,Cordero,M,16,3179995,11197
11760,Covey,M,16,3180011,11103
11761,Cristiana,F,16,3180027,11752
11762,Cruzito,M,16,3180043,11545
11763,Cuyler,M,16,3180059,11359
11764,Dagoberto,M,16,3180075,11893
11765,Dailany,F,16,3180091,11986
11766,Daisie,F,16,3180107,11636
11767,Dakai,M,16,3180123,11896
11768,Dalaney,F,16,3180139,11870
11769,Dalayah,F,16,3180155,11017
11770,Dalayla,F,16,3180171,11297
11771,Dally,F,16,3180187,11529
11772,Dameir,M,16,3180203,11266
11773,Damiano,M,16,3180219,11223
11774,Dannah,F,16,3180235,11645
11775,Dannie,M,16,3180251,11607
11776,Danyal,M,16,3180267,11555
11777,Daoud,M,16,3180283,11271
11778,Darron,M,16,3180299,11437
11779,Davit,M,16,3180315,11272
11780,Decklin,M,16,3180331,11310
11781,Delayza,F,16,3180347,11491
11782,Derin,F,16,3180363,11329
11783,Devaansh,M,16,3180379,11799
11784,Devika,F,16,3180395,11434
11785,Deziree,F,16,3180411,11980
11786,Dhara,F,16,3180427,11771
11787,Dhruvan,M,16,3180443,11751
11788,Diago,M,16,3180459,11480
11789,Dillinger,M,16,3180475,11622
11790,Dionna,F,16,3180491,11386
11791,Divisha,F,16,3180507,11687
11792,Divit,M,16,3180523,11767
11793,Dom,M,16,3180539,11088
11794,Donatella,F,16,3180555,11292
11795,Dontavius,M,16,3180571,11041
11796,Drexel,M,16,3180587,11959
11797,Dustyn,M,16,3180603,11678
11798,Edelyn,F,16,3180619,11481
11799,Eero,M,16,3180635,11625
11800,Einar,M,16,3180651,11996
11801,Elea,F,16,3180667,11709
11802,Ellani,F,16,3180683,11211
11803,Ellina,F,16,3180699,11104
11804,Ellyn,F,16,3180715,11843
11805,Elona,F,16,3180731,11177
11806,Elwin,M,16,3180747,11863
11807,Emmary,F,16,3180763,11812
11808,Emmilyn,F,16,3180779,11169
11809,Epiphany,F,16,3180795,11335
11810,Faheem,M,16,3180811,11657
11811,Fendi,F,16,3180827,11149
11812,Fenrir,M,16,3180843,11048
11813,Flavia,F,16,3180859,11140
11814,Fransisco,M,16,3180875,11584
11815,Frederik,M,16,3180891,11790
11816,Fredrik,M,16,3180907,11209
11817,Gardner,M,16,3180923,11518
11818,Garth,M,16,3180939,11357
11819,Gemini,F,16,3180955,11170
11820,Gerry,M,16,3180971,11955
11821,Getsemani,F,16,3180987,11994
11822,Ghassan,M,16,3181003,11278
11823,Graclynn,F,16,3181019,11999
11824,Gram,M,16,3181035,11540
11825,Graycie,F,16,3181051,11783
11826,Grettell,F,16,3181067,11676
11827,Greysyn,M,16,3181083,11670
11828,Haiven,F,16,3181099,11903
11829,Hardin,M,16,3181115,11415
11830,Harlon,M,16,3181131,11704
11831,Haroun,M,16,3181147,11715
11832,Hartleigh,F,16,3181163,11459
11833,Harvest,F,16,3181179,11768
11834,Hazem,M,16,3181195,11925
11835,Hazleigh,F,16,3181211,11797
11836,Hemen,F,16,3181227,11222
11837,Heydi,F,16,3181243,11754
11838,Humaira,F,16,3181259,11616
11839,Ibtisam,F,16,3181275,11714
11840,Ifeoluwa,F,16,3181291,11854
11841,Ikenna,M,16,3181307,11556
11842,Ilene,F,16,3181323,11581
11843,Imrie,F,16,3181339,11630
11844,Indra,F,16,3181355,11961
11845,Insiya,F,16,3181371,11078
11846,Isidora,F,16,3181387,11805
11847,Iveth,F,16,3181403,11819
11848,Izza,F,16,3181419,11332
11849,Jaanvi,F,16,3181435,11276
11850,Jaeleigh,F,16,3181451,11748
11851,Jahnavi,F,16,3181467,11150
11852,Jahniya,F,16,3181483,11993
11853,Jaidon,M,16,3181499,11236
11854,Jakarri,M,16,3181515,11128
11855,Jakiya,F,16,3181531,11213
11856,Jakye,M,16,3181547,11582
11857,Jamell,M,16,3181563,11734
11858,Jamesen,M,16,3181579,11878
11859,Jamira,F,16,3181595,11879
11860,Jamirah,F,16,3181611,11850
11861,Jamoni,F,16,3181627,11672
11862,Jaquae,M,16,3181643,11947
11863,Jarett,M,16,3181659,11789
11864,Jasibe,F,16,3181675,11406
11865,Jasiyah,F,16,3181691,11786
11866,Jasnoor,F,16,3181707,11046
11867,Jayah,F,16,3181723,11782
11868,Jayan,M,16,3181739,11553
11869,Jaydenn,M,16,3181755,11552
11870,Jaymin,M,16,3181771,11667
11871,Jazel,F,16,3181787,11399
11872,Jazper,M,16,3181803,11586
11873,Jc,M,16,3181819,11906
11874,Jeana,F,16,3181835,11931
11875,Jeevan,M,16,3181851,11533
11876,Jep,M,16,3181867,11679
11877,Jerron,M,16,3181883,11287
11878,Johari,F,16,3181899,11200
11879,Jolyn,F,16,3181915,11720
11880,Josalynn,F,16,3181931,11923
11881,Joseantonio,M,16,3181947,11207
11882,Joshlyn,F,16,3181963,11324
11883,Josselin,F,16,3181979,11792
11884,Jovanna,F,16,3181995,11130
11885,Julion,M,16,3182011,11712
11886,Justen,M,16,3182027,11479
11887,Kahlea,F,16,3182043,11385
11888,Kaida,F,16,3182059,11044
11889,Kairah,F,16,3182075,11539
11890,Kaleya,F,16,3182091,11835
11891,Kalyani,F,16,3182107,11191
11892,Kamau,M,16,3182123,11578
11893,Kameren,M,16,3182139,11145
11894,Kamillah,F,16,3182155,11560
11895,Kamorah,F,16,3182171,11765
11896,Kanna,F,16,3182187,11718
11897,Kanyla,F,16,3182203,11954
11898,Karan,M,16,3182219,11295
11899,Karder,M,16,3182235,11690
11900,Karlin,M,16,3182251,11661
11901,Karthikeya,M,16,3182267,11978
11902,Kashawn,M,16,3182283,11354
11903,Kasie,F,16,3182299,11686
11904,Kasim,M,16,3182315,11298
11905,Katalena,F,16,3182331,11216
11906,Katharina,F,16,3182347,11842
11907,Katiana,F,16,3182363,11613
11908,Kavik,M,16,3182379,11344
11909,Kawsar,F,16,3182395,11042
11910,Kaylana,F,16,3182411,11680
11911,Kayler,M,16,3182427,11143
11912,Kedrick,M,16,3182443,11904
11913,Keilly,F,16,3182459,11577
11914,Keiston,M,16,3182475,11701
11915,Kelso,M,16,3182491,11874
11916,Kenner,M,16,3182507,11306
11917,Kerim,M,16,3182523,11872
11918,Keshon,M,16,3182539,11650
11919,Keylie,F,16,3182555,11069
11920,Khalel,M,16,3182571,11096
11921,Khalilah,F,16,3182587,11447
11922,Kinston,M,16,3182603,11293
11923,Kitai,M,16,3182619,11208
11924,Kitt,M,16,3182635,11370
11925,Klaira,F,16,3182651,11699
11926,Kohlson,M,16,3182667,11392
11927,Koran,M,16,3182683,11642
11928,Kosta,M,16,3182699,11174
11929,Krishal,M,16,3182715,11393
11930,Kristie,F,16,3182731,11927
11931,Kyari,F,16,3182747,11263
11932,Kylea,F,16,3182763,11605
11933,Kylinn,F,16,3182779,11189
11934,Kyndell,F,16,3182795,11047
11935,Lailynn,F,16,3182811,11351
11936,Lanah,F,16,3182827,11762
11937,Lavontae,M,16,3182843,11515
11938,Laycee,F,16,3182859,11388
11939,Layten,M,16,3182875,11937
11940,Legacii,F,16,3182891,11250
11941,Leilanii,F,16,3182907,11403
11942,Leonela,F,16,3182923,11691
11943,Libbie,F,16,3182939,11018
11944,Lleyton,M,16,3182955,11684
11945,Logyn,F,16,3182971,11681
11946,Lolita,F,16,3182987,11982
11947,Lona,F,16,3183003,11487
11948,Lucielle,F,16,3183019,11876
11949,Luma,F,16,3183035,11401
11950,Lyndie,F,16,3183051,11549
11951,Maahir,M,16,3183067,11558
11952,Maalik,M,16,3183083,11837
11953,Macayla,F,16,3183099,11180
11954,Mackayla,F,16,3183115,11350
11955,Mahamed,M,16,3183131,11439
11956,Mahealani,F,16,3183147,11381
11957,Maisen,M,16,3183163,11058
11958,Malachy,M,16,3183179,11022
11959,Maleiah,F,16,3183195,11803
11960,Malichi,M,16,3183211,11791
11961,Maricruz,F,16,3183227,11521
11962,Markese,M,16,3183243,11079
11963,Marsel,M,16,3183259,11090
11964,Marshon,M,16,3183275,11571
11965,Martavious,M,16,3183291,11081
11966,Marvelous,M,16,3183307,11770
11967,Marz,M,16,3183323,11989
11968,Masina,F,16,3183339,11027
11969,Maylah,F,16,3183355,11074
11970,Mayli,F,16,3183371,11283
11971,Mayumi,F,16,3183387,11963
11972,Meer,M,16,3183403,11838
11973,Meleah,F,16,3183419,11355
11974,Melek,F,16,3183435,11696
11975,Meliana,F,16,3183451,11524
11976,Melyssa,F,16,3183467,11953
11977,Merit,F,16,3183483,11156
11978,Meya,F,16,3183499,11888
11979,Micayla,F,16,3183515,11129
11980,Mikelle,F,16,3183531,11907
11981,Mirza,M,16,3183547,11483
11982,Mizael,M,16,3183563,11304
11983,Molli,F,16,3183579,11097
11984,Mung,M,16,3183595,11184
11985,Naasir,M,16,3183611,11800
11986,Nadeem,M,16,3183627,11688
11987,Naryiah,F,16,3183643,11107
11988,Nasra,F,16,3183659,11727
11989,Natalina,F,16,3183675,11697
11990,Natilee,F,16,3183691,11362
11991,Navayah,F,16,3183707,11398
11992,Navid,M,16,3183723,11136
11993,Nayara,F,16,3183739,11916
11994,Nazanin,F,16,3183755,11628
11995,Neave,F,16,3183771,11644
11996,Nelani,F,16,3183787,11312
11997,Neysa,F,16,3183803,11348
11998,Niani,F,16,3183819,11747
11999,Nickolai,M,16,3183835,11956
12000,Nihaal,M,16,3183851,12565
12001,Nikos,M,16,3183867,12076
12002,Nira,F,16,3183883,12142
12003,Nita,F,16,3183899,12546
12004,Noya,F,16,3183915,12497
12005,Nusaiba,F,16,3183931,12934
12006,Nyellie,F,16,3183947,12921
12007,Nyleah,F,16,3183963,12201
12008,Nyomie,F,16,3183979,12774
12009,Olanna,F,16,3183995,12665
12010,Olenna,F,16,3184011,12656
12011,Orien,M,16,3184027,12732
12012,Orville,M,16,3184043,12679
12013,Phelix,M,16,3184059,12932
12014,Pietra,F,16,3184075,12676
12015,Pihu,F,16,3184091,12603
12016,Pressley,F,16,3184107,12088
12017,Pricilla,F,16,3184123,12959
12018,Priyansh,M,16,3184139,12144
12019,Psalm,M,16,3184155,12907
12020,Radhika,F,16,3184171,12447
12021,Raeanna,F,16,3184187,12180
12022,Raela,F,16,3184203,12670
12023,Raghad,F,16,3184219,12853
12024,Rai,M,16,3184235,12520
12025,Rainee,F,16,3184251,12797
12026,Rama,F,16,3184267,12040
12027,Rameen,F,16,3184283,12649
12028,Rand,M,16,3184299,12364
12029,Ranya,F,16,3184315,12192
12030,Raylie,F,16,3184331,12345
12031,Raziya,F,16,3184347,12037
12032,Reine,F,16,3184363,12361
12033,Reis,M,16,3184379,12825
12034,Rhet,M,16,3184395,12066
12035,Rhone,M,16,3184411,12659
12036,Riddhi,F,16,3184427,12765
12037,Rinley,F,16,3184443,12974
12038,Ritaj,F,16,3184459,12742
12039,Rollins,M,16,3184475,12083
12040,Romen,M,16,3184491,12412
12041,Ronit,M,16,3184507,12778
12042,Roselia,F,16,3184523,12169
12043,Roselle,F,16,3184539,12775
12044,Rut,F,16,3184555,12426
12045,Ryiah,F,16,3184571,12668
12046,Ryson,M,16,3184587,12493
12047,Sabino,M,16,3184603,12616
12048,Sadi,F,16,3184619,12615
12049,Saloma,F,16,3184635,12671
12050,Samaiya,F,16,3184651,12630
12051,Samone,F,16,3184667,12513
12052,Samyuktha,F,16,3184683,12357
12053,Sanaii,F,16,3184699,12735
12054,Sanari,F,16,3184715,12982
12055,Sarabi,F,16,3184731,12904
12056,Saraiya,F,16,3184747,12730
12057,Saraphina,F,16,3184763,12108
12058,Saron,F,16,3184779,12348
12059,Saw,M,16,3184795,12395
12060,Scotti,F,16,3184811,12314
12061,Shadrach,M,16,3184827,12190
12062,Shanna,F,16,3184843,12329
12063,Shari,F,16,3184859,12618
12064,Shawnee,F,16,3184875,12300
12065,Shaylah,F,16,3184891,12652
12066,Shem,M,16,3184907,12139
12067,Shilo,M,16,3184923,12635
12068,Shivanya,F,16,3184939,12253
12069,Shuaib,M,16,3184955,12214
12070,Shyne,M,16,3184971,12378
12071,Skilar,F,16,3184987,12722
12072,Sophiya,F,16,3185003,12692
12073,Soriya,F,16,3185019,12389
12074,Spring,F,16,3185035,12769
12075,Stellarose,F,16,3185051,12127
12076,Suraj,M,16,3185067,12990
12077,Syire,M,16,3185083,12756
12078,Syrenity,F,16,3185099,12503
12079,Taiga,M,16,3185115,12776
12080,Taimur,M,16,3185131,12270
12081,Tait,M,16,3185147,12627
12082,Takai,M,16,3185163,12553
12083,Talaysia,F,16,3185179,12265
12084,Taleigha,F,16,3185195,12711
12085,Taliesin,M,16,3185211,12589
12086,Tanay,M,16,3185227,12903
12087,Tanish,M,16,3185243,12084
12088,Taos,M,16,3185259,12133
12089,Tawhid,M,16,3185275,12609
12090,Taylar,F,16,3185291,12367
12091,Tayshaun,M,16,3185307,12483
12092,Tayton,M,16,3185323,12000
12093,Tayveon,M,16,3185339,12163
12094,Tehani,F,16,3185355,12307
12095,Theodoros,M,16,3185371,12054
12096,Timofey,M,16,3185387,12286
12097,Toba,F,16,3185403,12351
12098,Trevyn,M,16,3185419,12971
12099,Trysten,M,16,3185435,12894
12100,Tyaire,M,16,3185451,12252
12101,Tyden,M,16,3185467,12585
12102,Tyrik,M,16,3185483,12927
12103,Urvi,F,16,3185499,12069
12104,Varsha,F,16,3185515,12833
12105,Vedha,F,16,3185531,12892
12106,Venezia,F,16,3185547,12810
12107,Vian,M,16,3185563,12610
12108,Vrinda,F,16,3185579,12064
12109,Wright,M,16,3185595,12789
12110,Xadrian,M,16,3185611,12575
12111,Xayla,F,16,3185627,12658
12112,Xela,F,16,3185643,12184
12113,Xoe,F,16,3185659,12409
12114,Yahmir,M,16,3185675,12328
12115,Yakira,F,16,3185691,12237
12116,Yamin,M,16,3185707,12194
12117,Yarel,M,16,3185723,12354
12118,Yaroslav,M,16,3185739,12922
12119,Yitzhak,M,16,3185755,12539
12120,Yiyi,F,16,3185771,12661
12121,Yoana,F,16,3185787,12902
12122,Yuridia,F,16,3185803,12333
12123,Yusha,M,16,3185819,12094
12124,Zala,F,16,3185835,12025
12125,Zaleigh,F,16,3185851,12074
12126,Zalen,M,16,3185867,12895
12127,Zamia,F,16,3185883,12524
12128,Zarai,F,16,3185899,12452
12129,Zaraya,F,16,3185915,12470
12130,Zarion,M,16,3185931,12453
12131,Zayanna,F,16,3185947,12969
12132,Zenon,M,16,3185963,12411
12133,Zimal,F,16,3185979,12080
12134,Zona,F,16,3185995,12012
12135,Zyiah,F,16,3186011,12020
12136,Zyier,M,16,3186027,12058
12137,Zyonna,F,16,3186043,12691
12138,Aadarsh,M,15,3186058,12369
12139,Aadit,M,15,3186073,12200
12140,Aaro,M,15,3186088,12909
12141,Aasha,F,15,3186103,12101
12142,Abdulhadi,M,15,3186118,12572
12143,Abdulwahab,M,15,3186133,12298
12144,Aberdeen,F,15,3186148,12231
12145,Abi,F,15,3186163,12251
12146,Abijah,M,15,3186178,12505
12147,Aceton,M,15,3186193,12477
12148,Adalida,F,15,3186208,12753
12149,Adalyna,F,15,3186223,12800
12150,Adea,F,15,3186238,12390
12151,Adelena,F,15,3186253,12992
12152,Adith,M,15,3186268,12719
12153,Admire,F,15,3186283,12877
12154,Adonys,M,15,3186298,12712
12155,Ahan,M,15,3186313,12376
12156,Ahkeem,M,15,3186328,12496
12157,Ahlayah,F,15,3186343,12444
12158,Ahmet,M,15,3186358,12716
12159,Airi,F,15,3186373,12721
12160,Aithan,M,15,3186388,12057
12161,Aizlynn,F,15,3186403,12296
12162,Akirah,F,15,3186418,12375
12163,Alaiza,F,15,3186433,12085
12164,Alanny,F,15,3186448,12975
12165,Alayshia,F,15,3186463,12530
12166,Albany,F,15,3186478,12319
12167,Aldrin,M,15,3186493,12677
12168,Aleaha,F,15,3186508,12443
12169,Aleera,F,15,3186523,12498
12170,Aleksei,M,15,3186538,12220
12171,Alesana,F,15,3186553,12343
12172,Alexsandra,F,15,3186568,12118
12173,Alianah,F,15,3186583,12209
12174,Alivya,F,15,3186598,12591
12175,Allee,F,15,3186613,12131
12176,Alley,F,15,3186628,12748
12177,Allis,F,15,3186643,12005
12178,Allisyn,F,15,3186658,12154
12179,Almas,F,15,3186673,12223
12180,Alylah,F,15,3186688,12935
12181,Alyzah,F,15,3186703,12793
12182,Amayiah,F,15,3186718,12795
12183,Amely,F,15,3186733,12879
12184,Amit,M,15,3186748,12980
12185,Amonte,M,15,3186763,12256
12186,Anabell,F,15,3186778,12944
12187,Anaeli,F,15,3186793,12325
12188,Anahit,F,15,3186808,12100
12189,Anamarie,F,15,3186823,12516
12190,Anastasios,M,15,3186838,12851
12191,Anayla,F,15,3186853,12937
12192,Andreu,M,15,3186868,12157
12193,Aneesh,M,15,3186883,12806
12194,Anella,F,15,3186898,12177
12195,Angelee,F,15,3186913,12086
12196,Anh,F,15,3186928,12249
12197,Anias,M,15,3186943,12052
12198,Annaleigha,F,15,3186958,12244
12199,Annastyn,F,15,3186973,12107
12200,Anneke,F,15,3186988,12842
12201,Anni,F,15,3187003,12519
12202,Anthea,F,15,3187018,12023
12203,Antuan,M,15,3187033,12035
12204,Anum,F,15,3187048,12039
12205,Araina,F,15,3187063,12407
12206,Araiya,F,15,3187078,12152
12207,Araiyah,F,15,3187093,12962
12208,Arash,M,15,3187108,12282
12209,Arelis,F,15,3187123,12302
12210,Arha,F,15,3187138,12844
12211,Arla,F,15,3187153,12308
12212,Arria,F,15,3187168,12248
12213,Arshi,F,15,3187183,12687
12214,Aryaan,M,15,3187198,12004
12215,Asaya,M,15,3187213,12884
12216,Ashari,F,15,3187228,12347
12217,Ashland,F,15,3187243,12681
12218,Ashlin,F,15,3187258,12918
12219,Asier,M,15,3187273,12285
12220,Aslyn,F,15,3187288,12506
12221,Aspynn,F,15,3187303,12655
12222,Aubriel,F,15,3187318,12283
12223,Auna,F,15,3187333,12638
12224,Aurianna,F,15,3187348,12840
12225,Avaiyah,F,15,3187363,12759
12226,Avante,M,15,3187378,12233
12227,Avaree,F,15,3187393,12958
12228,Avianne,F,15,3187408,12099
12229,Avisha,F,15,3187423,12768
12230,Aviyanna,F,15,3187438,12856
12231,Ayaat,F,15,3187453,12526
12232,Ayaz,M,15,3187468,12841
12233,Ayelen,F,15,3187483,12254
12234,Ayushman,M,15,3187498,12178
12235,Azizah,F,15,3187513,12158
12236,Basel,M,15,3187528,12669
12237,Bash,M,15,3187543,12597
12238,Bay,F,15,3187558,12183
12239,Betzalel,M,15,3187573,12938
12240,Billion,M,15,3187588,12067
12241,Blayden,M,15,3187603,12929
12242,Blen,F,15,3187618,12151
12243,Blessed,M,15,3187633,12654
12244,Bradly,M,15,3187648,12247
12245,Braison,M,15,3187663,12206
12246,Brandie,F,15,3187678,12811
12247,Braylei,F,15,3187693,12352
12248,Breah,F,15,3187708,12706
12249,Brealynn,F,15,3187723,12628
12250,Breasia,F,15,3187738,12490
12251,Brennex,M,15,3187753,12189
12252,Breslyn,F,15,3187768,12731
12253,Brextyn,M,15,3187783,12967
12254,Briah,F,15,3187798,12943
12255,Brixxon,F,15,3187813,12050
12256,Brodey,M,15,3187828,12890
12257,Bryley,F,15,3187843,12819
12258,Cadyn,M,15,3187858,12391
12259,Caedmon,M,15,3187873,12431
12260,Calian,M,15,3187888,12170
12261,Caliya,F,15,3187903,12650
12262,Calogero,M,15,3187918,12950
12263,Camillia,F,15,3187933,12979
12264,Camrie,F,15,3187948,12786
12265,Carston,M,15,3187963,12741
12266,Casanova,M,15,3187978,12933
12267,Cashus,M,15,3187993,12544
12268,Cassadee,F,15,3188008,12680
12269,Catelyn,F,15,3188023,12388
12270,Caylie,F,15,3188038,12435
12271,Caz,M,15,3188053,12462
12272,Ceasar,M,15,3188068,12548
12273,Chanse,M,15,3188083,12860
12274,Charliee,F,15,3188098,12229
12275,Chaseton,M,15,3188113,12257
12276,Chenoa,F,15,3188128,12381
12277,Chioma,F,15,3188143,12911
12278,Chloey,F,15,3188158,12494
12279,Christabel,F,15,3188173,12382
12280,Cianni,F,15,3188188,12822
12281,Cobe,M,15,3188203,12353
12282,Codey,M,15,3188218,12588
12283,Cohan,M,15,3188233,12429
12284,Colm,M,15,3188248,12847
12285,Colvin,M,15,3188263,12657
12286,Cordae,M,15,3188278,12598
12287,Crimsyn,F,15,3188293,12528
12288,Cris,M,15,3188308,12318
12289,Crockett,M,15,3188323,12910
12290,Crosley,F,15,3188338,12760
12291,Cylie,F,15,3188353,12988
12292,Dade,M,15,3188368,12871
12293,Dailen,M,15,3188383,12672
12294,Dailynn,F,15,3188398,12849
12295,Dajah,F,15,3188413,12499
12296,Dalexa,F,15,3188428,12461
12297,Dallen,M,15,3188443,12951
12298,Damere,M,15,3188458,12122
12299,Damonie,M,15,3188473,12824
12300,Danaya,F,15,3188488,12226
12301,Daniil,M,15,3188503,12549
12302,Dareen,F,15,3188518,12191
12303,Darrick,M,15,3188533,12147
12304,Darshan,M,15,3188548,12733
12305,Dasan,M,15,3188563,12876
12306,Dason,M,15,3188578,12338
12307,Davionna,F,15,3188593,12291
12308,Daxtin,M,15,3188608,12740
12309,Delayla,F,15,3188623,12623
12310,Demya,F,15,3188638,12913
12311,Deontay,M,15,3188653,12404
12312,Derion,M,15,3188668,12165
12313,Deshun,M,15,3188683,12936
12314,Devoiry,F,15,3188698,12874
12315,Dhanya,F,15,3188713,12330
12316,Dim,F,15,3188728,12502
12317,Dima,F,15,3188743,12365
12318,Diondre,M,15,3188758,12611
12319,Dmitriy,M,15,3188773,12481
12320,Domenick,M,15,3188788,12662
12321,Donell,M,15,3188803,12130
12322,Donya,F,15,3188818,12274
12323,Dredyn,M,15,3188833,12289
12324,Drevon,M,15,3188848,12280
12325,Duaa,F,15,3188863,12288
12326,Dunia,F,15,3188878,12336
12327,Dyani,F,15,3188893,12777
12328,Ebba,F,15,3188908,12148
12329,Ederson,M,15,3188923,12523
12330,Edmundo,M,15,3188938,12026
12331,Edwyn,M,15,3188953,12258
12332,Elenna,F,15,3188968,12596
12333,Elham,F,15,3188983,12940
12334,Elier,M,15,3188998,12140
12335,Eliyanna,F,15,3189013,12755
12336,Elvie,F,15,3189028,12612
12337,Emalia,F,15,3189043,12788
12338,Eniola,F,15,3189058,12751
12339,Esraa,F,15,3189073,12898
12340,Eudora,F,15,3189088,12423
12341,Evelette,F,15,3189103,12320
12342,Evian,M,15,3189118,12116
12343,Eyob,M,15,3189133,12112
12344,Faduma,F,15,3189148,12437
12345,Farren,F,15,3189163,12684
12346,Farryn,F,15,3189178,12645
12347,Fatema,F,15,3189193,12271
12348,Fatma,F,15,3189208,12885
12349,Fennec,M,15,3189223,12485
12350,Fielding,M,15,3189238,12303
12351,Gail,F,15,3189253,12952
12352,Gianlucca,M,15,3189268,12293
12353,Giovana,F,15,3189283,12024
12354,Gisell,F,15,3189298,12781
12355,Graclyn,F,15,3189313,12310
12356,Grahm,M,15,3189328,12126
12357,Graysyn,M,15,3189343,12780
12358,Griffith,M,15,3189358,12607
12359,Grizzly,M,15,3189373,12356
12360,Gunther,M,15,3189388,12878
12361,Gwynn,F,15,3189403,12599
12362,Halie,F,15,3189418,12149
12363,Halli,F,15,3189433,12246
12364,Hanaa,F,15,3189448,12056
12365,Hani,F,15,3189463,12089
12366,Harmonei,F,15,3189478,12634
12367,Hasaan,M,15,3189493,12718
12368,Haygen,M,15,3189508,12955
12369,Haytham,M,15,3189523,12203
12370,Henok,M,15,3189538,12533
12371,Heru,M,15,3189553,12397
12372,Hidaya,F,15,3189568,12673
12373,Howie,M,15,3189583,12211
12374,Hutchinson,M,15,3189598,12442
12375,Huy,M,15,3189613,12017
12376,Hyde,M,15,3189628,12006
12377,Ihsan,M,15,3189643,12358
12378,Ilyaas,M,15,3189658,12545
12379,Ilyan,M,15,3189673,12785
12380,Imron,M,15,3189688,12647
12381,Isadore,M,15,3189703,12893
12382,Ishana,F,15,3189718,12276
12383,Izabellah,F,15,3189733,12438
12384,Izmael,M,15,3189748,12912
12385,Izreal,M,15,3189763,12071
12386,Izzie,F,15,3189778,12075
12387,Jackelin,F,15,3189793,12439
12388,Jacolby,M,15,3189808,12268
12389,Jaevion,M,15,3189823,12752
12390,Jahziah,M,15,3189838,12009
12391,Jaileen,F,15,3189853,12125
12392,Jaivyn,M,15,3189868,12491
12393,Jamelia,F,15,3189883,12469
12394,Jami,F,15,3189898,12838
12395,Jarel,M,15,3189913,12048
12396,Jasim,M,15,3189928,12746
12397,Jatziri,F,15,3189943,12683
12398,Jaxel,M,15,3189958,12046
12399,Jayani,F,15,3189973,12713
12400,Jayron,M,15,3189988,12631
12401,Jayston,M,15,3190003,12472
12402,Jazzmine,F,15,3190018,12639
12403,Jeilyn,F,15,3190033,12646
12404,Jeison,M,15,3190048,12564
12405,Jema,F,15,3190063,12831
12406,Jennavieve,F,15,3190078,12145
12407,Jennica,F,15,3190093,12419
12408,Jerzey,F,15,3190108,12174
12409,Jesaiah,M,15,3190123,12880
12410,Jesslynn,F,15,3190138,12232
12411,Jettsen,M,15,3190153,12535
12412,Jeyren,M,15,3190168,12224
12413,Jhamir,M,15,3190183,12150
12414,Jinora,F,15,3190198,12234
12415,Jochebed,F,15,3190213,12537
12416,Joesph,M,15,3190228,12550
12417,Johny,M,15,3190243,12255
12418,Jolina,F,15,3190258,12762
12419,Josmar,M,15,3190273,12227
12420,Jouri,F,15,3190288,12794
12421,Jozlynn,F,15,3190303,12536
12422,Juandiego,M,15,3190318,12275
12423,Kaaliyah,F,15,3190333,12197
12424,Kaavia,F,15,3190348,12737
12425,Kahli,F,15,3190363,12262
12426,Kaikoa,M,15,3190378,12570
12427,Kailoni,F,15,3190393,12821
12428,Kainalu,M,15,3190408,12007
12429,Kallyn,F,15,3190423,12394
12430,Kalman,M,15,3190438,12181
12431,Kandice,F,15,3190453,12421
12432,Kanin,M,15,3190468,12406
12433,Karalynn,F,15,3190483,12384
12434,Karmah,F,15,3190498,12710
12435,Karmela,F,15,3190513,12219
12436,Kartel,M,15,3190528,12297
12437,Katja,F,15,3190543,12030
12438,Kaydyn,M,15,3190558,12277
12439,Kayelynn,F,15,3190573,12161
12440,Kayori,F,15,3190588,12644
12441,Keahi,M,15,3190603,12946
12442,Keani,F,15,3190618,12620
12443,Keeton,M,15,3190633,12500
12444,Keilen,M,15,3190648,12238
12445,Kena,F,15,3190663,12120
12446,Kendi,F,15,3190678,12415
12447,Kennia,F,15,3190693,12779
12448,Kennon,M,15,3190708,12782
12449,Kenzlei,F,15,3190723,12994
12450,Keri,F,15,3190738,12799
12451,Kesean,M,15,3190753,12324
12452,Keyaan,M,15,3190768,12743
12453,Khalyla,F,15,3190783,12557
12454,Khye,M,15,3190798,12349
12455,Khylar,F,15,3190813,12245
12456,Kier,M,15,3190828,12290
12457,Kimia,F,15,3190843,12995
12458,Kincaid,M,15,3190858,12427
12459,Kinnley,F,15,3190873,12704
12460,Kire,M,15,3190888,12166
12461,Kiyana,F,15,3190903,12770
12462,Knoxton,M,15,3190918,12924
12463,Koehn,M,15,3190933,12560
12464,Koji,M,15,3190948,12179
12465,Kolsyn,M,15,3190963,12188
12466,Kopelyn,F,15,3190978,12633
12467,Koraleigh,F,15,3190993,12014
12468,Koralynn,F,15,3191008,12689
12469,Korynn,F,15,3191023,12216
12470,Kratos,M,15,3191038,12705
12471,Kutter,M,15,3191053,12062
12472,Kyeir,M,15,3191068,12281
12473,Ladarrius,M,15,3191083,12235
12474,Lahna,F,15,3191098,12690
12475,Lain,M,15,3191113,12073
12476,Lanora,F,15,3191128,12313
12477,Lashaun,M,15,3191143,12784
12478,Lathen,M,15,3191158,12269
12479,Latoya,F,15,3191173,12339
12480,Lauchlan,M,15,3191188,12715
12481,Law,M,15,3191203,12455
12482,Layni,F,15,3191218,12699
12483,Leanora,F,15,3191233,12584
12484,Legacee,F,15,3191248,12215
12485,Lennan,F,15,3191263,12001
12486,Lennyx,F,15,3191278,12205
12487,Lenyx,M,15,3191293,12559
12488,Leomar,M,15,3191308,12132
12489,Leonid,M,15,3191323,12660
12490,Letizia,F,15,3191338,12465
12491,Leul,M,15,3191353,12724
12492,Lilac,F,15,3191368,12185
12493,Lincy,F,15,3191383,12973
12494,Lofton,M,15,3191398,12899
12495,Londen,F,15,3191413,12463
12496,Loraine,F,15,3191428,12458
12497,Lorenza,F,15,3191443,12968
12498,Lovell,M,15,3191458,12044
12499,Lovie,F,15,3191473,12593
12500,Luken,M,15,3191488,12033
12501,Lukus,M,15,3191503,12467
12502,Lunarose,F,15,3191518,12896
12503,Lydian,F,15,3191533,12138
12504,Lyna,F,15,3191548,12592
12505,Lyrah,F,15,3191563,12727
12506,Mackenzy,F,15,3191578,12783
12507,Mackynzie,F,15,3191593,12708
12508,Madeleyn,F,15,3191608,12757
12509,Madelina,F,15,3191623,12707
12510,Maezie,F,15,3191638,12045
12511,Mahzi,M,15,3191653,12478
12512,Mairin,F,15,3191668,12868
12513,Makar,M,15,3191683,12091
12514,Malayiah,F,15,3191698,12798
12515,Maleny,F,15,3191713,12019
12516,Malory,F,15,3191728,12372
12517,Manases,M,15,3191743,12747
12518,Maraki,F,15,3191758,12826
12519,Marcial,M,15,3191773,12595
12520,Markanthony,M,15,3191788,12028
12521,Marni,F,15,3191803,12915
12522,Marshaun,M,15,3191818,12464
12523,Martrell,M,15,3191833,12960
12524,Marvens,M,15,3191848,12156
12525,Matis,M,15,3191863,12863
12526,Matisse,M,15,3191878,12457
12527,Maxfield,M,15,3191893,12514
12528,Mayan,M,15,3191908,12264
12529,Mayvis,F,15,3191923,12996
12530,Mcclain,M,15,3191938,12510
12531,Mckenleigh,F,15,3191953,12816
12532,Meenakshi,F,15,3191968,12688
12533,Mehtab,M,15,3191983,12306
12534,Melahni,F,15,3191998,12562
12535,Melyna,F,15,3192013,12240
12536,Micco,M,15,3192028,12239
12537,Mickayla,F,15,3192043,12068
12538,Mikell,M,15,3192058,12953
12539,Miki,F,15,3192073,12098
12540,Mileah,F,15,3192088,12963
12541,Mili,F,15,3192103,12305
12542,Mililani,F,15,3192118,12998
12543,Milka,F,15,3192133,12556
12544,Millianna,F,15,3192148,12366
12545,Milynn,F,15,3192163,12047
12546,Mirian,F,15,3192178,12624
12547,Mishael,M,15,3192193,12792
12548,Moishe,M,15,3192208,12379
12549,Momina,F,15,3192223,12374
12550,Montavious,M,15,3192238,12146
12551,Mordche,M,15,3192253,12077
12552,Myana,F,15,3192268,12887
12553,Myonna,F,15,3192283,12386
12554,Naavya,F,15,3192298,12173
12555,Nahlia,F,15,3192313,12436
12556,Naiyah,F,15,3192328,12279
12557,Najwa,F,15,3192343,12135
12558,Nakiyah,F,15,3192358,12632
12559,Naloni,F,15,3192373,12213
12560,Namiyah,F,15,3192388,12111
12561,Napoleon,M,15,3192403,12978
12562,Nardos,F,15,3192418,12272
12563,Nariya,F,15,3192433,12964
12564,Nashley,F,15,3192448,12726
12565,Navee,F,15,3192463,12605
12566,Naythan,M,15,3192478,12410
12567,Naziyah,F,15,3192493,12371
12568,Ndeye,F,15,3192508,12055
12569,Nechemia,M,15,3192523,12613
12570,Ned,M,15,3192538,12698
12571,Neoma,F,15,3192553,12600
12572,Neven,M,15,3192568,12327
12573,Nhi,F,15,3192583,12459
12574,Nicol,F,15,3192598,12804
12575,Nieko,M,15,3192613,12813
12576,Niklas,M,15,3192628,12566
12577,Nikodem,M,15,3192643,12022
12578,Nikolina,F,15,3192658,12401
12579,Nolah,F,15,3192673,12815
12580,Noralynn,F,15,3192688,12834
12581,Nyelli,F,15,3192703,12360
12582,Nysir,M,15,3192718,12738
12583,Oaklynne,F,15,3192733,12787
12584,Obaloluwa,M,15,3192748,12865
12585,Obi,M,15,3192763,12454
12586,Oisin,M,15,3192778,12511
12587,Oluwadamilare,M,15,3192793,12304
12588,Onalee,F,15,3192808,12864
12589,Osama,M,15,3192823,12602
12590,Patrice,F,15,3192838,12763
12591,Paulino,M,15,3192853,12250
12592,Peregrine,M,15,3192868,12858
12593,Perrie,F,15,3192883,12541
12594,Petar,M,15,3192898,12003
12595,Petros,M,15,3192913,12581
12596,Phyllis,F,15,3192928,12186
12597,Poetry,F,15,3192943,12919
12598,Prem,M,15,3192958,12309
12599,Purity,F,15,3192973,12405
12600,Quinnlee,F,15,3192988,12273
12601,Quynn,F,15,3193003,12241
12602,Rajah,M,15,3193018,12702
12603,Rakim,M,15,3193033,12889
12604,Rakiyah,F,15,3193048,12590
12605,Ramel,M,15,3193063,12515
12606,Randell,M,15,3193078,12925
12607,Rashard,M,15,3193093,12829
12608,Rayleen,F,15,3193108,12717
12609,Raynard,M,15,3193123,12396
12610,Raynee,F,15,3193138,12492
12611,Rayquan,M,15,3193153,12260
12612,Reigan,F,15,3193168,12393
12613,Remingtyn,F,15,3193183,12531
12614,Renatha,F,15,3193198,12070
12615,Reo,M,15,3193213,12162
12616,Reynolds,M,15,3193228,12312
12617,Rhya,F,15,3193243,12866
12618,Riann,F,15,3193258,12790
12619,Rida,F,15,3193273,12392
12620,Rip,M,15,3193288,12532
12621,Rital,F,15,3193303,12571
12622,Romani,F,15,3193318,12403
12623,Romulus,M,15,3193333,12418
12624,Roni,F,15,3193348,12331
12625,Ronnell,M,15,3193363,12629
12626,Roseline,F,15,3193378,12479
12627,Rossi,F,15,3193393,12060
12628,Ruba,F,15,3193408,12301
12629,Ruchama,F,15,3193423,12839
12630,Rucker,M,15,3193438,12604
12631,Ruhani,F,15,3193453,12807
12632,Ruhee,F,15,3193468,12802
12633,Rutledge,M,15,3193483,12337
12634,Ruvim,M,15,3193498,12359
12635,Ryott,M,15,3193513,12387
12636,Saanvika,F,15,3193528,12093
12637,Saathvik,M,15,3193543,12568
12638,Sada,F,15,3193558,12836
12639,Sadiq,M,15,3193573,12103
12640,Safiyyah,F,15,3193588,12507
12641,Sajid,M,15,3193603,12867
12642,Salahuddin,M,15,3193618,12984
12643,Samwise,M,15,3193633,12527
12644,Santo,M,15,3193648,12450
12645,Sarafina,F,15,3193663,12031
12646,Sarvesh,M,15,3193678,12766
12647,Saryiah,F,15,3193693,12835
12648,Savage,M,15,3193708,12850
12649,Saydi,F,15,3193723,12761
12650,Scarlettrose,F,15,3193738,12961
12651,Serenitee,F,15,3193753,12482
12652,Seriyah,F,15,3193768,12456
12653,Shahan,M,15,3193783,12745
12654,Shaheed,M,15,3193798,12577
12655,Sham,F,15,3193813,12801
12656,Shamari,F,15,3193828,12653
12657,Shanyla,F,15,3193843,12474
12658,Shanzay,F,15,3193858,12042
12659,Shealynn,F,15,3193873,12637
12660,Silverio,M,15,3193888,12168
12661,Skyelar,F,15,3193903,12928
12662,Solene,F,15,3193918,12428
12663,Solstice,F,15,3193933,12448
12664,Sonali,F,15,3193948,12449
12665,Sreshta,F,15,3193963,12508
12666,Stanlee,M,15,3193978,12534
12667,Starlynn,F,15,3193993,12129
12668,Stepan,M,15,3194008,12043
12669,Suheyla,F,15,3194023,12121
12670,Sui,F,15,3194038,12263
12671,Suki,F,15,3194053,12210
12672,Syere,M,15,3194068,12542
12673,Syra,F,15,3194083,12872
12674,Tabor,M,15,3194098,12034
12675,Taevion,M,15,3194113,12522
12676,Tallen,M,15,3194128,12977
12677,Talula,F,15,3194143,12686
12678,Tamsyn,F,15,3194158,12701
12679,Tasia,F,15,3194173,12862
12680,Taurus,M,15,3194188,12468
12681,Taym,M,15,3194203,12422
12682,Taysen,M,15,3194218,12117
12683,Teghan,F,15,3194233,12636
12684,Tensley,F,15,3194248,12095
12685,Teya,F,15,3194263,12987
12686,Thanvi,F,15,3194278,12558
12687,Thunder,M,15,3194293,12820
12688,Tian,M,15,3194308,12016
12689,Tovah,F,15,3194323,12053
12690,Traeger,M,15,3194338,12854
12691,Trayvion,M,15,3194353,12350
12692,Treshaun,M,15,3194368,12110
12693,Truu,M,15,3194383,12476
12694,Tymeir,M,15,3194398,12923
12695,Tymere,M,15,3194413,12809
12696,Tyre,M,15,3194428,12621
12697,Tzippy,F,15,3194443,12750
12698,Varian,M,15,3194458,12517
12699,Vashti,F,15,3194473,12018
12700,Vasiliki,F,15,3194488,12939
12701,Vergil,M,15,3194503,12554
12702,Viera,F,15,3194518,12373
12703,Viyaan,M,15,3194533,12725
12704,Vonn,M,15,3194548,12827
12705,Vrishank,M,15,3194563,12332
12706,Vung,F,15,3194578,12966
12707,Wayden,M,15,3194593,12261
12708,Wesly,M,15,3194608,12097
12709,Wrenn,F,15,3194623,12059
12710,Wylee,F,15,3194638,12323
12711,Wynona,F,15,3194653,12767
12712,Xavia,F,15,3194668,12695
12713,Xitlalli,F,15,3194683,12487
12714,Xzavian,M,15,3194698,12242
12715,Xzayvian,M,15,3194713,12999
12716,Yahsir,M,15,3194728,12926
12717,Yaiden,M,15,3194743,12424
12718,Yaiza,F,15,3194758,12377
12719,Yassir,M,15,3194773,12002
12720,Yazn,M,15,3194788,12341
12721,Yehia,M,15,3194803,12187
12722,Yena,F,15,3194818,12432
12723,Yesica,F,15,3194833,12355
12724,Yeva,F,15,3194848,12294
12725,Yidel,M,15,3194863,12160
12726,Yona,M,15,3194878,12587
12727,Yoseph,M,15,3194893,12916
12728,Yvaine,F,15,3194908,12434
12729,Zacharia,M,15,3194923,12225
12730,Zadrian,M,15,3194938,12543
12731,Zadyn,M,15,3194953,12484
12732,Zairah,F,15,3194968,12873
12733,Zamier,M,15,3194983,12104
12734,Zamorah,F,15,3194998,12930
12735,Zarayah,F,15,3195013,12155
12736,Zareth,F,15,3195028,12137
12737,Zarianna,F,15,3195043,12417
12738,Zarriah,F,15,3195058,12651
12739,Zayin,M,15,3195073,12617
12740,Zeeshan,M,15,3195088,12344
12741,Zeniah,F,15,3195103,12675
12742,Zeplyn,F,15,3195118,12399
12743,Zera,F,15,3195133,12846
12744,Zeya,F,15,3195148,12486
12745,Zita,F,15,3195163,12580
12746,Zoravar,M,15,3195178,12106
12747,Zuko,M,15,3195193,12754
12748,Zuleika,F,15,3195208,12882
12749,Zurich,M,15,3195223,12171
12750,Zuriyah,F,15,3195238,12284
12751,Zyasia,F,15,3195253,12105
12752,Zymire,M,15,3195268,12175
12753,Aadvika,F,14,3195282,12989
12754,Aamirah,F,14,3195296,12475
12755,Aaradhana,F,14,3195310,12480
12756,Aaric,M,14,3195324,12400
12757,Aarika,F,14,3195338,12217
12758,Aashna,F,14,3195352,12685
12759,Aayam,M,14,3195366,12414
12760,Abbi,F,14,3195380,12538
12761,Abcde,F,14,3195394,12700
12762,Abie,M,14,3195408,12606
12763,Adaleah,F,14,3195422,12736
12764,Adarsh,M,14,3195436,12993
12765,Addaline,F,14,3195450,12141
12766,Adelai,F,14,3195464,12385
12767,Adeleigh,F,14,3195478,12525
12768,Adien,M,14,3195492,12512
12769,Adiya,F,14,3195506,12529
12770,Adlai,M,14,3195520,12551
12771,Adream,F,14,3195534,12092
12772,Adrean,M,14,3195548,12881
12773,Adysen,F,14,3195562,12228
12774,Ahmya,F,14,3195576,12488
12775,Ahnyla,F,14,3195590,12326
12776,Ahveya,F,14,3195604,12123
12777,Aika,F,14,3195618,12207
12778,Aiman,M,14,3195632,12981
12779,Ainoa,F,14,3195646,12078
12780,Aishwarya,F,14,3195660,12504
12781,Akane,F,14,3195674,12573
12782,Akyli,F,14,3195688,12029
12783,Akyra,F,14,3195702,12363
12784,Alaijah,F,14,3195716,12574
12785,Alannie,F,14,3195730,12471
12786,Aleck,M,14,3195744,12582
12787,Aleesia,F,14,3195758,12970
12788,Aleigh,F,14,3195772,12579
12789,Aleki,M,14,3195786,12832
12790,Aleks,M,14,3195800,12218
12791,Alianny,F,14,3195814,12008
12792,Alira,F,14,3195828,12495
12793,Alis,F,14,3195842,12663
12794,Allayna,F,14,3195856,12032
12795,Allora,F,14,3195870,12321
12796,Alonah,F,14,3195884,12772
12797,Amarey,M,14,3195898,12828
12798,Amarrah,F,14,3195912,12082
12799,Ambria,F,14,3195926,12164
12800,Ameli,F,14,3195940,12901
12801,Ameliya,F,14,3195954,12072
12802,Amerah,F,14,3195968,12749
12803,Amily,F,14,3195982,12230
12804,Amirrah,F,14,3195996,12061
12805,Amma,F,14,3196010,12697
12806,Amorette,F,14,3196024,12626
12807,Amorie,F,14,3196038,12614
12808,Anaid,F,14,3196052,12509
12809,Analyse,F,14,3196066,12222
12810,Anant,M,14,3196080,12063
12811,Anastasija,F,14,3196094,12578
12812,Anchor,M,14,3196108,12027
12813,Anden,M,14,3196122,12196
12814,Andreus,M,14,3196136,12693
12815,Anhar,F,14,3196150,12667
12816,Anica,F,14,3196164,12021
12817,Annalaya,F,14,3196178,12808
12818,Annaly,F,14,3196192,12204
12819,Annelie,F,14,3196206,12640
12820,Anouk,F,14,3196220,12198
12821,Antone,M,14,3196234,12583
12822,Apolonia,F,14,3196248,12090
12823,Arieana,F,14,3196262,12114
12824,Arien,M,14,3196276,12734
12825,Ariza,F,14,3196290,12771
12826,Armina,F,14,3196304,12081
12827,Arnika,F,14,3196318,12869
12828,Arrabella,F,14,3196332,12208
12829,Arriah,F,14,3196346,12957
12830,Arriyah,F,14,3196360,12883
12831,Arson,M,14,3196374,12696
12832,Ary,F,14,3196388,12852
12833,Asah,M,14,3196402,12886
12834,Aseem,M,14,3196416,12119
12835,Ashaad,M,14,3196430,12818
12836,Ashira,F,14,3196444,12451
12837,Ashleen,F,14,3196458,12136
12838,Ashvik,M,14,3196472,12744
12839,Askari,M,14,3196486,12949
12840,Athanasios,M,14,3196500,12292
12841,Athea,F,14,3196514,12682
12842,Athira,F,14,3196528,12576
12843,Athziri,F,14,3196542,12664
12844,Avaiah,F,14,3196556,12986
12845,Avea,F,14,3196570,12728
12846,Avriana,F,14,3196584,12346
12847,Aydenn,M,14,3196598,12619
12848,Ayzel,F,14,3196612,12079
12849,Azaelia,F,14,3196626,12335
12850,Azarie,F,14,3196640,12334
12851,Azaylia,F,14,3196654,12723
12852,Babyboy,M,14,3196668,12370
12853,Bailynn,F,14,3196682,12648
12854,Barak,M,14,3196696,12430
12855,Baraka,M,14,3196710,12153
12856,Barkot,M,14,3196724,12569
12857,Basem,M,14,3196738,12709
12858,Bastien,M,14,3196752,12666
12859,Baylei,F,14,3196766,12015
12860,Bayler,M,14,3196780,12976
12861,Beckley,F,14,3196794,12380
12862,Benelli,F,14,3196808,12113
12863,Bertie,F,14,3196822,12985
12864,Bethanie,F,14,3196836,12193
12865,Betzy,F,14,3196850,12521
12866,Beya,F,14,3196864,12036
12867,Binta,F,14,3196878,12547
12868,Bitania,F,14,3196892,12202
12869,Bob,M,14,3196906,12383
12870,Bowyn,M,14,3196920,12049
12871,Braddock,M,14,3196934,12317
12872,Braxxton,M,14,3196948,12440
12873,Brayah,F,14,3196962,12212
12874,Breana,F,14,3196976,12920
12875,Breena,F,14,3196990,12954
12876,Brennley,F,14,3197004,12942
12877,Breslin,F,14,3197018,12402
12878,Briggston,M,14,3197032,12342
12879,Brinn,F,14,3197046,12259
12880,Bryceson,M,14,3197060,12182
12881,Bryker,M,14,3197074,12567
12882,Caelen,M,14,3197088,12195
12883,Calais,M,14,3197102,12622
12884,Caleesi,F,14,3197116,12983
12885,Caley,F,14,3197130,12941
12886,Caleyah,F,14,3197144,12199
12887,Cammie,F,14,3197158,12441
12888,Carlene,F,14,3197172,12888
12889,Carmel,F,14,3197186,12115
12890,Carmelina,F,14,3197200,12956
12891,Carolena,F,14,3197214,12906
12892,Cashtyn,M,14,3197228,12608
12893,Cavani,M,14,3197242,12972
12894,Cephas,M,14,3197256,12416
12895,Charlise,F,14,3197270,12931
12896,Chastin,M,14,3197284,12805
12897,Chazz,M,14,3197298,12814
12898,Chidera,F,14,3197312,12102
12899,Choyce,M,14,3197326,12011
12900,Chrisette,F,14,3197340,12413
12901,Christain,M,14,3197354,12817
12902,Clary,F,14,3197368,12368
12903,Coretta,F,14,3197382,12041
12904,Corin,M,14,3197396,12641
12905,Corinthian,M,14,3197410,12914
12906,Corley,F,14,3197424,12917
12907,Cosimo,M,14,3197438,12109
12908,Cosme,M,14,3197452,12601
12909,Cristy,F,14,3197466,12278
12910,Cyprian,M,14,3197480,12287
12911,Dajon,M,14,3197494,12764
12912,Daleah,F,14,3197508,12897
12913,Daliana,F,14,3197522,12796
12914,Damaria,F,14,3197536,12433
12915,Damaya,F,14,3197550,12473
12916,Danial,M,14,3197564,12243
12917,Danisha,F,14,3197578,12460
12918,Danyelle,F,14,3197592,12643
12919,Darielys,F,14,3197606,12900
12920,Dastan,M,14,3197620,12997
12921,Davia,F,14,3197634,12420
12922,Dayonna,F,14,3197648,12791
12923,Dayveon,M,14,3197662,12739
12924,Dayvion,M,14,3197676,12466
12925,Dekota,F,14,3197690,12703
12926,Deleah,F,14,3197704,12905
12927,Denia,F,14,3197718,12773
12928,Despina,F,14,3197732,12891
12929,Devine,F,14,3197746,12823
12930,Devory,F,14,3197760,12316
12931,Dezi,M,14,3197774,12586
12932,Dimitry,M,14,3197788,12991
12933,Dio,M,14,3197802,12398
12934,Dionicio,M,14,3197816,12812
12935,Diontae,M,14,3197830,12236
12936,Dolan,M,14,3197844,12540
12937,Domenica,F,14,3197858,12758
12938,Donovin,M,14,3197872,12714
12939,Dontez,M,14,3197886,12625
12940,Drax,M,14,3197900,12674
12941,Draycen,M,14,3197914,12408
12942,Duvid,M,14,3197928,12694
12943,Dyana,F,14,3197942,12875
12944,Eber,M,14,3197956,12267
12945,Eda,F,14,3197970,12552
12946,Ediel,M,14,3197984,12848
12947,Edras,M,14,3197998,12176
12948,Edwardo,M,14,3198012,12947
12949,Eilish,F,14,3198026,12051
12950,Eldridge,M,14,3198040,12594
12951,Elgin,M,14,3198054,12362
12952,Ellenore,F,14,3198068,12010
12953,Elloree,F,14,3198082,12159
12954,Elody,F,14,3198096,12038
12955,Elson,M,14,3198110,12563
12956,Elyanah,F,14,3198124,12861
12957,Emaya,F,14,3198138,12295
12958,Emberlie,F,14,3198152,12446
12959,Emett,M,14,3198166,12340
12960,Emiley,F,14,3198180,12315
12961,Emilyrose,F,14,3198194,12501
12962,Emmarae,F,14,3198208,12425
12963,Emrik,M,14,3198222,12221
12964,Erandi,F,14,3198236,12561
12965,Eriella,F,14,3198250,12065
12966,Eron,M,14,3198264,12830
12967,Espyn,F,14,3198278,12720
12968,Esvin,M,14,3198292,12642
12969,Evangelia,F,14,3198306,12843
12970,Evangelos,M,14,3198320,12128
12971,Everet,M,14,3198334,12729
12972,Everton,M,14,3198348,12013
12973,Evonne,F,14,3198362,12857
12974,Evynn,F,14,3198376,12322
12975,Ezequias,M,14,3198390,12855
12976,Fahd,M,14,3198404,12965
12977,Fariha,F,14,3198418,12266
12978,Felton,M,14,3198432,12948
12979,Fenris,M,14,3198446,12143
12980,Fiadh,F,14,3198460,12555
12981,Finch,M,14,3198474,12172
12982,Fintan,M,14,3198488,12134
12983,Fishel,M,14,3198502,12845
12984,Fleur,F,14,3198516,12518
12985,Franciszek,M,14,3198530,12311
12986,Francois,M,14,3198544,12489
12987,Gatlyn,M,14,3198558,12803
12988,Gelila,F,14,3198572,12096
12989,Genesys,F,14,3198586,12945
12990,Ghalia,F,14,3198600,12678
12991,Godfrey,M,14,3198614,12837
12992,Godson,M,14,3198628,12124
12993,Gracia,F,14,3198642,12445
12994,Gracious,F,14,3198656,12087
12995,Graylee,F,14,3198670,12870
12996,Graylen,M,14,3198684,12908
12997,Graysin,M,14,3198698,12859
12998,Griezmann,M,14,3198712,12167
12999,Gwendolen,F,14,3198726,12299
13000,Happiness,F,14,3198740,13370
13001,Hava,F,14,3198754,13201
13002,Hayk,M,14,3198768,13732
13003,Haylo,F,14,3198782,13889
13004,Hayslee,F,14,3198796,13438
13005,Hedy,F,14,3198810,13235
13006,Heer,F,14,3198824,13449
13007,Heinrich,M,14,3198838,13024
13008,Heloisa,F,14,3198852,13328
13009,Hodan,F,14,3198866,13001
13010,Hopper,M,14,3198880,13539
13011,Hridhaan,M,14,3198894,13751
13012,Hughes,M,14,3198908,13473
13013,Hux,M,14,3198922,13598
13014,Ilena,F,14,3198936,13011
13015,Illa,F,14,3198950,13737
13016,Imoni,F,14,3198964,13222
13017,Imraan,M,14,3198978,13642
13018,Isabeau,F,14,3198992,13152
13019,Isayah,M,14,3199006,13930
13020,Issak,M,14,3199020,13824
13021,Itzabella,F,14,3199034,13916
13022,Iyad,M,14,3199048,13975
13023,Izen,M,14,3199062,13073
13024,Iziah,M,14,3199076,13075
13025,Jaaliyah,F,14,3199090,13174
13026,Jadalyn,F,14,3199104,13669
13027,Jadzia,F,14,3199118,13741
13028,Jaeleen,F,14,3199132,13358
13029,Jag,M,14,3199146,13960
13030,Jahkeem,M,14,3199160,13963
13031,Jahlani,F,14,3199174,13634
13032,Jahmeer,M,14,3199188,13855
13033,Jahzir,M,14,3199202,13982
13034,Jairon,M,14,3199216,13768
13035,Jakyra,F,14,3199230,13816
13036,Jala,F,14,3199244,13462
13037,Jalaiya,F,14,3199258,13939
13038,Jamani,M,14,3199272,13722
13039,Jamayah,F,14,3199286,13405
13040,Jamez,M,14,3199300,13078
13041,Jamiracle,F,14,3199314,13909
13042,Jamisyn,F,14,3199328,13938
13043,Janasia,F,14,3199342,13746
13044,Janiylah,F,14,3199356,13264
13045,Janoah,M,14,3199370,13016
13046,January,F,14,3199384,13317
13047,Jaquavious,M,14,3199398,13354
13048,Jarek,M,14,3199412,13771
13049,Jarius,M,14,3199426,13832
13050,Jarron,M,14,3199440,13010
13051,Jasslyn,F,14,3199454,13221
13052,Jathan,M,14,3199468,13461
13053,Javarion,M,14,3199482,13788
13054,Jayleene,F,14,3199496,13644
13055,Jaylinn,F,14,3199510,13254
13056,Jaynee,F,14,3199524,13806
13057,Jayton,M,14,3199538,13137
13058,Jedd,M,14,3199552,13581
13059,Jehiel,M,14,3199566,13862
13060,Jeilani,F,14,3199580,13183
13061,Jeily,F,14,3199594,13032
13062,Jenasis,F,14,3199608,13787
13063,Jentzen,M,14,3199622,13178
13064,Jeovanni,M,14,3199636,13209
13065,Jerel,M,14,3199650,13735
13066,Jerzee,F,14,3199664,13489
13067,Jessamine,F,14,3199678,13457
13068,Jetta,F,14,3199692,13800
13069,Jhace,M,14,3199706,13028
13070,Jhanvi,F,14,3199720,13570
13071,Jhazelle,F,14,3199734,13675
13072,Jocelin,F,14,3199748,13227
13073,Jocie,F,14,3199762,13369
13074,Joleah,F,14,3199776,13440
13075,Jonelle,F,14,3199790,13136
13076,Jonpaul,M,14,3199804,13792
13077,Josafat,M,14,3199818,13719
13078,Joshuah,M,14,3199832,13430
13079,Journeigh,F,14,3199846,13880
13080,Joyanna,F,14,3199860,13448
13081,Joyner,M,14,3199874,13966
13082,Juaquin,M,14,3199888,13538
13083,Julyan,M,14,3199902,13910
13084,Juneau,F,14,3199916,13738
13085,Justo,M,14,3199930,13274
13086,Kabeer,M,14,3199944,13372
13087,Kacelyn,F,14,3199958,13108
13088,Kadie,F,14,3199972,13819
13089,Kaidynce,F,14,3199986,13494
13090,Kailon,M,14,3200000,13104
13091,Kairon,M,14,3200014,13526
13092,Kally,F,14,3200028,13630
13093,Kamaree,M,14,3200042,13843
13094,Kamber,F,14,3200056,13595
13095,Kamyia,F,14,3200070,13506
13096,Karima,F,14,3200084,13324
13097,Kashus,M,14,3200098,13856
13098,Kassi,F,14,3200112,13772
13099,Kavan,M,14,3200126,13076
13100,Kawai,M,14,3200140,13240
13101,Kawika,M,14,3200154,13769
13102,Kaydenn,M,14,3200168,13726
13103,Kayleah,F,14,3200182,13352
13104,Kaylia,F,14,3200196,13255
13105,Kayonna,F,14,3200210,13175
13106,Kaysley,F,14,3200224,13857
13107,Kean,M,14,3200238,13400
13108,Keisi,F,14,3200252,13759
13109,Kelechi,M,14,3200266,13306
13110,Kemal,M,14,3200280,13496
13111,Kemet,M,14,3200294,13132
13112,Kemi,F,14,3200308,13453
13113,Kendyn,M,14,3200322,13281
13114,Keniyah,F,14,3200336,13363
13115,Kenlie,F,14,3200350,13245
13116,Kenly,F,14,3200364,13615
13117,Kenston,M,14,3200378,13148
13118,Kentavious,M,14,3200392,13527
13119,Keonna,F,14,3200406,13542
13120,Kesleigh,F,14,3200420,13549
13121,Khaleed,M,14,3200434,13925
13122,Khalise,F,14,3200448,13228
13123,Khylei,F,14,3200462,13947
13124,Khyleigh,F,14,3200476,13138
13125,Khyron,M,14,3200490,13463
13126,Khyzer,M,14,3200504,13133
13127,Kia,F,14,3200518,13232
13128,Kieron,M,14,3200532,13706
13129,Kiki,F,14,3200546,13575
13130,Kirah,F,14,3200560,13486
13131,Kiyansh,M,14,3200574,13558
13132,Kolette,F,14,3200588,13573
13133,Konor,M,14,3200602,13562
13134,Kordae,M,14,3200616,13260
13135,Koven,M,14,3200630,13817
13136,Krishika,F,14,3200644,13597
13137,Kristell,F,14,3200658,13900
13138,Krysta,F,14,3200672,13860
13139,Kuzey,M,14,3200686,13720
13140,Kyasia,F,14,3200700,13683
13141,Kynnedy,F,14,3200714,13701
13142,Kyrese,M,14,3200728,13134
13143,Kyshawn,M,14,3200742,13195
13144,Laelyn,F,14,3200756,13942
13145,Lanai,F,14,3200770,13596
13146,Launa,F,14,3200784,13973
13147,Lawsen,M,14,3200798,13555
13148,Layann,F,14,3200812,13366
13149,Laysha,F,14,3200826,13868
13150,Lean,M,14,3200840,13471
13151,Lennin,M,14,3200854,13244
13152,Leoni,F,14,3200868,13750
13153,Leonides,M,14,3200882,13455
13154,Leta,F,14,3200896,13733
13155,Libi,F,14,3200910,13096
13156,Lijah,M,14,3200924,13267
13157,Lileigh,F,14,3200938,13066
13158,Lillien,F,14,3200952,13869
13159,Linkon,M,14,3200966,13532
13160,Linlee,F,14,3200980,13180
13161,Linsey,F,14,3200994,13534
13162,Lissa,F,14,3201008,13043
13163,Lizandro,M,14,3201022,13053
13164,Loyalti,F,14,3201036,13742
13165,Lumina,F,14,3201050,13519
13166,Luzmaria,F,14,3201064,13290
13167,Lynnleigh,F,14,3201078,13308
13168,Lynnley,F,14,3201092,13976
13169,Maanya,F,14,3201106,13396
13170,Macallister,M,14,3201120,13413
13171,Mackinley,F,14,3201134,13047
13172,Macklan,M,14,3201148,13808
13173,Maddelynn,F,14,3201162,13522
13174,Maddyx,F,14,3201176,13214
13175,Madlyn,F,14,3201190,13635
13176,Madsen,M,14,3201204,13072
13177,Madylin,F,14,3201218,13398
13178,Maesie,F,14,3201232,13237
13179,Mahreen,F,14,3201246,13591
13180,Maidah,F,14,3201260,13632
13181,Maika,F,14,3201274,13012
13182,Maimuna,F,14,3201288,13835
13183,Mairi,F,14,3201302,13007
13184,Maizley,F,14,3201316,13459
13185,Makana,M,14,3201330,13038
13186,Makell,M,14,3201344,13168
13187,Makyah,F,14,3201358,13605
13188,Malania,F,14,3201372,13058
13189,Malanni,F,14,3201386,13299
13190,Malone,F,14,3201400,13536
13191,Malosi,M,14,3201414,13894
13192,Mame,F,14,3201428,13077
13193,Manahil,F,14,3201442,13955
13194,Manu,M,14,3201456,13490
13195,Manya,F,14,3201470,13445
13196,Maricella,F,14,3201484,13034
13197,Marilena,F,14,3201498,13470
13198,Marino,M,14,3201512,13651
13199,Marleen,F,14,3201526,13265
13200,Martavius,M,14,3201540,13998
13201,Maryana,F,14,3201554,13729
13202,Marybeth,F,14,3201568,13206
13203,Masha,F,14,3201582,13208
13204,Mathius,M,14,3201596,13919
13205,Matin,M,14,3201610,13600
13206,Matylda,F,14,3201624,13739
13207,Mavryck,M,14,3201638,13655
13208,Maximos,M,14,3201652,13256
13209,Mayci,F,14,3201666,13211
13210,Mayrani,F,14,3201680,13693
13211,Mckenzy,F,14,3201694,13173
13212,Meeka,F,14,3201708,13897
13213,Meilech,M,14,3201722,13383
13214,Meriam,F,14,3201736,13248
13215,Meshilem,M,14,3201750,13628
13216,Michela,F,14,3201764,13646
13217,Mikhaila,F,14,3201778,13770
13218,Mikyla,F,14,3201792,13892
13219,Milad,M,14,3201806,13226
13220,Morgana,F,14,3201820,13604
13221,Morgyn,F,14,3201834,13898
13222,Muadh,M,14,3201848,13814
13223,Muneer,M,14,3201862,13377
13224,Murron,F,14,3201876,13362
13225,Myangel,F,14,3201890,13243
13226,Mylez,M,14,3201904,13585
13227,Mynor,M,14,3201918,13723
13228,Naama,F,14,3201932,13712
13229,Nabila,F,14,3201946,13332
13230,Nafisa,F,14,3201960,13090
13231,Naftoli,M,14,3201974,13502
13232,Nakayla,F,14,3201988,13153
13233,Nakshatra,F,14,3202002,13999
13234,Naman,M,14,3202016,13008
13235,Naquan,M,14,3202030,13384
13236,Nasira,F,14,3202044,13033
13237,Nasiyah,F,14,3202058,13731
13238,Nataliah,F,14,3202072,13846
13239,Navira,F,14,3202086,13102
13240,Nazly,F,14,3202100,13620
13241,Neda,F,14,3202114,13809
13242,Neizan,M,14,3202128,13510
13243,Nelliel,F,14,3202142,13278
13244,Nena,F,14,3202156,13052
13245,Neriyah,F,14,3202170,13322
13246,Nicoletta,F,14,3202184,13943
13247,Niels,M,14,3202198,13414
13248,Nikayla,F,14,3202212,13025
13249,Ninah,F,14,3202226,13525
13250,Nivin,M,14,3202240,13760
13251,Noar,M,14,3202254,13231
13252,Noelly,F,14,3202268,13852
13253,Noemy,F,14,3202282,13050
13254,Nolawi,M,14,3202296,13068
13255,Nouri,F,14,3202310,13748
13256,Novi,F,14,3202324,13874
13257,Nyaire,M,14,3202338,13345
13258,Nylee,F,14,3202352,13095
13259,Oluwademilade,M,14,3202366,13931
13260,Omni,F,14,3202380,13853
13261,Orhan,M,14,3202394,13567
13262,Oriyah,F,14,3202408,13487
13263,Oseas,M,14,3202422,13135
13264,Panagiotis,M,14,3202436,13097
13265,Payden,M,14,3202450,13491
13266,Peyson,M,14,3202464,13599
13267,Pharrah,F,14,3202478,13435
13268,Phil,M,14,3202492,13145
13269,Poppi,F,14,3202506,13436
13270,Presli,F,14,3202520,13671
13271,Queena,F,14,3202534,13196
13272,Rabia,F,14,3202548,13776
13273,Raekwon,M,14,3202562,13307
13274,Raeley,F,14,3202576,13451
13275,Raffaella,F,14,3202590,13270
13276,Raffi,M,14,3202604,13485
13277,Rahi,F,14,3202618,13582
13278,Raife,M,14,3202632,13891
13279,Raihan,M,14,3202646,13996
13280,Rajon,M,14,3202660,13258
13281,Ramla,F,14,3202674,13878
13282,Raydel,M,14,3202688,13663
13283,Raydon,M,14,3202702,13298
13284,Raye,F,14,3202716,13293
13285,Reda,M,14,3202730,13838
13286,Redford,M,14,3202744,13083
13287,Refoel,M,14,3202758,13347
13288,Rejoice,F,14,3202772,13432
13289,Remiel,M,14,3202786,13721
13290,Reminisce,F,14,3202800,13637
13291,Renesmay,F,14,3202814,13456
13292,Retaj,F,14,3202828,13450
13293,Reuel,M,14,3202842,13478
13294,Revel,M,14,3202856,13648
13295,Reyah,F,14,3202870,13970
13296,Rheagan,F,14,3202884,13621
13297,Rhyley,F,14,3202898,13761
13298,Riccardo,M,14,3202912,13029
13299,Ridhan,M,14,3202926,13842
13300,Rishab,M,14,3202940,13687
13301,Riverly,F,14,3202954,13346
13302,Rockford,M,14,3202968,13087
13303,Roizy,F,14,3202982,13762
13304,Rommel,M,14,3202996,13950
13305,Rosselyn,F,14,3203010,13114
13306,Rourke,M,14,3203024,13127
13307,Rustyn,M,14,3203038,13725
13308,Ruxin,M,14,3203052,13576
13309,Ryanna,F,14,3203066,13810
13310,Rydge,M,14,3203080,13967
13311,Rylon,M,14,3203094,13225
13312,Sabian,M,14,3203108,13927
13313,Sacha,M,14,3203122,13890
13314,Saesha,F,14,3203136,13476
13315,Sahid,M,14,3203150,13829
13316,Sahra,F,14,3203164,13170
13317,Saleen,F,14,3203178,13110
13318,Samay,M,14,3203192,13194
13319,Samera,F,14,3203206,13923
13320,Samyrah,F,14,3203220,13994
13321,Santina,F,14,3203234,13296
13322,Sarahy,F,14,3203248,13395
13323,Seger,M,14,3203262,13730
13324,Severin,M,14,3203276,13859
13325,Shadow,M,14,3203290,13569
13326,Sharlene,F,14,3203304,13325
13327,Sharod,M,14,3203318,13323
13328,Sherly,F,14,3203332,13548
13329,Shrihan,M,14,3203346,13753
13330,Siar,M,14,3203360,13182
13331,Siddhi,F,14,3203374,13905
13332,Signe,F,14,3203388,13676
13333,Sindy,F,14,3203402,13893
13334,Skylen,F,14,3203416,13717
13335,Slayden,M,14,3203430,13579
13336,Sloka,F,14,3203444,13004
13337,Solan,M,14,3203458,13627
13338,Soleia,F,14,3203472,13410
13339,Soloman,M,14,3203486,13314
13340,Srishti,F,14,3203500,13361
13341,Stefanos,M,14,3203514,13882
13342,Sumayah,F,14,3203528,13516
13343,Sumayya,F,14,3203542,13757
13344,Surah,F,14,3203556,13535
13345,Suttyn,F,14,3203570,13977
13346,Sy,M,14,3203584,13316
13347,Taevon,M,14,3203598,13872
13348,Tahari,F,14,3203612,13310
13349,Tajh,M,14,3203626,13547
13350,Taleyah,F,14,3203640,13234
13351,Talise,F,14,3203654,13014
13352,Tavares,M,14,3203668,13046
13353,Taylani,F,14,3203682,13364
13354,Tayshawn,M,14,3203696,13840
13355,Teddie,F,14,3203710,13603
13356,Tenlee,F,14,3203724,13820
13357,Teodora,F,14,3203738,13204
13358,Teona,F,14,3203752,13390
13359,Thelonious,M,14,3203766,13530
13360,Thorsten,M,14,3203780,13707
13361,Tionna,F,14,3203794,13022
13362,Trentyn,M,14,3203808,13176
13363,Treston,M,14,3203822,13807
13364,Treysen,M,14,3203836,13399
13365,Trice,M,14,3203850,13101
13366,Troi,F,14,3203864,13039
13367,Tuck,M,14,3203878,13886
13368,Tyjuan,M,14,3203892,13705
13369,Uzair,M,14,3203906,13681
13370,Valerian,M,14,3203920,13574
13371,Vallen,M,14,3203934,13638
13372,Vana,F,14,3203948,13280
13373,Vaya,F,14,3203962,13734
13374,Vibha,F,14,3203976,13129
13375,Vivica,F,14,3203990,13291
13376,Vlad,M,14,3204004,13374
13377,Waverley,F,14,3204018,13252
13378,Webster,M,14,3204032,13229
13379,Wiktoria,F,14,3204046,13499
13380,Wilton,M,14,3204060,13217
13381,Wyeth,M,14,3204074,13442
13382,Wyland,M,14,3204088,13784
13383,Xaden,M,14,3204102,13167
13384,Xandria,F,14,3204116,13121
13385,Yalena,F,14,3204130,13294
13386,Yaneliz,F,14,3204144,13881
13387,Yanelli,F,14,3204158,13426
13388,Yaslin,F,14,3204172,13304
13389,Yasna,F,14,3204186,13498
13390,Yazlin,F,14,3204200,13406
13391,Yemariam,F,14,3204214,13365
13392,Yi,M,14,3204228,13120
13393,Yousaf,M,14,3204242,13664
13394,Yusif,M,14,3204256,13084
13395,Yzabella,F,14,3204270,13847
13396,Zadkiel,M,14,3204284,13728
13397,Zaide,M,14,3204298,13421
13398,Zakariye,M,14,3204312,13107
13399,Zakiah,M,14,3204326,13420
13400,Zamarah,F,14,3204340,13958
13401,Zanai,F,14,3204354,13160
13402,Zareen,F,14,3204368,13594
13403,Zariana,F,14,3204382,13668
13404,Zaxai,M,14,3204396,13149
13405,Zaylia,F,14,3204410,13971
13406,Zazie,F,14,3204424,13203
13407,Zeal,M,14,3204438,13689
13408,Zeenat,F,14,3204452,13318
13409,Zeeva,F,14,3204466,13464
13410,Zelma,F,14,3204480,13297
13411,Zeniya,F,14,3204494,13191
13412,Zhyon,M,14,3204508,13118
13413,Ziona,F,14,3204522,13884
13414,Ziyanna,F,14,3204536,13944
13415,Zubayr,M,14,3204550,13342
13416,Zurielle,F,14,3204564,13696
13417,Aadhiran,M,13,3204577,13850
13418,Aaisha,F,13,3204590,13773
13419,Aamani,F,13,3204603,13492
13420,Aamina,F,13,3204616,13957
13421,Aaryahi,F,13,3204629,13607
13422,Aava,F,13,3204642,13423
13423,Abdalla,M,13,3204655,13439
13424,Abdoul,M,13,3204668,13230
13425,Abdulla,M,13,3204681,13763
13426,Abeera,F,13,3204694,13085
13427,Abem,M,13,3204707,13340
13428,Abhimanyu,M,13,3204720,13379
13429,Absalat,F,13,3204733,13987
13430,Adaia,F,13,3204746,13124
13431,Adaora,F,13,3204759,13888
13432,Addalynne,F,13,3204772,13517
13433,Addley,F,13,3204785,13207
13434,Addysen,F,13,3204798,13780
13435,Adoree,F,13,3204811,13049
13436,Adryanna,F,13,3204824,13283
13437,Adylin,F,13,3204837,13116
13438,Aerabella,F,13,3204850,13348
13439,Afrah,F,13,3204863,13933
13440,Ahlias,M,13,3204876,13659
13441,Ahsha,F,13,3204889,13021
13442,Aide,F,13,3204902,13223
13443,Aima,F,13,3204915,13422
13444,Airis,F,13,3204928,13172
13445,Aison,M,13,3204941,13513
13446,Akila,F,13,3204954,13887
13447,Al,M,13,3204967,13834
13448,Alaeya,F,13,3204980,13684
13449,Alanee,F,13,3204993,13752
13450,Alazne,F,13,3205006,13636
13451,Aldon,M,13,3205019,13783
13452,Aleynah,F,13,3205032,13215
13453,Aliani,F,13,3205045,13141
13454,Allayah,F,13,3205058,13157
13455,Aloura,F,13,3205071,13836
13456,Altair,F,13,3205084,13412
13457,Alyas,M,13,3205097,13993
13458,Alyjah,M,13,3205110,13830
13459,Alyla,F,13,3205123,13302
13460,Amaliya,F,13,3205136,13700
13461,Amalya,F,13,3205149,13131
13462,Amariona,F,13,3205162,13791
13463,Ameliyah,F,13,3205175,13041
13464,Amillion,M,13,3205188,13334
13465,Amiria,F,13,3205201,13657
13466,Amrit,M,13,3205214,13166
13467,Amun,M,13,3205227,13694
13468,Amyr,M,13,3205240,13592
13469,Anahy,F,13,3205253,13554
13470,Analeya,F,13,3205266,13680
13471,Anani,F,13,3205279,13861
13472,Anasophia,F,13,3205292,13795
13473,Andrews,M,13,3205305,13954
13474,Andrian,M,13,3205318,13169
13475,Andrick,M,13,3205331,13903
13476,Angy,F,13,3205344,13929
13477,Anmol,M,13,3205357,13403
13478,Annaliah,F,13,3205370,13972
13479,Annalicia,F,13,3205383,13666
13480,Annaliyah,F,13,3205396,13067
13481,Anuar,M,13,3205409,13284
13482,Arber,M,13,3205422,13690
13483,Areeba,F,13,3205435,13098
13484,Aribelle,F,13,3205448,13393
13485,Arietta,F,13,3205461,13906
13486,Ariez,M,13,3205474,13798
13487,Arif,M,13,3205487,13523
13488,Aristeo,M,13,3205500,13837
13489,Arlington,F,13,3205513,13344
13490,Armiyah,F,13,3205526,13460
13491,Arrielle,F,13,3205539,13411
13492,Arth,M,13,3205552,13961
13493,Ashir,M,13,3205565,13673
13494,Ashwath,M,13,3205578,13876
13495,Ashyr,M,13,3205591,13359
13496,Asli,F,13,3205604,13774
13497,Astor,M,13,3205617,13580
13498,Atiana,F,13,3205630,13003
13499,Atif,M,13,3205643,13612
13500,Audry,F,13,3205656,13044
13501,Auriyah,F,13,3205669,13557
13502,Autum,F,13,3205682,13353
13503,Avanni,F,13,3205695,13849
13504,Avant,M,13,3205708,13714
13505,Avantika,F,13,3205721,13643
13506,Avelino,M,13,3205734,13339
13507,Aviah,F,13,3205747,13465
13508,Avner,M,13,3205760,13250
13509,Avyay,M,13,3205773,13333
13510,Axcel,M,13,3205786,13978
13511,Ayaana,F,13,3205799,13785
13512,Ayaka,F,13,3205812,13036
13513,Ayame,F,13,3205825,13702
13514,Aydeen,M,13,3205838,13672
13515,Ayisha,F,13,3205851,13158
13516,Azaya,F,13,3205864,13093
13517,Azreal,M,13,3205877,13945
13518,Bader,M,13,3205890,13251
13519,Baine,M,13,3205903,13590
13520,Bartolo,M,13,3205916,13357
13521,Basilio,M,13,3205929,13563
13522,Bassel,M,13,3205942,13541
13523,Baya,F,13,3205955,13756
13524,Beckem,M,13,3205968,13394
13525,Beckhem,M,13,3205981,13249
13526,Beckum,M,13,3205994,13692
13527,Believe,F,13,3206007,13495
13528,Bellamarie,F,13,3206020,13833
13529,Bellany,F,13,3206033,13711
13530,Benita,F,13,3206046,13661
13531,Benjamen,M,13,3206059,13481
13532,Beren,M,13,3206072,13885
13533,Betzaida,F,13,3206085,13140
13534,Boss,M,13,3206098,13313
13535,Boyan,M,13,3206111,13662
13536,Braley,F,13,3206124,13122
13537,Branton,M,13,3206137,13163
13538,Bretton,M,13,3206150,13989
13539,Bridge,M,13,3206163,13356
13540,Brihanna,F,13,3206176,13779
13541,Brina,F,13,3206189,13647
13542,Brion,M,13,3206202,13511
13543,Brittyn,F,13,3206215,13803
13544,Brixlee,F,13,3206228,13822
13545,Brixx,M,13,3206241,13408
13546,Briya,F,13,3206254,13013
13547,Bronn,M,13,3206267,13990
13548,Bronsyn,M,13,3206280,13159
13549,Brydon,M,13,3206293,13609
13550,Brynlynn,F,13,3206306,13593
13551,Caidon,M,13,3206319,13057
13552,Caisyn,M,13,3206332,13718
13553,California,F,13,3206345,13528
13554,Callia,F,13,3206358,13875
13555,Calyx,M,13,3206371,13030
13556,Carder,M,13,3206384,13507
13557,Carlson,M,13,3206397,13315
13558,Caspen,M,13,3206410,13877
13559,Catori,F,13,3206423,13883
13560,Caycee,F,13,3206436,13758
13561,Chael,M,13,3206449,13858
13562,Chandlar,F,13,3206462,13794
13563,Chanoch,M,13,3206475,13002
13564,Charlton,M,13,3206488,13691
13565,Chavez,M,13,3206501,13871
13566,Chaynce,M,13,3206514,13611
13567,Christal,F,13,3206527,13948
13568,Christoph,M,13,3206540,13130
13569,Christyn,F,13,3206553,13271
13570,Clayson,M,13,3206566,13329
13571,Clea,F,13,3206579,13427
13572,Clovis,M,13,3206592,13259
13573,Coyote,M,13,3206605,13546
13574,Cristo,M,13,3206618,13286
13575,Cruise,M,13,3206631,13699
13576,Cyla,F,13,3206644,13441
13577,Cyrie,M,13,3206657,13303
13578,Daelen,M,13,3206670,13404
13579,Daevion,M,13,3206683,13023
13580,Daevon,M,13,3206696,13649
13581,Dailee,F,13,3206709,13380
13582,Dain,M,13,3206722,13524
13583,Dalayza,F,13,3206735,13841
13584,Dallan,M,13,3206748,13415
13585,Dalyla,F,13,3206761,13564
13586,Danyah,F,13,3206774,13397
13587,Daryana,F,13,3206787,13908
13588,Dashly,F,13,3206800,13946
13589,Daviel,M,13,3206813,13614
13590,Davison,M,13,3206826,13914
13591,Davonta,M,13,3206839,13070
13592,Dawayne,M,13,3206852,13005
13593,Daxter,M,13,3206865,13504
13594,Dayshawn,M,13,3206878,13932
13595,Daytona,F,13,3206891,13042
13596,Deaira,F,13,3206904,13533
13597,Declynn,F,13,3206917,13670
13598,Dedric,M,13,3206930,13391
13599,Dekhari,M,13,3206943,13685
13600,Delaina,F,13,3206956,13937
13601,Delayah,F,13,3206969,13917
13602,Demetrious,M,13,3206982,13777
13603,Demetris,M,13,3206995,13678
13604,Demiana,F,13,3207008,13854
13605,Deo,M,13,3207021,13823
13606,Derez,M,13,3207034,13623
13607,Derrek,M,13,3207047,13521
13608,Deveon,M,13,3207060,13715
13609,Dhanvi,F,13,3207073,13186
13610,Dijon,M,13,3207086,13018
13611,Dionne,F,13,3207099,13865
13612,Dmir,M,13,3207112,13326
13613,Dreshawn,M,13,3207125,13321
13614,Dylen,M,13,3207138,13602
13615,Eagan,M,13,3207151,13935
13616,Ege,M,13,3207164,13094
13617,Eilis,F,13,3207177,13277
13618,Elai,M,13,3207190,13912
13619,Eliannah,F,13,3207203,13556
13620,Elim,M,13,3207216,13778
13621,Elinora,F,13,3207229,13371
13622,Elira,F,13,3207242,13472
13623,Ellianne,F,13,3207255,13437
13624,Elohim,M,13,3207268,13458
13625,Elsi,F,13,3207281,13964
13626,Elwyn,M,13,3207294,13092
13627,Elyssia,F,13,3207307,13279
13628,Elza,F,13,3207320,13335
13629,Emarion,M,13,3207333,13015
13630,Embri,F,13,3207346,13419
13631,Embrie,F,13,3207359,13716
13632,Emelin,F,13,3207372,13480
13633,Emerlee,F,13,3207385,13185
13634,Emiliah,F,13,3207398,13520
13635,Emmakate,F,13,3207411,13879
13636,Emmalene,F,13,3207424,13652
13637,Enaya,F,13,3207437,13452
13638,Ephram,M,13,3207450,13505
13639,Ericson,M,13,3207463,13272
13640,Erinn,F,13,3207476,13006
13641,Erlin,M,13,3207489,13309
13642,Estee,F,13,3207502,13545
13643,Evia,F,13,3207515,13940
13644,Evryn,F,13,3207528,13187
13645,Eyleen,F,13,3207541,13805
13646,Eylin,F,13,3207554,13111
13647,Ezekeil,M,13,3207567,13531
13648,Fahima,F,13,3207580,13826
13649,Faiz,M,13,3207593,13584
13650,Fearne,F,13,3207606,13123
13651,Finnan,M,13,3207619,13561
13652,Fiora,F,13,3207632,13469
13653,Fortune,F,13,3207645,13144
13654,Franko,M,13,3207658,13922
13655,Fredi,M,13,3207671,13017
13656,Gargi,F,13,3207684,13934
13657,Geremy,M,13,3207697,13764
13658,Gianny,F,13,3207710,13071
13659,Glendon,M,13,3207723,13431
13660,Gor,M,13,3207736,13074
13661,Grason,M,13,3207749,13385
13662,Grayli,F,13,3207762,13969
13663,Graziella,F,13,3207775,13988
13664,Greeicy,F,13,3207788,13091
13665,Grethel,F,13,3207801,13782
13666,Greydon,M,13,3207814,13962
13667,Grimm,M,13,3207827,13797
13668,Haakon,M,13,3207840,13606
13669,Hadija,F,13,3207853,13482
13670,Halimah,F,13,3207866,13305
13671,Haniyah,F,13,3207879,13239
13672,Hannibal,M,13,3207892,13844
13673,Harbour,F,13,3207905,13213
13674,Harden,M,13,3207918,13241
13675,Harriett,F,13,3207931,13515
13676,Haruto,M,13,3207944,13387
13677,Hawthorn,M,13,3207957,13793
13678,Heart,F,13,3207970,13864
13679,Hemi,M,13,3207983,13320
13680,Henchy,F,13,3207996,13497
13681,Hendy,F,13,3208009,13959
13682,Henrique,M,13,3208022,13330
13683,Henrry,M,13,3208035,13839
13684,Heron,M,13,3208048,13082
13685,Hildegard,F,13,3208061,13812
13686,Holy,F,13,3208074,13360
13687,Honestii,F,13,3208087,13926
13688,Honour,F,13,3208100,13433
13689,Huntington,M,13,3208113,13640
13690,Hyder,M,13,3208126,13553
13691,Ibn,M,13,3208139,13790
13692,Ilany,F,13,3208152,13300
13693,Illias,M,13,3208165,13336
13694,Ilwad,F,13,3208178,13688
13695,Inayat,F,13,3208191,13956
13696,Indiya,F,13,3208204,13509
13697,Inga,F,13,3208217,13965
13698,Ion,M,13,3208230,13434
13699,Iremide,F,13,3208243,13424
13700,Irhaa,F,13,3208256,13658
13701,Isaura,F,13,3208269,13154
13702,Ishaaq,M,13,3208282,13165
13703,Ishita,F,13,3208295,13219
13704,Isolde,F,13,3208308,13572
13705,Iven,M,13,3208321,13081
13706,Ivery,F,13,3208334,13724
13707,Ivo,M,13,3208347,13200
13708,Izeyah,M,13,3208360,13821
13709,Jabria,F,13,3208373,13986
13710,Jacory,M,13,3208386,13428
13711,Jacquelin,F,13,3208399,13745
13712,Jacquez,M,13,3208412,13402
13713,Jaeceon,M,13,3208425,13109
13714,Jaecion,M,13,3208438,13089
13715,Jaeson,M,13,3208451,13952
13716,Jahaira,F,13,3208464,13192
13717,Jahara,F,13,3208477,13295
13718,Jahliyah,F,13,3208490,13056
13719,Jahmel,M,13,3208503,13373
13720,Jailey,F,13,3208516,13273
13721,Jaiveer,M,13,3208529,13126
13722,Jaivion,M,13,3208542,13061
13723,Jaiyah,F,13,3208555,13765
13724,Jalayia,F,13,3208568,13210
13725,Jamarian,M,13,3208581,13392
13726,Jamarious,M,13,3208594,13503
13727,Jamisen,M,13,3208607,13171
13728,Jancarlo,M,13,3208620,13639
13729,Janiece,F,13,3208633,13911
13730,Jannelle,F,13,3208646,13703
13731,Janova,F,13,3208659,13616
13732,Jarod,M,13,3208672,13848
13733,Jasaun,M,13,3208685,13218
13734,Jashan,M,13,3208698,13899
13735,Jasmyne,F,13,3208711,13247
13736,Jayshaun,M,13,3208724,13268
13737,Jaysiah,M,13,3208737,13825
13738,Jazarah,F,13,3208750,13466
13739,Jazariah,F,13,3208763,13514
13740,Jazmynn,F,13,3208776,13224
13741,Jazzmyn,F,13,3208789,13088
13742,Jceon,M,13,3208802,13749
13743,Jeanie,F,13,3208815,13184
13744,Jeniah,F,13,3208828,13789
13745,Jeremia,M,13,3208841,13355
13746,Jerika,F,13,3208854,13065
13747,Jeriyah,F,13,3208867,13477
13748,Jernie,F,13,3208880,13262
13749,Jeron,M,13,3208893,13484
13750,Jerri,F,13,3208906,13106
13751,Jhadiel,M,13,3208919,13417
13752,Jhony,M,13,3208932,13566
13753,Jhream,F,13,3208945,13500
13754,Joannie,F,13,3208958,13236
13755,Jobe,M,13,3208971,13079
13756,Joellie,F,13,3208984,13867
13757,Johanny,F,13,3208997,13000
13758,Jonnah,M,13,3209010,13660
13759,Joon,M,13,3209023,13288
13760,Jordann,F,13,3209036,13263
13761,Josaiah,M,13,3209049,13444
13762,Joselyne,F,13,3209062,13179
13763,Josi,F,13,3209075,13571
13764,Jourdan,M,13,3209088,13199
13765,Jovin,M,13,3209101,13275
13766,Jt,M,13,3209114,13518
13767,Julieann,F,13,3209127,13389
13768,Julienne,F,13,3209140,13338
13769,Justise,F,13,3209153,13740
13770,Jwan,F,13,3209166,13979
13771,Kaelum,M,13,3209179,13367
13772,Kaenan,M,13,3209192,13551
13773,Kahleesi,F,13,3209205,13913
13774,Kaielle,F,13,3209218,13099
13775,Kaige,M,13,3209231,13151
13776,Kairy,F,13,3209244,13146
13777,Kaizlyn,F,13,3209257,13540
13778,Kaja,F,13,3209270,13193
13779,Kalaia,F,13,3209283,13583
13780,Kalana,F,13,3209296,13368
13781,Kalii,F,13,3209309,13619
13782,Kalissa,F,13,3209322,13181
13783,Kallee,F,13,3209335,13781
13784,Kalon,M,13,3209348,13488
13785,Kamala,F,13,3209361,13409
13786,Kamarii,F,13,3209374,13156
13787,Kamayah,F,13,3209387,13407
13788,Kameela,F,13,3209400,13212
13789,Kamel,M,13,3209413,13331
13790,Kamsiyochukwu,M,13,3209426,13656
13791,Karalee,F,13,3209439,13866
13792,Karolyn,F,13,3209452,13995
13793,Karyn,F,13,3209465,13870
13794,Kasir,M,13,3209478,13767
13795,Katheryne,F,13,3209491,13629
13796,Kayari,F,13,3209504,13115
13797,Kaye,F,13,3209517,13980
13798,Kaylanii,F,13,3209530,13565
13799,Kaylany,F,13,3209543,13343
13800,Kayleena,F,13,3209556,13622
13801,Kaylena,F,13,3209569,13454
13802,Kayliah,F,13,3209582,13851
13803,Kaylianna,F,13,3209595,13301
13804,Keanan,M,13,3209608,13586
13805,Keelin,M,13,3209621,13086
13806,Keithan,M,13,3209634,13128
13807,Keizer,M,13,3209647,13818
13808,Kejuan,M,13,3209660,13139
13809,Kelaiah,F,13,3209673,13552
13810,Kelci,F,13,3209686,13921
13811,Kelcie,F,13,3209699,13633
13812,Keldan,M,13,3209712,13425
13813,Kenay,M,13,3209725,13190
13814,Kennidy,F,13,3209738,13654
13815,Kennith,M,13,3209751,13667
13816,Kenyatta,M,13,3209764,13983
13817,Kervin,M,13,3209777,13811
13818,Keyani,F,13,3209790,13285
13819,Keyri,F,13,3209803,13801
13820,Khalaya,F,13,3209816,13704
13821,Khazi,M,13,3209829,13443
13822,Khia,F,13,3209842,13048
13823,Khiley,F,13,3209855,13907
13824,Khyaire,M,13,3209868,13601
13825,Kiannah,F,13,3209881,13736
13826,Kieren,M,13,3209894,13727
13827,Kierstin,F,13,3209907,13474
13828,Kiing,M,13,3209920,13349
13829,Kinslei,F,13,3209933,13147
13830,Kioni,F,13,3209946,13695
13831,Kiro,M,13,3209959,13246
13832,Kix,M,13,3209972,13312
13833,Kiyanna,F,13,3209985,13743
13834,Kiyoshi,M,13,3209998,13177
13835,Koben,M,13,3210011,13069
13836,Kobey,M,13,3210024,13863
13837,Koki,M,13,3210037,13142
13838,Koralee,F,13,3210050,13920
13839,Kove,M,13,3210063,13974
13840,Krithik,M,13,3210076,13189
13841,Kushal,M,13,3210089,13537
13842,Kyani,F,13,3210102,13928
13843,Kyleen,F,13,3210115,13117
13844,Kymere,M,13,3210128,13381
13845,Kymoni,F,13,3210141,13902
13846,Kyndra,F,13,3210154,13754
13847,Kynslei,F,13,3210167,13063
13848,Kyrillos,M,13,3210180,13162
13849,Kyzier,M,13,3210193,13035
13850,Laekyn,F,13,3210206,13233
13851,Lakeland,M,13,3210219,13341
13852,Lakeleigh,F,13,3210232,13577
13853,Lakeyn,F,13,3210245,13103
13854,Lalani,F,13,3210258,13991
13855,Lania,F,13,3210271,13682
13856,Lanyiah,F,13,3210284,13376
13857,Lashae,F,13,3210297,13686
13858,Lauro,M,13,3210310,13895
13859,Lavayah,F,13,3210323,13468
13860,Lavie,M,13,3210336,13161
13861,Lawren,F,13,3210349,13375
13862,Layliana,F,13,3210362,13446
13863,Layson,M,13,3210375,13327
13864,Lazlo,M,13,3210388,13873
13865,Leam,M,13,3210401,13713
13866,Leangelo,M,13,3210414,13550
13867,Leib,M,13,3210427,13578
13868,Leighana,F,13,3210440,13429
13869,Lenoxx,M,13,3210453,13009
13870,Leondro,M,13,3210466,13479
13871,Leor,M,13,3210479,13100
13872,Lesandro,M,13,3210492,13150
13873,Lesli,F,13,3210505,13037
13874,Lexani,F,13,3210518,13289
13875,Liat,F,13,3210531,13467
13876,Lidya,F,13,3210544,13610
13877,Lilit,F,13,3210557,13831
13878,Lillah,F,13,3210570,13827
13879,Lin,F,13,3210583,13105
13880,Liona,F,13,3210596,13918
13881,Logic,M,13,3210609,13382
13882,Lolah,F,13,3210622,13796
13883,Lorali,F,13,3210635,13588
13884,Lorianna,F,13,3210648,13560
13885,Louden,M,13,3210661,13677
13886,Lunafreya,F,13,3210674,13257
13887,Lunamarie,F,13,3210687,13205
13888,Lydiann,F,13,3210700,13915
13889,Lynnon,F,13,3210713,13896
13890,Lyssa,F,13,3210726,13378
13891,Mabrey,F,13,3210739,13292
13892,Macarthur,M,13,3210752,13626
13893,Macklen,M,13,3210765,13337
13894,Macklynn,F,13,3210778,13941
13895,Madalee,F,13,3210791,13062
13896,Madiha,F,13,3210804,13276
13897,Magdalynn,F,13,3210817,13755
13898,Maleeya,F,13,3210830,13924
13899,Malyah,F,13,3210843,13697
13900,Manna,F,13,3210856,13992
13901,Maraya,F,13,3210869,13080
13902,Marayah,F,13,3210882,13617
13903,Margarito,M,13,3210895,13386
13904,Marielena,F,13,3210908,13813
13905,Markie,F,13,3210921,13143
13906,Marra,F,13,3210934,13269
13907,Marvell,M,13,3210947,13828
13908,Marymargaret,F,13,3210960,13508
13909,Massimiliano,M,13,3210973,13608
13910,Matteus,M,13,3210986,13775
13911,Mattilynn,F,13,3210999,13766
13912,Maurizio,M,13,3211012,13019
13913,Mavric,M,13,3211025,13968
13914,Mawada,F,13,3211038,13936
13915,Mayari,F,13,3211051,13624
13916,Mega,M,13,3211064,13625
13917,Megumi,F,13,3211077,13027
13918,Mehran,M,13,3211090,13125
13919,Melanee,F,13,3211103,13710
13920,Melea,F,13,3211116,13054
13921,Memory,F,13,3211129,13350
13922,Menaal,F,13,3211142,13287
13923,Meral,F,13,3211155,13266
13924,Meryn,F,13,3211168,13985
13925,Miami,F,13,3211181,13587
13926,Miasia,F,13,3211194,13113
13927,Michaiah,F,13,3211207,13164
13928,Mickie,F,13,3211220,13951
13929,Midas,M,13,3211233,13529
13930,Miesha,F,13,3211246,13447
13931,Miia,F,13,3211259,13188
13932,Milia,F,13,3211272,13589
13933,Millan,M,13,3211285,13708
13934,Millani,F,13,3211298,13984
13935,Mitzi,F,13,3211311,13045
13936,Moataz,M,13,3211324,13901
13937,Mohamedamin,M,13,3211337,13261
13938,Monzerrat,F,13,3211350,13493
13939,Morven,F,13,3211363,13613
13940,Moss,M,13,3211376,13418
13941,Moustapha,M,13,3211389,13238
13942,Murphie,F,13,3211402,13311
13943,Mushtaq,F,13,3211415,13559
13944,Mychael,M,13,3211428,13051
13945,Myshawn,M,13,3211441,13026
13946,Naava,F,13,3211454,13747
13947,Nahyan,M,13,3211467,13112
13948,Najla,F,13,3211480,13631
13949,Nalan,M,13,3211493,13216
13950,Nanami,F,13,3211506,13815
13951,Narah,F,13,3211519,13282
13952,Naseer,M,13,3211532,13031
13953,Nasier,M,13,3211545,13981
13954,Naveya,F,13,3211558,13997
13955,Nayvee,F,13,3211571,13055
13956,Naz,F,13,3211584,13674
13957,Nazario,M,13,3211597,13197
13958,Nazeer,M,13,3211610,13543
13959,Nazli,F,13,3211623,13253
13960,Nels,M,13,3211636,13020
13961,Nevaan,M,13,3211649,13202
13962,Nichelle,F,13,3211662,13242
13963,Nicky,M,13,3211675,13645
13964,Nil,F,13,3211688,13544
13965,Nima,M,13,3211701,13198
13966,Nissi,F,13,3211714,13416
13967,Nivi,F,13,3211727,13618
13968,Niyam,M,13,3211740,13483
13969,Nkosi,M,13,3211753,13953
13970,Noaah,M,13,3211766,13568
13971,Nolani,F,13,3211779,13744
13972,Novali,F,13,3211792,13475
13973,Nusayba,F,13,3211805,13845
13974,Nyema,F,13,3211818,13786
13975,Nyima,F,13,3211831,13512
13976,Nysha,F,13,3211844,13904
13977,Ohemaa,F,13,3211857,13698
13978,Ola,F,13,3211870,13665
13979,Olivea,F,13,3211883,13802
13980,Ollyver,M,13,3211896,13799
13981,Olson,M,13,3211909,13679
13982,Onna,F,13,3211922,13040
13983,Oralia,F,13,3211935,13401
13984,Ostara,F,13,3211948,13060
13985,Parnika,F,13,3211961,13155
13986,Parthenia,F,13,3211974,13059
13987,Paytin,F,13,3211987,13119
13988,Peniel,F,13,3212000,13650
13989,Piercen,M,13,3212013,13804
13990,Qira,F,13,3212026,13501
13991,Quavion,M,13,3212039,13949
13992,Raad,M,13,3212052,13319
13993,Raffaele,M,13,3212065,13220
13994,Rahmah,F,13,3212078,13351
13995,Rahmel,M,13,3212091,13709
13996,Raigen,F,13,3212104,13388
13997,Ralynn,F,13,3212117,13641
13998,Ramya,F,13,3212130,13653
13999,Ramzi,M,13,3212143,13064
14000,Rance,M,13,3212156,14346
14001,Raseel,F,13,3212169,14811
14002,Rawley,M,13,3212182,14298
14003,Rayon,M,13,3212195,14364
14004,Rayshon,M,13,3212208,14135
14005,Raziyah,F,13,3212221,14235
14006,Reality,F,13,3212234,14758
14007,Reet,F,13,3212247,14059
14008,Refugio,M,13,3212260,14080
14009,Reham,F,13,3212273,14640
14010,Reighlyn,F,13,3212286,14206
14011,Rennie,F,13,3212299,14018
14012,Rheia,F,13,3212312,14706
14013,Rhyse,M,13,3212325,14845
14014,Rickie,M,13,3212338,14192
14015,Riku,M,13,3212351,14554
14016,Riona,F,13,3212364,14097
14017,Rishika,F,13,3212377,14498
14018,Rivansh,M,13,3212390,14188
14019,Ronon,M,13,3212403,14279
14020,Rosalea,F,13,3212416,14890
14021,Rosalena,F,13,3212429,14517
14022,Roselee,F,13,3212442,14668
14023,Roselin,F,13,3212455,14491
14024,Roselina,F,13,3212468,14658
14025,Ruchel,F,13,3212481,14220
14026,Rumaisa,F,13,3212494,14959
14027,Rushank,M,13,3212507,14923
14028,Ryliegh,F,13,3212520,14720
14029,Rynleigh,F,13,3212533,14024
14030,Ryo,M,13,3212546,14734
14031,Saabir,M,13,3212559,14749
14032,Saatvik,M,13,3212572,14159
14033,Sahira,F,13,3212585,14788
14034,Saleena,F,13,3212598,14587
14035,Samanvitha,F,13,3212611,14529
14036,Samary,F,13,3212624,14987
14037,Samvel,M,13,3212637,14502
14038,Sanchez,M,13,3212650,14960
14039,Santonio,M,13,3212663,14572
14040,Sarabeth,F,13,3212676,14978
14041,Saud,M,13,3212689,14632
14042,Sebashtian,M,13,3212702,14511
14043,Serge,M,13,3212715,14737
14044,Sergi,M,13,3212728,14473
14045,Sevastian,M,13,3212741,14281
14046,Shaheem,M,13,3212754,14590
14047,Shahzaib,M,13,3212767,14646
14048,Shakti,F,13,3212780,14202
14049,Shaquan,M,13,3212793,14105
14050,Sharvin,M,13,3212806,14877
14051,Shauna,F,13,3212819,14338
14052,Sheena,F,13,3212832,14017
14053,Shifa,F,13,3212845,14286
14054,Shirel,F,13,3212858,14271
14055,Shiva,M,13,3212871,14661
14056,Shravya,F,13,3212884,14228
14057,Shubh,M,13,3212897,14329
14058,Sian,F,13,3212910,14438
14059,Sianni,F,13,3212923,14965
14060,Sina,M,13,3212936,14189
14061,Siri,F,13,3212949,14545
14062,Siyona,F,13,3212962,14161
14063,Soniya,F,13,3212975,14486
14064,Sonnet,F,13,3212988,14674
14065,Sophea,F,13,3213001,14099
14066,Sophiagrace,F,13,3213014,14366
14067,Sophina,F,13,3213027,14546
14068,Sovereign,F,13,3213040,14968
14069,Sparsh,M,13,3213053,14573
14070,Stefen,M,13,3213066,14385
14071,Steffen,M,13,3213079,14670
14072,Suany,F,13,3213092,14401
14073,Sufiyan,M,13,3213105,14791
14074,Suliman,M,13,3213118,14285
14075,Sunflower,F,13,3213131,14299
14076,Suryansh,M,13,3213144,14121
14077,Suvi,F,13,3213157,14939
14078,Swayde,M,13,3213170,14625
14079,Sylvana,F,13,3213183,14976
14080,Taisha,F,13,3213196,14504
14081,Talani,F,13,3213209,14996
14082,Talley,F,13,3213222,14839
14083,Tanush,M,13,3213235,14178
14084,Tarah,F,13,3213248,14950
14085,Tashawn,M,13,3213261,14023
14086,Taten,M,13,3213274,14470
14087,Thiana,F,13,3213287,14937
14088,Tilda,F,13,3213300,14902
14089,Timberlynn,F,13,3213313,14359
14090,Timia,F,13,3213326,14654
14091,Tobiah,M,13,3213339,14613
14092,Tora,F,13,3213352,14007
14093,Traci,F,13,3213365,14793
14094,Tramaine,M,13,3213378,14986
14095,Traysen,M,13,3213391,14201
14096,Trentin,M,13,3213404,14851
14097,Trevan,M,13,3213417,14849
14098,Trever,M,13,3213430,14610
14099,Tulsi,F,13,3213443,14898
14100,Tynslee,F,13,3213456,14653
14101,Tyon,M,13,3213469,14129
14102,Tyrek,M,13,3213482,14566
14103,Tyreke,M,13,3213495,14219
14104,Tyton,M,13,3213508,14565
14105,Umaima,F,13,3213521,14229
14106,Umair,M,13,3213534,14776
14107,Vadim,M,13,3213547,14912
14108,Vaila,F,13,3213560,14350
14109,Valeska,F,13,3213573,14577
14110,Velma,F,13,3213586,14456
14111,Vidya,F,13,3213599,14582
14112,Vinh,M,13,3213612,14390
14113,Viva,F,13,3213625,14464
14114,Viyona,F,13,3213638,14115
14115,Wanda,F,13,3213651,14380
14116,Wiliam,M,13,3213664,14046
14117,Willson,M,13,3213677,14906
14118,Wyllow,F,13,3213690,14400
14119,Xiana,F,13,3213703,14875
14120,Yacob,M,13,3213716,14657
14121,Yafet,M,13,3213729,14344
14122,Yahye,M,13,3213742,14267
14123,Yanelis,F,13,3213755,14413
14124,Yanna,F,13,3213768,14436
14125,Yasiah,M,13,3213781,14341
14126,Yeiren,M,13,3213794,14903
14127,Yeriel,M,13,3213807,14476
14128,Yianni,M,13,3213820,14742
14129,Yichen,M,13,3213833,14853
14130,Yishai,M,13,3213846,14222
14131,Yoanna,F,13,3213859,14847
14132,Yonis,M,13,3213872,14581
14133,Ysabelle,F,13,3213885,14433
14134,Yuma,M,13,3213898,14524
14135,Yvan,M,13,3213911,14075
14136,Zackaria,M,13,3213924,14755
14137,Zaeem,M,13,3213937,14043
14138,Zaiah,F,13,3213950,14971
14139,Zamyah,F,13,3213963,14409
14140,Zanae,F,13,3213976,14927
14141,Zanaya,F,13,3213989,14580
14142,Zarie,F,13,3214002,14743
14143,Zarra,F,13,3214015,14249
14144,Zarrah,F,13,3214028,14913
14145,Zavior,M,13,3214041,14871
14146,Zayli,F,13,3214054,14317
14147,Zayon,M,13,3214067,14604
14148,Zayven,M,13,3214080,14556
14149,Zebedee,M,13,3214093,14048
14150,Zeta,F,13,3214106,14162
14151,Zetta,F,13,3214119,14782
14152,Zilah,F,13,3214132,14795
14153,Ziyan,M,13,3214145,14730
14154,Zolan,M,13,3214158,14992
14155,Zyere,M,13,3214171,14501
14156,Zylie,F,13,3214184,14167
14157,Zylon,M,13,3214197,14374
14158,Zyonn,M,13,3214210,14918
14159,Zyron,M,13,3214223,14247
14160,Aadhi,M,12,3214235,14315
14161,Aafiya,F,12,3214247,14824
14162,Aamari,M,12,3214259,14123
14163,Aamilah,F,12,3214271,14035
14164,Aarnav,M,12,3214283,14440
14165,Aarnika,F,12,3214295,14494
14166,Aaruhi,F,12,3214307,14818
14167,Abdikadir,M,12,3214319,14826
14168,Abdou,M,12,3214331,14543
14169,Abena,F,12,3214343,14867
14170,Abenezer,M,12,3214355,14141
14171,Adahlia,F,12,3214367,14127
14172,Adalaya,F,12,3214379,14241
14173,Addalyne,F,12,3214391,14237
14174,Addis,M,12,3214403,14463
14175,Adelheid,F,12,3214415,14848
14176,Adelisa,F,12,3214427,14205
14177,Adharv,M,12,3214439,14383
14178,Adilee,F,12,3214451,14140
14179,Adja,F,12,3214463,14367
14180,Adoni,M,12,3214475,14415
14181,Adrain,M,12,3214487,14039
14182,Adryel,M,12,3214499,14584
14183,Aerie,F,12,3214511,14208
14184,Ahmadou,M,12,3214523,14844
14185,Ahmaud,M,12,3214535,14495
14186,Ahmon,M,12,3214547,14262
14187,Ahriyah,F,12,3214559,14052
14188,Ailana,F,12,3214571,14272
14189,Ailis,F,12,3214583,14480
14190,Aimsley,F,12,3214595,14910
14191,Aisla,F,12,3214607,14006
14192,Akayla,F,12,3214619,14929
14193,Alaine,F,12,3214631,14724
14194,Alayha,F,12,3214643,14846
14195,Alayjah,F,12,3214655,14792
14196,Albus,M,12,3214667,14854
14197,Aleiza,F,12,3214679,14086
14198,Alesso,M,12,3214691,14008
14199,Alianys,F,12,3214703,14443
14200,Alika,M,12,3214715,14250
14201,Allyanna,F,12,3214727,14924
14202,Almira,F,12,3214739,14891
14203,Alonni,F,12,3214751,14531
14204,Alyric,F,12,3214763,14683
14205,Alyrica,F,12,3214775,14036
14206,Alyssah,F,12,3214787,14060
14207,Alysse,F,12,3214799,14291
14208,Amad,M,12,3214811,14680
14209,Amariya,F,12,3214823,14655
14210,Amarri,M,12,3214835,14044
14211,Amarys,F,12,3214847,14628
14212,Ambree,F,12,3214859,14774
14213,Ambrosia,F,12,3214871,14810
14214,Ameah,F,12,3214883,14735
14215,Amela,F,12,3214895,14193
14216,Ameris,F,12,3214907,14034
14217,Amoree,F,12,3214919,14805
14218,Amoret,F,12,3214931,14964
14219,Amrom,M,12,3214943,14153
14220,Anabiya,F,12,3214955,14079
14221,Anayra,F,12,3214967,14447
14222,Andrae,M,12,3214979,14716
14223,Andrej,M,12,3214991,14897
14224,Anely,F,12,3215003,14602
14225,Aniel,M,12,3215015,14037
14226,Aniket,M,12,3215027,14471
14227,Annakate,F,12,3215039,14702
14228,Annalysia,F,12,3215051,14864
14229,Annelyse,F,12,3215063,14020
14230,Anselmo,M,12,3215075,14062
14231,Anvit,M,12,3215087,14757
14232,Anvita,F,12,3215099,14536
14233,Aolani,F,12,3215111,14369
14234,Araeya,F,12,3215123,14747
14235,Araf,M,12,3215135,14069
14236,Araoluwa,F,12,3215147,14873
14237,Archivaldo,M,12,3215159,14863
14238,Arielis,F,12,3215171,14675
14239,Ariyonna,F,12,3215183,14802
14240,Arkin,M,12,3215195,14361
14241,Arkyn,M,12,3215207,14596
14242,Arlowe,F,12,3215219,14224
14243,Arohi,F,12,3215231,14149
14244,Arrietty,F,12,3215243,14645
14245,Artemisia,F,12,3215255,14065
14246,Aryahi,F,12,3215267,14838
14247,Ashai,M,12,3215279,14103
14248,Ashlynne,F,12,3215291,14165
14249,Asif,M,12,3215303,14985
14250,Atiya,F,12,3215315,14691
14251,Atlantis,F,12,3215327,14426
14252,Aubriee,F,12,3215339,14424
14253,Aubryanna,F,12,3215351,14071
14254,Audi,F,12,3215363,14138
14255,Aundre,M,12,3215375,14481
14256,Aurla,F,12,3215387,14611
14257,Avamae,F,12,3215399,14884
14258,Aveera,F,12,3215411,14598
14259,Avianni,F,12,3215423,14373
14260,Aviendha,F,12,3215435,14242
14261,Avry,M,12,3215447,14713
14262,Avyon,M,12,3215459,14622
14263,Aydon,M,12,3215471,14882
14264,Aydyn,M,12,3215483,14697
14265,Ayrabella,F,12,3215495,14038
14266,Ayris,F,12,3215507,14245
14267,Ayvion,M,12,3215519,14382
14268,Azaad,M,12,3215531,14095
14269,Azaylah,F,12,3215543,14026
14270,Babygirl,F,12,3215555,14855
14271,Bairon,M,12,3215567,14215
14272,Baldemar,M,12,3215579,14339
14273,Bao,M,12,3215591,14879
14274,Barack,M,12,3215603,14085
14275,Barok,M,12,3215615,14748
14276,Barton,M,12,3215627,14221
14277,Batool,F,12,3215639,14376
14278,Baz,M,12,3215651,14972
14279,Bellamae,F,12,3215663,14934
14280,Berel,M,12,3215675,14348
14281,Bergen,F,12,3215687,14360
14282,Bhargav,M,12,3215699,14398
14283,Birdy,F,12,3215711,14199
14284,Blaklee,F,12,3215723,14122
14285,Blakleigh,F,12,3215735,14458
14286,Bohannon,M,12,3215747,14019
14287,Bonita,F,12,3215759,14261
14288,Brahm,M,12,3215771,14196
14289,Bralyn,M,12,3215783,14306
14290,Braxden,M,12,3215795,14335
14291,Brayley,F,12,3215807,14311
14292,Bren,M,12,3215819,14113
14293,Brenten,M,12,3215831,14515
14294,Brevin,M,12,3215843,14519
14295,Brexten,M,12,3215855,14941
14296,Breyson,M,12,3215867,14294
14297,Bridgett,F,12,3215879,14878
14298,Brihana,F,12,3215891,14133
14299,Brockton,M,12,3215903,14449
14300,Bruna,F,12,3215915,14928
14301,Bryler,M,12,3215927,14493
14302,Buster,M,12,3215939,14807
14303,Byrdie,F,12,3215951,14427
14304,Cahlil,M,12,3215963,14641
14305,Caila,F,12,3215975,14961
14306,Cailean,M,12,3215987,14022
14307,Calihan,M,12,3215999,14796
14308,Calirose,F,12,3216011,14634
14309,Calissa,F,12,3216023,14507
14310,Camaya,F,12,3216035,14452
14311,Camile,F,12,3216047,14880
14312,Canelo,M,12,3216059,14723
14313,Carlina,F,12,3216071,14363
14314,Cashlyn,F,12,3216083,14182
14315,Cashmir,M,12,3216095,14633
14316,Cassidee,F,12,3216107,14305
14317,Castin,M,12,3216119,14767
14318,Catalea,F,12,3216131,14888
14319,Caylani,F,12,3216143,14289
14320,Ceanna,F,12,3216155,14684
14321,Cecilio,M,12,3216167,14322
14322,Charissa,F,12,3216179,14894
14323,Chidinma,F,12,3216191,14817
14324,Chinedu,M,12,3216203,14081
14325,Chizara,F,12,3216215,14040
14326,Christella,F,12,3216227,14736
14327,Christin,F,12,3216239,14630
14328,Ciela,F,12,3216251,14794
14329,Cipriano,M,12,3216263,14213
14330,Clemence,F,12,3216275,14650
14331,Colbi,F,12,3216287,14144
14332,Colman,M,12,3216299,14172
14333,Conrado,M,12,3216311,14326
14334,Cope,M,12,3216323,14118
14335,Copelynn,F,12,3216335,14715
14336,Corleone,M,12,3216347,14638
14337,Corvus,M,12,3216359,14605
14338,Coty,M,12,3216371,14510
14339,Curry,M,12,3216383,14679
14340,Cylis,M,12,3216395,14391
14341,Cyniah,F,12,3216407,14821
14342,Cyris,M,12,3216419,14387
14343,Dailani,F,12,3216431,14953
14344,Daimon,M,12,3216443,14815
14345,Dajour,M,12,3216455,14908
14346,Dalaysia,F,12,3216467,14100
14347,Dalya,F,12,3216479,14106
14348,Damiah,F,12,3216491,14662
14349,Damyla,F,12,3216503,14200
14350,Danah,F,12,3216515,14083
14351,Danniel,M,12,3216527,14886
14352,Darleny,F,12,3216539,14342
14353,Darryn,M,12,3216551,14260
14354,Daulton,M,12,3216563,14719
14355,Daunte,M,12,3216575,14204
14356,Davari,M,12,3216587,14349
14357,Daxxton,M,12,3216599,14563
14358,Daziyah,F,12,3216611,14030
14359,Deaundre,M,12,3216623,14512
14360,Deetya,F,12,3216635,14562
14361,Dela,F,12,3216647,14179
14362,Delonte,M,12,3216659,14107
14363,Demarkus,M,12,3216671,14936
14364,Denilson,M,12,3216683,14503
14365,Derwin,M,12,3216695,14756
14366,Deryck,M,12,3216707,14687
14367,Deylani,F,12,3216719,14370
14368,Dezmon,M,12,3216731,14603
14369,Dhilan,M,12,3216743,14290
14370,Diangelo,M,12,3216755,14957
14371,Diara,F,12,3216767,14407
14372,Diezel,M,12,3216779,14825
14373,Dj,M,12,3216791,14592
14374,Dkhari,M,12,3216803,14198
14375,Donivan,M,12,3216815,14288
14376,Dovber,M,12,3216827,14164
14377,Dovi,M,12,3216839,14223
14378,Draedyn,M,12,3216851,14128
14379,Draper,M,12,3216863,14514
14380,Drin,M,12,3216875,14428
14381,Dublin,M,12,3216887,14010
14382,Edel,M,12,3216899,14982
14383,Edeline,F,12,3216911,14027
14384,Edinson,M,12,3216923,14865
14385,Edrian,M,12,3216935,14652
14386,Edriel,M,12,3216947,14347
14387,Eeshan,M,12,3216959,14497
14388,Eevie,F,12,3216971,14049
14389,Efrata,F,12,3216983,14482
14390,Egor,M,12,3216995,14741
14391,Eilyn,F,12,3217007,14399
14392,Eissa,M,12,3217019,14943
14393,Eivan,M,12,3217031,14013
14394,Eladio,M,12,3217043,14432
14395,Elany,F,12,3217055,14416
14396,Elda,F,12,3217067,14296
14397,Elen,F,12,3217079,14264
14398,Eleny,F,12,3217091,14462
14399,Eleora,F,12,3217103,14656
14400,Eliav,M,12,3217115,14209
14401,Elika,F,12,3217127,14073
14402,Elilah,F,12,3217139,14859
14403,Elka,F,12,3217151,14932
14404,Ellenora,F,12,3217163,14207
14405,Eluzer,M,12,3217175,14831
14406,Elyna,F,12,3217187,14136
14407,Elynn,F,12,3217199,14185
14408,Elysian,M,12,3217211,14624
14409,Emaly,F,12,3217223,14186
14410,Emanii,F,12,3217235,14248
14411,Emanuella,F,12,3217247,14988
14412,Emaree,F,12,3217259,14088
14413,Emerik,M,12,3217271,14759
14414,Emias,M,12,3217283,14307
14415,Emie,F,12,3217295,14466
14416,Emila,F,12,3217307,14190
14417,Emilija,F,12,3217319,14465
14418,Emiline,F,12,3217331,14731
14419,Emilliano,M,12,3217343,14077
14420,Emillio,M,12,3217355,14386
14421,Emilya,F,12,3217367,14644
14422,Emmalynne,F,12,3217379,14881
14423,Emmari,F,12,3217391,14453
14424,Emmely,F,12,3217403,14168
14425,Emmerick,M,12,3217415,14564
14426,Emonie,F,12,3217427,14905
14427,Enora,F,12,3217439,14647
14428,Erikson,M,12,3217451,14893
14429,Esequiel,M,12,3217463,14616
14430,Estrellita,F,12,3217475,14711
14431,Eugenie,F,12,3217487,14547
14432,Eusebio,M,12,3217499,14814
14433,Evarose,F,12,3217511,14393
14434,Eveleigh,F,12,3217523,14522
14435,Evelena,F,12,3217535,14496
14436,Evely,F,12,3217547,14525
14437,Evony,F,12,3217559,14084
14438,Ezel,M,12,3217571,14746
14439,Eztli,F,12,3217583,14676
14440,Fabeha,F,12,3217595,14752
14441,Fadi,M,12,3217607,14310
14442,Fajr,F,12,3217619,14535
14443,Fara,F,12,3217631,14729
14444,Farris,M,12,3217643,14047
14445,Fatimata,F,12,3217655,14157
14446,Feliks,M,12,3217667,14354
14447,Finan,M,12,3217679,14537
14448,Fitzpatrick,M,12,3217691,14254
14449,Francheska,F,12,3217703,14623
14450,Frankee,F,12,3217715,14469
14451,Fredric,M,12,3217727,14137
14452,Fuad,M,12,3217739,14999
14453,Gabbanelli,F,12,3217751,14319
14454,Gable,M,12,3217763,14708
14455,Gabryel,M,12,3217775,14532
14456,Gabryella,F,12,3217787,14772
14457,Gaetano,M,12,3217799,14574
14458,Genesee,F,12,3217811,14942
14459,Gianelle,F,12,3217823,14284
14460,Glorianna,F,12,3217835,14255
14461,Greisy,F,12,3217847,14150
14462,Guhan,M,12,3217859,14995
14463,Gurbaaz,M,12,3217871,14444
14464,Gurmehar,F,12,3217883,14876
14465,Gwyn,F,12,3217895,14054
14466,Hadeel,F,12,3217907,14883
14467,Hades,M,12,3217919,14822
14468,Hadessah,F,12,3217931,14238
14469,Haivyn,F,12,3217943,14110
14470,Haizleigh,F,12,3217955,14403
14471,Halleigh,F,12,3217967,14042
14472,Hanif,M,12,3217979,14834
14473,Hannan,F,12,3217991,14057
14474,Harrington,M,12,3218003,14600
14475,Haseeb,M,12,3218015,14917
14476,Hasnain,M,12,3218027,14569
14477,Havoc,M,12,3218039,14714
14478,Hawke,M,12,3218051,14901
14479,Hidayah,F,12,3218063,14980
14480,Hila,F,12,3218075,14325
14481,Hira,F,12,3218087,14696
14482,Hiroshi,M,12,3218099,14429
14483,Hodaya,F,12,3218111,14606
14484,Holli,F,12,3218123,14055
14485,Hollynn,F,12,3218135,14842
14486,Holston,M,12,3218147,14093
14487,Honestee,F,12,3218159,14803
14488,Hridaan,M,12,3218171,14475
14489,Huxson,M,12,3218183,14677
14490,Igor,M,12,3218195,14615
14491,Ikram,F,12,3218207,14282
14492,Ilay,M,12,3218219,14993
14493,Illianna,F,12,3218231,14025
14494,Inanna,F,12,3218243,14707
14495,Indee,F,12,3218255,14639
14496,Ionna,F,12,3218267,14754
14497,Ithiel,M,12,3218279,14005
14498,Ivianna,F,12,3218291,14907
14499,Ivor,M,12,3218303,14594
14500,Iyaan,M,12,3218315,14102
14501,Izaiyah,M,12,3218327,14217
14502,Izora,F,12,3218339,14911
14503,Jaaziah,M,12,3218351,14540
14504,Jacobie,M,12,3218363,14268
14505,Jadarius,M,12,3218375,14827
14506,Jadis,F,12,3218387,14568
14507,Jaelee,F,12,3218399,14283
14508,Jaelin,M,12,3218411,14586
14509,Jahi,M,12,3218423,14101
14510,Jahmier,M,12,3218435,14609
14511,Jahvon,M,12,3218447,14028
14512,Jaianna,F,12,3218459,14692
14513,Jaimie,F,12,3218471,14896
14514,Jalayiah,F,12,3218483,14635
14515,Jalayla,F,12,3218495,14263
14516,Jamarie,M,12,3218507,14459
14517,Jamyiah,F,12,3218519,14533
14518,Jandel,M,12,3218531,14892
14519,Janelis,F,12,3218543,14738
14520,Jaryah,F,12,3218555,14919
14521,Javiah,F,12,3218567,14621
14522,Javiel,M,12,3218579,14253
14523,Jaxn,M,12,3218591,14492
14524,Jaxstyn,M,12,3218603,14211
14525,Jaxsun,M,12,3218615,14506
14526,Jayco,M,12,3218627,14321
14527,Jaydee,M,12,3218639,14700
14528,Jayelle,F,12,3218651,14868
14529,Jayliah,F,12,3218663,14474
14530,Jazmarie,F,12,3218675,14328
14531,Jazzmin,F,12,3218687,14710
14532,Jeanpierre,M,12,3218699,14280
14533,Jenaya,F,12,3218711,14396
14534,Jeno,M,12,3218723,14273
14535,Jeramie,M,12,3218735,14058
14536,Jerelyn,F,12,3218747,14392
14537,Jermain,M,12,3218759,14293
14538,Jermari,M,12,3218771,14430
14539,Jessejames,M,12,3218783,14169
14540,Jeyla,F,12,3218795,14236
14541,Jezebel,F,12,3218807,14388
14542,Joangel,M,12,3218819,14003
14543,Joas,M,12,3218831,14895
14544,Johnthomas,M,12,3218843,14642
14545,Jojo,F,12,3218855,14550
14546,Jonae,F,12,3218867,14252
14547,Josemiguel,M,12,3218879,14156
14548,Joven,M,12,3218891,14764
14549,Jubal,M,12,3218903,14406
14550,Jujhar,M,12,3218915,14963
14551,Julez,M,12,3218927,14173
14552,Juvenal,M,12,3218939,14214
14553,Juventino,M,12,3218951,14441
14554,Kadance,F,12,3218963,14131
14555,Kadarius,M,12,3218975,14266
14556,Kadija,F,12,3218987,14548
14557,Kaedin,M,12,3218999,14553
14558,Kagan,M,12,3219011,14671
14559,Kahiau,M,12,3219023,14801
14560,Kahloni,F,12,3219035,14143
14561,Kaian,M,12,3219047,14591
14562,Kaicee,F,12,3219059,14857
14563,Kaii,M,12,3219071,14304
14564,Kainon,M,12,3219083,14066
14565,Kalaiya,F,12,3219095,14457
14566,Kaleem,M,12,3219107,14733
14567,Kalisa,F,12,3219119,14861
14568,Kamela,F,12,3219131,14528
14569,Kanani,F,12,3219143,14423
14570,Karalyn,F,12,3219155,14130
14571,Kariana,F,12,3219167,14439
14572,Kario,M,12,3219179,14041
14573,Karlynn,F,12,3219191,14094
14574,Karra,F,12,3219203,14649
14575,Kashaun,M,12,3219215,14490
14576,Kashis,M,12,3219227,14277
14577,Kasiyah,F,12,3219239,14820
14578,Kasten,M,12,3219251,14958
14579,Kataleena,F,12,3219263,14397
14580,Kathaleya,F,12,3219275,14940
14581,Katherina,F,12,3219287,14045
14582,Kaylinn,F,12,3219299,14145
14583,Kaylum,M,12,3219311,14050
14584,Kayshawn,M,12,3219323,14739
14585,Kayveon,M,12,3219335,14295
14586,Kealani,F,12,3219347,14956
14587,Keaston,M,12,3219359,14732
14588,Keen,M,12,3219371,14500
14589,Keilee,F,12,3219383,14330
14590,Keleigh,F,12,3219395,14031
14591,Kemauri,M,12,3219407,14067
14592,Kember,F,12,3219419,14601
14593,Kennah,F,12,3219431,14705
14594,Kentrel,M,12,3219443,14951
14595,Kenzee,F,12,3219455,14930
14596,Keo,M,12,3219467,14962
14597,Keomi,F,12,3219479,14833
14598,Keonte,M,12,3219491,14487
14599,Keron,M,12,3219503,14775
14600,Kervens,M,12,3219515,14292
14601,Khairi,M,12,3219527,14816
14602,Kharson,M,12,3219539,14483
14603,Khizar,M,12,3219551,14599
14604,Khy,M,12,3219563,14521
14605,Khyren,M,12,3219575,14744
14606,Kiaya,F,12,3219587,14777
14607,Kimiko,F,12,3219599,14499
14608,Kimorah,F,12,3219611,14726
14609,Kingsleigh,F,12,3219623,14712
14610,Knoelle,F,12,3219635,14117
14611,Korryn,F,12,3219647,14323
14612,Krimson,F,12,3219659,14345
14613,Krishav,M,12,3219671,14089
14614,Kristyn,F,12,3219683,14312
14615,Kylina,F,12,3219695,14620
14616,Kynadee,F,12,3219707,14761
14617,Kynedi,F,12,3219719,14991
14618,Kyria,F,12,3219731,14618
14619,Laasya,F,12,3219743,14745
14620,Laelle,F,12,3219755,14126
14621,Laiana,F,12,3219767,14446
14622,Laiani,F,12,3219779,14567
14623,Lakayla,F,12,3219791,14925
14624,Landynn,M,12,3219803,14203
14625,Lanya,F,12,3219815,14785
14626,Larenz,M,12,3219827,14780
14627,Latavious,M,12,3219839,14410
14628,Lazaria,F,12,3219851,14693
14629,Leani,F,12,3219863,14181
14630,Leddy,F,12,3219875,14984
14631,Leeloo,F,12,3219887,14695
14632,Leeon,M,12,3219899,14627
14633,Legynd,M,12,3219911,14120
14634,Leiby,M,12,3219923,14425
14635,Leighann,F,12,3219935,14246
14636,Leith,M,12,3219947,14394
14637,Leiyah,F,12,3219959,14124
14638,Lenard,M,12,3219971,14320
14639,Leniel,M,12,3219983,14557
14640,Lenya,F,12,3219995,14560
14641,Lexii,F,12,3220007,14087
14642,Lexis,F,12,3220019,14518
14643,Liandro,M,12,3220031,14313
14644,Linh,F,12,3220043,14539
14645,Lisseth,F,12,3220055,14975
14646,Livana,F,12,3220067,14660
14647,Livian,F,12,3220079,14461
14648,Liylah,F,12,3220091,14698
14649,Lizabeth,F,12,3220103,14297
14650,Loany,F,12,3220115,14856
14651,Lorik,M,12,3220127,14549
14652,Lorilei,F,12,3220139,14468
14653,Louna,F,12,3220151,14812
14654,Lovelyn,F,12,3220163,14119
14655,Lucan,M,12,3220175,14210
14656,Lun,F,12,3220187,14240
14657,Lydell,M,12,3220199,14434
14658,Lyliana,F,12,3220211,14096
14659,Lynne,F,12,3220223,14823
14660,Macari,M,12,3220235,14981
14661,Mackenlee,F,12,3220247,14619
14662,Maclynn,F,12,3220259,14709
14663,Madalina,F,12,3220271,14948
14664,Madalynne,F,12,3220283,14243
14665,Maddoxx,M,12,3220295,14488
14666,Madoc,M,12,3220307,14922
14667,Maelin,F,12,3220319,14983
14668,Mahalakshmi,F,12,3220331,14420
14669,Mahan,M,12,3220343,14852
14670,Maiza,F,12,3220355,14874
14671,Majed,M,12,3220367,14862
14672,Makya,F,12,3220379,14685
14673,Malaiah,F,12,3220391,14860
14674,Malanii,F,12,3220403,14064
14675,Malaquias,M,12,3220415,14472
14676,Maleeah,F,12,3220427,14158
14677,Malekai,M,12,3220439,14589
14678,Manaal,F,12,3220451,14704
14679,Manaia,F,12,3220463,14351
14680,Manar,F,12,3220475,14098
14681,Mang,M,12,3220487,14104
14682,Manvitha,F,12,3220499,14636
14683,Marcelle,F,12,3220511,14899
14684,Mariaelena,F,12,3220523,14694
14685,Maricarmen,F,12,3220535,14029
14686,Marijane,F,12,3220547,14664
14687,Mariyam,F,12,3220559,14909
14688,Markeith,M,12,3220571,14362
14689,Marlaysia,F,12,3220583,14583
14690,Marleni,F,12,3220595,14116
14691,Marsden,M,12,3220607,14184
14692,Marston,M,12,3220619,14309
14693,Marwah,F,12,3220631,14227
14694,Marya,F,12,3220643,14530
14695,Marycatherine,F,12,3220655,14665
14696,Masani,F,12,3220667,14544
14697,Mattingly,F,12,3220679,14916
14698,Maxamillion,M,12,3220691,14667
14699,Maxima,F,12,3220703,14004
14700,Mayela,F,12,3220715,14931
14701,Mayella,F,12,3220727,14276
14702,Mayes,M,12,3220739,14108
14703,Mayjor,M,12,3220751,14175
14704,Maykel,M,12,3220763,14021
14705,Maymunah,F,12,3220775,14356
14706,Mayukha,F,12,3220787,14570
14707,Mazy,F,12,3220799,14579
14708,Meika,F,12,3220811,14614
14709,Melaney,F,12,3220823,14484
14710,Merary,F,12,3220835,14946
14711,Meridian,F,12,3220847,14412
14712,Merrill,F,12,3220859,14508
14713,Miagrace,F,12,3220871,14251
14714,Mialani,F,12,3220883,14870
14715,Mialynn,F,12,3220895,14460
14716,Micheala,F,12,3220907,14146
14717,Milahni,F,12,3220919,14352
14718,Milina,F,12,3220931,14269
14719,Mily,F,12,3220943,14090
14720,Mohamud,M,12,3220955,14139
14721,Motty,M,12,3220967,14947
14722,Muhammadyusuf,M,12,3220979,14997
14723,Mujtaba,M,12,3220991,14666
14724,Munro,M,12,3221003,14371
14725,Murat,M,12,3221015,14148
14726,Mushka,F,12,3221027,14505
14727,Mussa,M,12,3221039,14051
14728,Mustafo,M,12,3221051,14781
14729,Myelle,F,12,3221063,14699
14730,Myiah,F,12,3221075,14534
14731,Mykaela,F,12,3221087,14885
14732,Mykal,M,12,3221099,14595
14733,Mylia,F,12,3221111,14300
14734,Myriah,F,12,3221123,14343
14735,Myrtle,F,12,3221135,14762
14736,Nachmen,M,12,3221147,14402
14737,Naelani,F,12,3221159,14843
14738,Naelle,F,12,3221171,14014
14739,Naif,M,12,3221183,14768
14740,Nainika,F,12,3221195,14765
14741,Nakiya,F,12,3221207,14016
14742,Nakota,M,12,3221219,14784
14743,Naliya,F,12,3221231,14411
14744,Namine,F,12,3221243,14074
14745,Nanea,F,12,3221255,14979
14746,Nasai,M,12,3221267,14155
14747,Nashton,M,12,3221279,14608
14748,Nasiya,F,12,3221291,14111
14749,Nasreen,F,12,3221303,14418
14750,Naturi,F,12,3221315,14578
14751,Naveena,F,12,3221327,14454
14752,Nayelis,F,12,3221339,14109
14753,Nazari,M,12,3221351,14954
14754,Nazariah,F,12,3221363,14669
14755,Nehal,F,12,3221375,14448
14756,Nehan,M,12,3221387,14033
14757,Neilan,M,12,3221399,14270
14758,Nevan,M,12,3221411,14389
14759,Nevaya,F,12,3221423,14551
14760,Niala,F,12,3221435,14195
14761,Niaomi,F,12,3221447,14134
14762,Nicklas,M,12,3221459,14944
14763,Nishtha,F,12,3221471,14809
14764,Niyana,F,12,3221483,14479
14765,Noami,F,12,3221495,14132
14766,Nobel,M,12,3221507,14053
14767,Nochum,M,12,3221519,14151
14768,Noellie,F,12,3221531,14541
14769,Noraa,F,12,3221543,14332
14770,North,F,12,3221555,14542
14771,Novaly,F,12,3221567,14340
14772,Novia,F,12,3221579,14197
14773,Nuh,M,12,3221591,14651
14774,Nuvia,F,12,3221603,14404
14775,Nyair,M,12,3221615,14174
14776,Nyzaiah,M,12,3221627,14414
14777,Nyzier,M,12,3221639,14686
14778,Oasis,F,12,3221651,14015
14779,Obie,M,12,3221663,14989
14780,Oday,M,12,3221675,14783
14781,Olaoluwa,M,12,3221687,14355
14782,Oliwier,M,12,3221699,14966
14783,Ollin,M,12,3221711,14576
14784,Oluwatamilore,F,12,3221723,14274
14785,Oluwatobi,M,12,3221735,14829
14786,Omkar,M,12,3221747,14216
14787,Oshae,M,12,3221759,14187
14788,Patryk,M,12,3221771,14866
14789,Penelopi,F,12,3221783,14527
14790,Persephonie,F,12,3221795,14790
14791,Persia,F,12,3221807,14001
14792,Pilot,M,12,3221819,14722
14793,Pixie,F,12,3221831,14520
14794,Poet,F,12,3221843,14973
14795,Porfirio,M,12,3221855,14974
14796,Portland,F,12,3221867,14813
14797,Prayer,F,12,3221879,14230
14798,Prentice,M,12,3221891,14417
14799,Prisca,F,12,3221903,14753
14800,Prodigy,M,12,3221915,14763
14801,Qadir,M,12,3221927,14779
14802,Quincee,F,12,3221939,14850
14803,Quint,M,12,3221951,14631
14804,Quintyn,M,12,3221963,14000
14805,Quorra,F,12,3221975,14477
14806,Raahi,F,12,3221987,14787
14807,Race,M,12,3221999,14257
14808,Raelene,F,12,3222011,14092
14809,Rahima,F,12,3222023,14234
14810,Raia,F,12,3222035,14797
14811,Rakeb,F,12,3222047,14740
14812,Ramey,F,12,3222059,14333
14813,Ramiel,M,12,3222071,14659
14814,Ranvir,M,12,3222083,14703
14815,Rashell,F,12,3222095,14331
14816,Rashod,M,12,3222107,14009
14817,Rasmus,M,12,3222119,14056
14818,Ravon,M,12,3222131,14945
14819,Rayhana,F,12,3222143,14327
14820,Raymir,M,12,3222155,14372
14821,Rayner,M,12,3222167,14561
14822,Raysean,M,12,3222179,14914
14823,Raza,M,12,3222191,14091
14824,Rechel,F,12,3222203,14526
14825,Redd,M,12,3222215,14316
14826,Rehema,F,12,3222227,14379
14827,Reniyah,F,12,3222239,14681
14828,Rennick,M,12,3222251,14353
14829,Reon,M,12,3222263,14721
14830,Rhealynn,F,12,3222275,14800
14831,Richelle,F,12,3222287,14523
14832,Ridlee,F,12,3222299,14337
14833,Riverleigh,F,12,3222311,14166
14834,Riviera,F,12,3222323,14798
14835,Roarke,M,12,3222335,14445
14836,Roby,M,12,3222347,14233
14837,Robynn,F,12,3222359,14218
14838,Rocklyn,F,12,3222371,14225
14839,Romilly,F,12,3222383,14232
14840,Ronav,M,12,3222395,14835
14841,Rosebella,F,12,3222407,14718
14842,Rosey,F,12,3222419,14935
14843,Ruari,M,12,3222431,14061
14844,Rubina,F,12,3222443,14915
14845,Ruhama,F,12,3222455,14275
14846,Ruweyda,F,12,3222467,14180
14847,Saber,M,12,3222479,14384
14848,Sachi,F,12,3222491,14663
14849,Sagal,F,12,3222503,14114
14850,Sahmir,M,12,3222515,14804
14851,Sahori,F,12,3222527,14318
14852,Saire,M,12,3222539,14478
14853,Salayah,F,12,3222551,14933
14854,Samah,F,12,3222563,14194
14855,Samaj,M,12,3222575,14575
14856,Sameen,F,12,3222587,14002
14857,Saniyya,F,12,3222599,14786
14858,Santanna,M,12,3222611,14770
14859,Saphire,F,12,3222623,14408
14860,Saralyn,F,12,3222635,14808
14861,Sargun,F,12,3222647,14239
14862,Sasuke,M,12,3222659,14068
14863,Savian,M,12,3222671,14378
14864,Seif,M,12,3222683,14154
14865,Serigne,M,12,3222695,14994
14866,Severus,M,12,3222707,14629
14867,Shaden,F,12,3222719,14513
14868,Shahmeer,M,12,3222731,14990
14869,Shalev,M,12,3222743,14926
14870,Shelbie,F,12,3222755,14555
14871,Shelley,F,12,3222767,14258
14872,Sho,M,12,3222779,14799
14873,Shukrona,F,12,3222791,14766
14874,Shyra,F,12,3222803,14760
14875,Siddarth,M,12,3222815,14789
14876,Siddhant,M,12,3222827,14442
14877,Simba,M,12,3222839,14142
14878,Sinclair,F,12,3222851,14171
14879,Sita,F,12,3222863,14872
14880,Skylor,M,12,3222875,14078
14881,Smaya,F,12,3222887,14727
14882,Sola,F,12,3222899,14183
14883,Sonnie,F,12,3222911,14869
14884,Stevan,M,12,3222923,14970
14885,Suhail,M,12,3222935,14773
14886,Suleman,M,12,3222947,14163
14887,Sumeya,F,12,3222959,14751
14888,Supriya,F,12,3222971,14678
14889,Surina,F,12,3222983,14489
14890,Susanne,F,12,3222995,14648
14891,Suzana,F,12,3223007,14552
14892,Symon,M,12,3223019,14076
14893,Szymon,M,12,3223031,14431
14894,Taft,M,12,3223043,14455
14895,Taggart,M,12,3223055,14358
14896,Takara,F,12,3223067,14920
14897,Takiyah,F,12,3223079,14422
14898,Talisa,F,12,3223091,14451
14899,Tamaya,F,12,3223103,14771
14900,Tarryn,F,12,3223115,14588
14901,Tarynn,F,12,3223127,14302
14902,Taurean,M,12,3223139,14011
14903,Taveon,M,12,3223151,14278
14904,Teanna,F,12,3223163,14112
14905,Tehya,F,12,3223175,14244
14906,Teia,F,12,3223187,14231
14907,Temari,F,12,3223199,14368
14908,Tenleigh,F,12,3223211,14259
14909,Terell,M,12,3223223,14152
14910,Thaddaeus,M,12,3223235,14819
14911,Thadeo,M,12,3223247,14160
14912,Thara,F,12,3223259,14571
14913,Thurston,M,12,3223271,14538
14914,Tigerlily,F,12,3223283,14597
14915,Timo,M,12,3223295,14509
14916,Tomasa,F,12,3223307,14836
14917,Tonya,F,12,3223319,14082
14918,Tor,M,12,3223331,14682
14919,Travell,M,12,3223343,14593
14920,Tray,M,12,3223355,14395
14921,Trayveon,M,12,3223367,14377
14922,Triana,F,12,3223379,14070
14923,Trigger,M,12,3223391,14336
14924,Trixie,F,12,3223403,14381
14925,Trooper,M,12,3223415,14308
14926,Trustin,M,12,3223427,14889
14927,Trypp,M,12,3223439,14841
14928,Tully,M,12,3223451,14717
14929,Tymon,M,12,3223463,14324
14930,Umi,F,12,3223475,14485
14931,Vianca,F,12,3223487,14955
14932,Vihaana,F,12,3223499,14969
14933,Vika,F,12,3223511,14147
14934,Vincenza,F,12,3223523,14191
14935,Viona,F,12,3223535,14314
14936,Viraat,M,12,3223547,14904
14937,Vyla,F,12,3223559,14226
14938,Waleska,F,12,3223571,14558
14939,Wally,M,12,3223583,14450
14940,Waniya,F,12,3223595,14837
14941,Werner,M,12,3223607,14585
14942,Westlee,M,12,3223619,14256
14943,Weyland,M,12,3223631,14690
14944,Wilhelm,M,12,3223643,14840
14945,Wissam,M,12,3223655,14559
14946,Xaylee,F,12,3223667,14421
14947,Xiadani,F,12,3223679,14287
14948,Xianna,F,12,3223691,14607
14949,Xola,F,12,3223703,14952
14950,Xylan,M,12,3223715,14626
14951,Xyliana,F,12,3223727,14728
14952,Xyon,M,12,3223739,14673
14953,Yahweh,M,12,3223751,14921
14954,Yarielis,F,12,3223763,14778
14955,Yates,M,12,3223775,14032
14956,Yelina,F,12,3223787,14301
14957,Yeudiel,M,12,3223799,14012
14958,Yliana,F,12,3223811,14998
14959,Yocelyn,F,12,3223823,14437
14960,Yoshi,M,12,3223835,14938
14961,Yovany,M,12,3223847,14900
14962,Yuchen,M,12,3223859,14750
14963,Yuto,M,12,3223871,14365
14964,Zahar,M,12,3223883,14769
14965,Zahran,M,12,3223895,14643
14966,Zaileigh,F,12,3223907,14405
14967,Zaim,M,12,3223919,14516
14968,Zakarri,M,12,3223931,14830
14969,Zakia,F,12,3223943,14858
14970,Zamani,F,12,3223955,14689
14971,Zandra,F,12,3223967,14125
14972,Zannah,F,12,3223979,14212
14973,Zawadi,F,12,3223991,14072
14974,Zayana,F,12,3224003,14063
14975,Zayen,M,12,3224015,14949
14976,Zaylani,F,12,3224027,14357
14977,Zebastian,M,12,3224039,14688
14978,Zelig,M,12,3224051,14177
14979,Zepplin,M,12,3224063,14967
14980,Zhamir,M,12,3224075,14375
14981,Zinedine,M,12,3224087,14977
14982,Zohaan,M,12,3224099,14832
14983,Zonaira,F,12,3224111,14725
14984,Zurisadai,F,12,3224123,14612
14985,Zyaira,F,12,3224135,14170
14986,Aariana,F,11,3224146,14176
14987,Aarion,M,11,3224157,14419
14988,Aashrith,M,11,3224168,14435
14989,Abbigale,F,11,3224179,14303
14990,Abbygale,F,11,3224190,14334
14991,Abdalrahman,M,11,3224201,14672
14992,Abdelrahman,M,11,3224212,14806
14993,Abdi,M,11,3224223,14617
14994,Abiha,F,11,3224234,14467
14995,Abishai,M,11,3224245,14637
14996,Abrahan,M,11,3224256,14887
14997,Abrian,M,11,3224267,14265
14998,Acesyn,M,11,3224278,14701
14999,Achilleus,M,11,3224289,14828
15000,Adaleya,F,11,3224300,15941
15001,Adaliz,F,11,3224311,15353
15002,Adelene,F,11,3224322,15137
15003,Adesuwa,F,11,3224333,15017
15004,Adib,M,11,3224344,15758
15005,Adrion,M,11,3224355,15266
15006,Aelia,F,11,3224366,15492
15007,Afiyah,F,11,3224377,15142
15008,Agaran,M,11,3224388,15130
15009,Agasthya,M,11,3224399,15074
15010,Ahmar,M,11,3224410,15740
15011,Ahmeir,M,11,3224421,15035
15012,Ahsoka,F,11,3224432,15032
15013,Aidah,F,11,3224443,15515
15014,Aidee,F,11,3224454,15187
15015,Aimar,M,11,3224465,15415
15016,Ajai,M,11,3224476,15165
15017,Ajwa,F,11,3224487,15327
15018,Aki,M,11,3224498,15930
15019,Akina,F,11,3224509,15983
15020,Aladdin,M,11,3224520,15544
15021,Alajah,F,11,3224531,15799
15022,Alayssa,F,11,3224542,15969
15023,Albaraa,M,11,3224553,15175
15024,Albin,M,11,3224564,15303
15025,Albina,F,11,3224575,15184
15026,Aldous,M,11,3224586,15361
15027,Aleea,F,11,3224597,15933
15028,Aleeha,F,11,3224608,15126
15029,Aleisha,F,11,3224619,15994
15030,Alenah,F,11,3224630,15673
15031,Aleni,F,11,3224641,15099
15032,Alesandra,F,11,3224652,15363
15033,Alessandria,F,11,3224663,15312
15034,Alessi,F,11,3224674,15322
15035,Alethia,F,11,3224685,15823
15036,Alexxa,F,11,3224696,15027
15037,Alexzandria,F,11,3224707,15745
15038,Alezander,M,11,3224718,15855
15039,Alhassan,M,11,3224729,15809
15040,Aliany,F,11,3224740,15371
15041,Alicea,F,11,3224751,15385
15042,Alija,M,11,3224762,15605
15043,Alissia,F,11,3224773,15671
15044,Alizon,F,11,3224784,15499
15045,Alleah,F,11,3224795,15565
15046,Alleigh,F,11,3224806,15071
15047,Alleria,F,11,3224817,15140
15048,Allistair,M,11,3224828,15926
15049,Alonnah,F,11,3224839,15105
15050,Altan,M,11,3224850,15793
15051,Alvis,M,11,3224861,15639
15052,Alynah,F,11,3224872,15974
15053,Amaal,F,11,3224883,15879
15054,Amabel,F,11,3224894,15287
15055,Amalee,F,11,3224905,15505
15056,Amali,F,11,3224916,15593
15057,Amariz,F,11,3224927,15305
15058,Amaryah,F,11,3224938,15060
15059,Amayia,F,11,3224949,15149
15060,Ameela,F,11,3224960,15735
15061,Amelah,F,11,3224971,15169
15062,Ameyah,F,11,3224982,15642
15063,Amiylah,F,11,3224993,15785
15064,Amrie,F,11,3225004,15622
15065,Anahat,F,11,3225015,15477
15066,Analeigha,F,11,3225026,15501
15067,Analisse,F,11,3225037,15719
15068,Analiya,F,11,3225048,15637
15069,Analynn,F,11,3225059,15421
15070,Anasia,F,11,3225070,15726
15071,Anberlin,F,11,3225081,15153
15072,Andilynn,F,11,3225092,15463
15073,Anelia,F,11,3225103,15443
15074,Angelena,F,11,3225114,15705
15075,Angelin,F,11,3225125,15088
15076,Anina,F,11,3225136,15771
15077,Annalynne,F,11,3225147,15846
15078,Annaya,F,11,3225158,15843
15079,Annetta,F,11,3225169,15536
15080,Anthuan,M,11,3225180,15664
15081,Antonela,F,11,3225191,15689
15082,Anzel,M,11,3225202,15959
15083,Apphia,F,11,3225213,15010
15084,Araminta,F,11,3225224,15940
15085,Arantxa,F,11,3225235,15418
15086,Aravis,F,11,3225246,15539
15087,Arcelia,F,11,3225257,15871
15088,Arel,M,11,3225268,15376
15089,Arella,F,11,3225279,15412
15090,Arfa,F,11,3225290,15076
15091,Arhum,M,11,3225301,15900
15092,Ariely,F,11,3225312,15520
15093,Arka,M,11,3225323,15131
15094,Arland,M,11,3225334,15398
15095,Arliss,M,11,3225345,15081
15096,Arlynn,F,11,3225356,15386
15097,Armor,M,11,3225367,15128
15098,Arnaldo,M,11,3225378,15857
15099,Arrion,M,11,3225389,15311
15100,Arris,M,11,3225400,15659
15101,Aryansh,M,11,3225411,15007
15102,Arye,M,11,3225422,15222
15103,Aryianna,F,11,3225433,15997
15104,Asal,F,11,3225444,15087
15105,Aser,M,11,3225455,15127
15106,Ashia,F,11,3225466,15599
15107,Ashiya,F,11,3225477,15880
15108,Asmi,F,11,3225488,15487
15109,Astella,F,11,3225499,15112
15110,Atheena,F,11,3225510,15903
15111,Aunna,F,11,3225521,15134
15112,Avaeh,F,11,3225532,15916
15113,Avanya,F,11,3225543,15616
15114,Aveena,F,11,3225554,15535
15115,Avien,M,11,3225565,15196
15116,Aviona,F,11,3225576,15342
15117,Avishai,M,11,3225587,15813
15118,Avya,F,11,3225598,15154
15119,Axara,F,11,3225609,15731
15120,Axe,M,11,3225620,15330
15121,Axil,M,11,3225631,15227
15122,Ayanah,F,11,3225642,15576
15123,Ayani,F,11,3225653,15202
15124,Ayannah,F,11,3225664,15249
15125,Aydah,F,11,3225675,15047
15126,Aylana,F,11,3225686,15988
15127,Aylene,F,11,3225697,15709
15128,Aysia,F,11,3225708,15301
15129,Azahra,F,11,3225719,15600
15130,Azam,M,11,3225730,15360
15131,Azar,M,11,3225741,15662
15132,Azarion,M,11,3225752,15238
15133,Azariya,F,11,3225763,15848
15134,Azhaan,M,11,3225774,15284
15135,Azyiah,F,11,3225785,15629
15136,Baldwin,M,11,3225796,15374
15137,Bali,F,11,3225807,15701
15138,Balthazar,M,11,3225818,15185
15139,Barrington,M,11,3225829,15120
15140,Bayli,F,11,3225840,15670
15141,Baylon,M,11,3225851,15339
15142,Bellagrace,F,11,3225862,15111
15143,Benjamim,M,11,3225873,15678
15144,Berit,F,11,3225884,15151
15145,Bertram,M,11,3225895,15344
15146,Bertrand,M,11,3225906,15822
15147,Bessie,F,11,3225917,15144
15148,Bethania,F,11,3225928,15352
15149,Bingham,M,11,3225939,15269
15150,Birch,M,11,3225950,15147
15151,Blakeli,F,11,3225961,15913
15152,Boyce,M,11,3225972,15402
15153,Branston,M,11,3225983,15324
15154,Braxston,M,11,3225994,15372
15155,Brayli,F,11,3226005,15800
15156,Breagha,F,11,3226016,15971
15157,Brek,M,11,3226027,15182
15158,Breklyn,F,11,3226038,15107
15159,Brex,M,11,3226049,15317
15160,Brexlyn,F,11,3226060,15054
15161,Breylon,M,11,3226071,15783
15162,Briann,F,11,3226082,15280
15163,Brinly,F,11,3226093,15125
15164,Briony,F,11,3226104,15987
15165,Bristal,F,11,3226115,15939
15166,Bristyn,F,11,3226126,15199
15167,Brisyn,M,11,3226137,15844
15168,British,F,11,3226148,15186
15169,Brixten,M,11,3226159,15732
15170,Bryor,M,11,3226170,15788
15171,Bryxton,M,11,3226181,15556
15172,Cailani,F,11,3226192,15658
15173,Calahan,M,11,3226203,15291
15174,Cannan,M,11,3226214,15905
15175,Carlei,F,11,3226225,15293
15176,Carmin,F,11,3226236,15268
15177,Carole,F,11,3226247,15811
15178,Catalena,F,11,3226258,15368
15179,Cathalina,F,11,3226269,15904
15180,Caydon,M,11,3226280,15921
15181,Cayley,F,11,3226291,15299
15182,Caylum,M,11,3226302,15522
15183,Caynan,M,11,3226313,15839
15184,Cebastian,M,11,3226324,15739
15185,Ceejay,M,11,3226335,15239
15186,Celene,F,11,3226346,15666
15187,Chanie,F,11,3226357,15827
15188,Chaniya,F,11,3226368,15359
15189,Chantz,M,11,3226379,15357
15190,Chara,F,11,3226390,15255
15191,Charlye,F,11,3226401,15135
15192,Charvik,M,11,3226412,15550
15193,Chasidy,F,11,3226423,15938
15194,Chaston,M,11,3226434,15297
15195,Chesnee,F,11,3226445,15824
15196,Chett,M,11,3226456,15775
15197,Chrystal,F,11,3226467,15246
15198,Cicely,F,11,3226478,15620
15199,Cinsere,M,11,3226489,15567
15200,Cirilo,M,11,3226500,15002
15201,Cisco,M,11,3226511,15411
15202,Cobey,M,11,3226522,15070
15203,Coleston,M,11,3226533,15349
15204,Conleigh,F,11,3226544,15625
15205,Conroy,M,11,3226555,15825
15206,Cortana,F,11,3226566,15831
15207,Coryn,F,11,3226577,15390
15208,Crews,M,11,3226588,15221
15209,Crist,M,11,3226599,15999
15210,Cyanna,F,11,3226610,15970
15211,Cypher,M,11,3226621,15523
15212,Cyprus,M,11,3226632,15244
15213,Daeshawn,M,11,3226643,15332
15214,Dagim,M,11,3226654,15682
15215,Dahiana,F,11,3226665,15925
15216,Daijon,M,11,3226676,15649
15217,Dailey,F,11,3226687,15254
15218,Daisee,F,11,3226698,15960
15219,Dakarri,M,11,3226709,15219
15220,Dalanie,F,11,3226720,15393
15221,Dalari,F,11,3226731,15968
15222,Daleiza,F,11,3226742,15636
15223,Damarian,M,11,3226753,15996
15224,Daneen,F,11,3226764,15830
15225,Daniah,F,11,3226775,15341
15226,Danyel,M,11,3226786,15467
15227,Darragh,M,11,3226797,15975
15228,Darrow,M,11,3226808,15836
15229,Daymond,M,11,3226819,15743
15230,Deklynn,F,11,3226830,15698
15231,Delahni,F,11,3226841,15528
15232,Delaila,F,11,3226852,15943
15233,Delaynie,F,11,3226863,15052
15234,Delena,F,11,3226874,15756
15235,Delmy,F,11,3226885,15675
15236,Demyla,F,11,3226896,15040
15237,Dennise,F,11,3226907,15102
15238,Deontre,M,11,3226918,15918
15239,Derrian,M,11,3226929,15261
15240,Deston,M,11,3226940,15647
15241,Deuce,M,11,3226951,15124
15242,Devesh,M,11,3226962,15205
15243,Devlyn,F,11,3226973,15331
15244,Dharma,F,11,3226984,15029
15245,Dhrithi,F,11,3226995,15744
15246,Dhyani,F,11,3227006,15347
15247,Diore,F,11,3227017,15733
15248,Diva,F,11,3227028,15504
15249,Djibril,M,11,3227039,15763
15250,Dkari,M,11,3227050,15101
15251,Dominico,M,11,3227061,15730
15252,Donavyn,M,11,3227072,15873
15253,Donis,M,11,3227083,15453
15254,Doyle,M,11,3227094,15201
15255,Draxton,M,11,3227105,15422
15256,Drelyn,M,11,3227116,15442
15257,Dyamond,F,11,3227127,15537
15258,Dyanna,F,11,3227138,15643
15259,Eames,M,11,3227149,15495
15260,Eathan,M,11,3227160,15337
15261,Edrik,M,11,3227171,15138
15262,Edynn,F,11,3227182,15867
15263,Ehaan,M,11,3227193,15440
15264,Eion,M,11,3227204,15714
15265,Ej,M,11,3227215,15251
15266,Elanese,F,11,3227226,15875
15267,Elania,F,11,3227237,15036
15268,Elanora,F,11,3227248,15865
15269,Elbert,M,11,3227259,15607
15270,Eldar,M,11,3227270,15502
15271,Elene,F,11,3227281,15450
15272,Eliakim,M,11,3227292,15276
15273,Elianne,F,11,3227303,15984
15274,Eliceo,M,11,3227314,15355
15275,Elienai,F,11,3227325,15233
15276,Elisabetta,F,11,3227336,15267
15277,Elisse,F,11,3227347,15989
15278,Elivia,F,11,3227358,15064
15279,Ellakate,F,11,3227369,15626
15280,Ellamay,F,11,3227380,15906
15281,Ellayna,F,11,3227391,15838
15282,Elliemay,F,11,3227402,15392
15283,Elliett,F,11,3227413,15672
15284,Ellorie,F,11,3227424,15012
15285,Ellyse,F,11,3227435,15172
15286,Elysa,F,11,3227446,15697
15287,Emerleigh,F,11,3227457,15923
15288,Emileo,M,11,3227468,15210
15289,Emili,F,11,3227479,15026
15290,Emilian,M,11,3227490,15195
15291,Emilianna,F,11,3227501,15396
15292,Emit,M,11,3227512,15656
15293,Emmalie,F,11,3227523,15400
15294,Emperor,M,11,3227534,15211
15295,Emrey,F,11,3227545,15439
15296,Endy,M,11,3227556,15323
15297,Enza,F,11,3227567,15919
15298,Eriberto,M,11,3227578,15503
15299,Erionna,F,11,3227589,15724
15300,Ermais,M,11,3227600,15383
15301,Eryka,F,11,3227611,15774
15302,Esmi,F,11,3227622,15067
15303,Essiah,M,11,3227633,15034
15304,Estephanie,F,11,3227644,15489
15305,Ettel,F,11,3227655,15367
15306,Eula,F,11,3227666,15712
15307,Evanie,F,11,3227677,15326
15308,Evann,M,11,3227688,15366
15309,Evergreen,F,11,3227699,15055
15310,Evoleht,F,11,3227710,15229
15311,Evrett,M,11,3227721,15073
15312,Eyal,M,11,3227732,15178
15313,Eymi,F,11,3227743,15674
15314,Eytan,M,11,3227754,15828
15315,Ezrie,F,11,3227765,15079
15316,Fable,F,11,3227776,15772
15317,Faithlyn,F,11,3227787,15573
15318,Fancy,F,11,3227798,15474
15319,Fareedah,F,11,3227809,15304
15320,Farouk,M,11,3227820,15161
15321,Fedor,M,11,3227831,15490
15322,Fields,M,11,3227842,15198
15323,Fionna,F,11,3227853,15092
15324,Flannery,F,11,3227864,15479
15325,Folarin,M,11,3227875,15506
15326,Fowler,M,11,3227886,15095
15327,Furaha,F,11,3227897,15306
15328,Gabbie,F,11,3227908,15454
15329,Galileah,F,11,3227919,15218
15330,Garrus,M,11,3227930,15286
15331,Gautam,M,11,3227941,15001
15332,General,M,11,3227952,15817
15333,Georgio,M,11,3227963,15108
15334,Germaine,M,11,3227974,15529
15335,Giah,F,11,3227985,15016
15336,Gianfranco,M,11,3227996,15807
15337,Giavanni,F,11,3228007,15132
15338,Gift,M,11,3228018,15948
15339,Grafton,M,11,3228029,15725
15340,Grainger,M,11,3228040,15980
15341,Grasyn,M,11,3228051,15481
15342,Gurtaj,M,11,3228062,15050
15343,Gwyndolyn,F,11,3228073,15540
15344,Hadiyah,F,11,3228084,15176
15345,Hamed,M,11,3228095,15473
15346,Hamlet,M,11,3228106,15590
15347,Hanzel,M,11,3228117,15840
15348,Haylin,F,11,3228128,15893
15349,Haylynn,F,11,3228139,15136
15350,Healani,F,11,3228150,15160
15351,Helix,M,11,3228161,15548
15352,Hennessey,F,11,3228172,15004
15353,Hensleigh,F,11,3228183,15338
15354,Hermela,F,11,3228194,15619
15355,Heyden,M,11,3228205,15967
15356,Himmat,M,11,3228216,15754
15357,Huckston,M,11,3228227,15496
15358,Husam,M,11,3228238,15150
15359,Huxtyn,M,11,3228249,15804
15360,Icon,M,11,3228260,15570
15361,Ikechukwu,M,11,3228271,15469
15362,Ileanna,F,11,3228282,15213
15363,Iliani,F,11,3228293,15289
15364,Ilina,F,11,3228304,15113
15365,Ineza,F,11,3228315,15789
15366,Infantgirl,F,11,3228326,15022
15367,Iridessa,F,11,3228337,15488
15368,Isaih,M,11,3228348,15578
15369,Israelle,F,11,3228359,15561
15370,Issam,M,11,3228370,15516
15371,Itamar,M,11,3228381,15955
15372,Izaias,M,11,3228392,15964
15373,Izyan,M,11,3228403,15048
15374,Izzah,F,11,3228414,15687
15375,Jacque,M,11,3228425,15990
15376,Jacquelynn,F,11,3228436,15993
15377,Jaelen,M,11,3228447,15103
15378,Jafar,M,11,3228458,15909
15379,Jager,M,11,3228469,15369
15380,Jahnae,F,11,3228480,15770
15381,Jaionna,F,11,3228491,15329
15382,Jaivon,M,11,3228502,15742
15383,Jakaden,M,11,3228513,15953
15384,Jaking,M,11,3228524,15459
15385,Jakya,F,11,3228535,15476
15386,Jalayna,F,11,3228546,15189
15387,Jaleiah,F,11,3228557,15876
15388,Jaleya,F,11,3228568,15478
15389,Jalilah,F,11,3228579,15508
15390,Jamario,M,11,3228590,15884
15391,Jamarr,M,11,3228601,15228
15392,Jamien,M,11,3228612,15319
15393,Jamiere,M,11,3228623,15193
15394,Jamilla,F,11,3228634,15089
15395,Janeliz,F,11,3228645,15998
15396,Janielys,F,11,3228656,15441
15397,Janya,F,11,3228667,15760
15398,Jari,F,11,3228678,15362
15399,Jariya,F,11,3228689,15236
15400,Jarret,M,11,3228700,15920
15401,Jaselyn,F,11,3228711,15881
15402,Jash,M,11,3228722,15833
15403,Jashon,M,11,3228733,15667
15404,Jasin,M,11,3228744,15958
15405,Jatavious,M,11,3228755,15413
15406,Jathniel,M,11,3228766,15158
15407,Javar,M,11,3228777,15887
15408,Javoni,M,11,3228788,15761
15409,Jaxie,F,11,3228799,15348
15410,Jaxsin,M,11,3228810,15163
15411,Jaycelyn,F,11,3228821,15773
15412,Jayliani,F,11,3228832,15281
15413,Jaymir,M,11,3228843,15635
15414,Jayziel,M,11,3228854,15717
15415,Jazier,M,11,3228865,15414
15416,Jazzy,F,11,3228876,15533
15417,Jeanelle,F,11,3228887,15882
15418,Jedaiah,M,11,3228898,15434
15419,Jedrek,M,11,3228909,15847
15420,Jeferson,M,11,3228920,15954
15421,Jelina,F,11,3228931,15764
15422,Jenesys,F,11,3228942,15547
15423,Jenevie,F,11,3228953,15075
15424,Jenika,F,11,3228964,15956
15425,Jennalee,F,11,3228975,15812
15426,Jentrie,F,11,3228986,15023
15427,Jeramy,M,11,3228997,15895
15428,Jeramyah,M,11,3229008,15191
15429,Jerica,F,11,3229019,15606
15430,Jerrica,F,11,3229030,15611
15431,Jerzi,F,11,3229041,15232
15432,Jese,M,11,3229052,15345
15433,Jevin,M,11,3229063,15798
15434,Jheremy,M,11,3229074,15776
15435,Jinan,F,11,3229085,15464
15436,Joellen,F,11,3229096,15737
15437,Johnell,M,11,3229107,15031
15438,Joline,F,11,3229118,15117
15439,Jony,M,11,3229129,15018
15440,Jordie,F,11,3229140,15277
15441,Jorgia,F,11,3229151,15851
15442,Josian,M,11,3229162,15957
15443,Josseline,F,11,3229173,15203
15444,Jovonni,M,11,3229184,15883
15445,Joziel,M,11,3229195,15275
15446,Judi,F,11,3229206,15356
15447,Juliany,F,11,3229217,15868
15448,Jullien,M,11,3229228,15497
15449,Jurney,F,11,3229239,15272
15450,Jynesis,F,11,3229250,15586
15451,Kabria,F,11,3229261,15663
15452,Kaceon,M,11,3229272,15253
15453,Kadon,M,11,3229283,15314
15454,Kaeo,M,11,3229294,15427
15455,Kaiana,F,11,3229305,15262
15456,Kailahni,F,11,3229316,15859
15457,Kaileb,M,11,3229327,15519
15458,Kailie,F,11,3229338,15781
15459,Kaimir,M,11,3229349,15381
15460,Kaion,M,11,3229360,15003
15461,Kairen,M,11,3229371,15294
15462,Kaisha,F,11,3229382,15325
15463,Kaiven,M,11,3229393,15206
15464,Kaiyon,M,11,3229404,15343
15465,Kaleiah,F,11,3229415,15157
15466,Kalev,M,11,3229426,15927
15467,Kalijah,M,11,3229437,15143
15468,Kalirose,F,11,3229448,15104
15469,Kallista,F,11,3229459,15563
15470,Kalyssa,F,11,3229470,15005
15471,Kamilia,F,11,3229481,15634
15472,Kamon,M,11,3229492,15723
15473,Kanari,F,11,3229503,15155
15474,Kanylah,F,11,3229514,15433
15475,Karel,M,11,3229525,15510
15476,Karelyn,F,11,3229536,15209
15477,Karman,F,11,3229547,15313
15478,Karolyne,F,11,3229558,15657
15479,Karri,F,11,3229569,15947
15480,Karyna,F,11,3229580,15890
15481,Karys,F,11,3229591,15252
15482,Kasra,M,11,3229602,15480
15483,Katai,M,11,3229613,15509
15484,Kathlyn,F,11,3229624,15049
15485,Kathrynn,F,11,3229635,15042
15486,Katriel,F,11,3229646,15835
15487,Kayal,F,11,3229657,15677
15488,Kayton,M,11,3229668,15569
15489,Keala,F,11,3229679,15978
15490,Kealohilani,F,11,3229690,15382
15491,Keerat,F,11,3229701,15718
15492,Keita,M,11,3229712,15624
15493,Keivon,M,11,3229723,15962
15494,Kelian,M,11,3229734,15541
15495,Kelsee,F,11,3229745,15408
15496,Kemara,F,11,3229756,15777
15497,Kenden,M,11,3229767,15549
15498,Kendrik,M,11,3229778,15230
15499,Kenlynn,F,11,3229789,15494
15500,Kennadee,F,11,3229800,15768
15501,Keno,M,11,3229811,15952
15502,Kevan,M,11,3229822,15465
15503,Keyana,F,11,3229833,15604
15504,Khalina,F,11,3229844,15401
15505,Khamani,M,11,3229855,15546
15506,Khary,M,11,3229866,15110
15507,Khase,M,11,3229877,15589
15508,Khassidy,F,11,3229888,15000
15509,Khepri,M,11,3229899,15404
15510,Khing,M,11,3229910,15866
15511,Khris,M,11,3229921,15707
15512,Khyir,M,11,3229932,15594
15513,Khylon,M,11,3229943,15274
15514,Kiel,M,11,3229954,15438
15515,Kimberlin,F,11,3229965,15749
15516,Kimiyah,F,11,3229976,15243
15517,Kindle,F,11,3229987,15801
15518,Kingson,M,11,3229998,15298
15519,Kinzee,F,11,3230009,15397
15520,Kirpa,F,11,3230020,15874
15521,Klea,F,11,3230031,15410
15522,Kloee,F,11,3230042,15475
15523,Knolan,M,11,3230053,15025
15524,Knova,F,11,3230064,15057
15525,Kohana,F,11,3230075,15571
15526,Kojo,M,11,3230086,15872
15527,Koleman,M,11,3230097,15046
15528,Kolesyn,M,11,3230108,15766
15529,Konstance,F,11,3230119,15437
15530,Korea,F,11,3230130,15901
15531,Korrie,F,11,3230141,15526
15532,Kortlyn,F,11,3230152,15159
15533,Kortney,F,11,3230163,15082
15534,Koston,M,11,3230174,15821
15535,Kourtlyn,F,11,3230185,15575
15536,Kourtlynn,F,11,3230196,15106
15537,Kouture,F,11,3230207,15379
15538,Krithika,F,11,3230218,15581
15539,Kwynn,F,11,3230229,15231
15540,Kyliana,F,11,3230240,15098
15541,Kyliyah,F,11,3230251,15056
15542,Kymberly,F,11,3230262,15168
15543,Kynnadi,F,11,3230273,15944
15544,Kyris,M,11,3230284,15247
15545,Kyroh,M,11,3230295,15062
15546,Laiklynn,F,11,3230306,15044
15547,Lailee,F,11,3230317,15288
15548,Laityn,F,11,3230328,15613
15549,Lamiah,F,11,3230339,15910
15550,Lamier,M,11,3230350,15680
15551,Lamyah,F,11,3230361,15554
15552,Lany,F,11,3230372,15028
15553,Lasya,F,11,3230383,15264
15554,Latifah,F,11,3230394,15794
15555,Lauralee,F,11,3230405,15818
15556,Lavanya,F,11,3230416,15380
15557,Laylee,F,11,3230427,15715
15558,Laylynn,F,11,3230438,15722
15559,Layn,M,11,3230449,15676
15560,Layonna,F,11,3230460,15417
15561,Leannah,F,11,3230471,15462
15562,Leelyn,M,11,3230482,15409
15563,Leilanny,F,11,3230493,15797
15564,Leiliana,F,11,3230504,15633
15565,Lenix,M,11,3230515,15226
15566,Lennex,M,11,3230526,15854
15567,Les,M,11,3230537,15803
15568,Levee,F,11,3230548,15212
15569,Leven,M,11,3230559,15033
15570,Lexxi,F,11,3230570,15568
15571,Leyanna,F,11,3230581,15560
15572,Liberti,F,11,3230592,15292
15573,Lilja,F,11,3230603,15641
15574,Linnaea,F,11,3230614,15630
15575,Lisanna,F,11,3230625,15574
15576,Lizmarie,F,11,3230636,15681
15577,Loa,F,11,3230647,15384
15578,Lochlynn,F,11,3230658,15316
15579,Loralee,F,11,3230669,15192
15580,Loreli,F,11,3230680,15225
15581,Lorien,F,11,3230691,15096
15582,Lorraina,F,11,3230702,15669
15583,Loveah,F,11,3230713,15806
15584,Luzma,F,11,3230724,15240
15585,Lylia,F,11,3230735,15686
15586,Lyniah,F,11,3230746,15435
15587,Lynkin,M,11,3230757,15646
15588,Lyria,F,11,3230768,15083
15589,Maat,F,11,3230779,15407
15590,Macai,M,11,3230790,15066
15591,Maddalynn,F,11,3230801,15461
15592,Maebelle,F,11,3230812,15237
15593,Mahmud,M,11,3230823,15935
15594,Maicol,M,11,3230834,15123
15595,Maija,F,11,3230845,15750
15596,Maisel,F,11,3230856,15375
15597,Majestee,F,11,3230867,15614
15598,Majestic,M,11,3230878,15350
15599,Makani,M,11,3230889,15653
15600,Makenley,F,11,3230900,15121
15601,Makeyla,F,11,3230911,15648
15602,Makkah,F,11,3230922,15961
15603,Makynna,F,11,3230933,15696
15604,Malahki,M,11,3230944,15972
15605,Malala,F,11,3230955,15623
15606,Malerie,F,11,3230966,15877
15607,Malonie,F,11,3230977,15354
15608,Manas,M,11,3230988,15885
15609,Manav,M,11,3230999,15746
15610,Manoah,M,11,3231010,15852
15611,Mar,F,11,3231021,15736
15612,Maranda,F,11,3231032,15557
15613,Marcio,M,11,3231043,15837
15614,Margareth,F,11,3231054,15406
15615,Margret,F,11,3231065,15628
15616,Mariaeduarda,F,11,3231076,15394
15617,Mariapaula,F,11,3231087,15431
15618,Marik,M,11,3231098,15445
15619,Marilu,F,11,3231109,15452
15620,Mariona,F,11,3231120,15950
15621,Markan,F,11,3231131,15632
15622,Marlayah,F,11,3231142,15455
15623,Marlayna,F,11,3231153,15791
15624,Marlea,F,11,3231164,15011
15625,Marleah,F,11,3231175,15207
15626,Marti,F,11,3231186,15215
15627,Maryalice,F,11,3231197,15043
15628,Marylee,F,11,3231208,15419
15629,Marzia,F,11,3231219,15498
15630,Masin,M,11,3231230,15097
15631,Mattew,M,11,3231241,15364
15632,Matti,F,11,3231252,15728
15633,Mavi,M,11,3231263,15425
15634,Maxxon,M,11,3231274,15566
15635,Maybel,F,11,3231285,15524
15636,Mayley,F,11,3231296,15661
15637,Maynard,M,11,3231307,15891
15638,Mayzee,F,11,3231318,15072
15639,Maziah,F,11,3231329,15795
15640,Mazzi,M,11,3231340,15937
15641,Mckennah,F,11,3231351,15583
15642,Meba,M,11,3231362,15365
15643,Meilany,F,11,3231373,15965
15644,Melanin,F,11,3231384,15684
15645,Melena,F,11,3231395,15738
15646,Meloni,F,11,3231406,15792
15647,Messi,M,11,3231417,15713
15648,Michai,M,11,3231428,15388
15649,Midori,F,11,3231439,15598
15650,Mikella,F,11,3231450,15685
15651,Mikeyla,F,11,3231461,15949
15652,Mikolaj,M,11,3231472,15512
15653,Milany,F,11,3231483,15668
15654,Mio,F,11,3231494,15248
15655,Miraal,F,11,3231505,15780
15656,Miray,F,11,3231516,15708
15657,Mishal,F,11,3231527,15706
15658,Missy,F,11,3231538,15428
15659,Miyuki,F,11,3231549,15038
15660,Momin,M,11,3231560,15922
15661,Montel,M,11,3231571,15387
15662,Morelia,F,11,3231582,15966
15663,Morghan,F,11,3231593,15204
15664,Moxley,M,11,3231604,15894
15665,Mubashir,M,11,3231615,15558
15666,Mudasir,M,11,3231626,15308
15667,Munachi,F,11,3231637,15518
15668,Munasar,M,11,3231648,15152
15669,Mustapha,M,11,3231659,15100
15670,Mylen,M,11,3231670,15395
15671,Naithan,M,11,3231681,15449
15672,Najat,F,11,3231692,15564
15673,Nalaia,F,11,3231703,15224
15674,Nalanie,F,11,3231714,15014
15675,Nalea,F,11,3231725,15378
15676,Naledi,F,11,3231736,15982
15677,Naleya,F,11,3231747,15946
15678,Namiah,F,11,3231758,15753
15679,Naomii,F,11,3231769,15194
15680,Nare,F,11,3231780,15214
15681,Nastassia,F,11,3231791,15164
15682,Natalija,F,11,3231802,15584
15683,Nataliyah,F,11,3231813,15468
15684,Navey,F,11,3231824,15591
15685,Navon,M,11,3231835,15808
15686,Nayleah,F,11,3231846,15530
15687,Nazaire,M,11,3231857,15654
15688,Nazaret,F,11,3231868,15945
15689,Nazim,M,11,3231879,15220
15690,Nefeli,F,11,3231890,15860
15691,Nene,F,11,3231901,15271
15692,Neviah,F,11,3231912,15741
15693,Newt,M,11,3231923,15486
15694,Neylani,F,11,3231934,15513
15695,Neziah,M,11,3231945,15068
15696,Nicholaus,M,11,3231956,15200
15697,Nicholi,M,11,3231967,15787
15698,Nicko,M,11,3231978,15816
15699,Nihan,F,11,3231989,15391
15700,Nishan,M,11,3232000,15119
15701,Nixxon,M,11,3232011,15451
15702,Niyati,F,11,3232022,15053
15703,Noha,F,11,3232033,15977
15704,Nohely,F,11,3232044,15720
15705,Noorseen,F,11,3232055,15282
15706,Novalea,F,11,3232066,15786
15707,Novareign,F,11,3232077,15610
15708,Nurvi,F,11,3232088,15307
15709,Nyaira,F,11,3232099,15902
15710,Nyeem,M,11,3232110,15420
15711,Nyko,M,11,3232121,15321
15712,Nylaa,F,11,3232132,15917
15713,Nyliah,F,11,3232143,15834
15714,Obinna,M,11,3232154,15466
15715,Obsidian,M,11,3232165,15086
15716,Odis,M,11,3232176,15853
15717,Olamide,M,11,3232187,15296
15718,Olena,F,11,3232198,15924
15719,Oli,M,11,3232209,15850
15720,Oliwia,F,11,3232220,15424
15721,Oneil,M,11,3232231,15373
15722,Oni,F,11,3232242,15995
15723,Oniel,M,11,3232253,15691
15724,Orchid,F,11,3232264,15618
15725,Oriel,M,11,3232275,15587
15726,Oxley,M,11,3232286,15582
15727,Padraig,M,11,3232297,15358
15728,Paisli,F,11,3232308,15704
15729,Pasquale,M,11,3232319,15985
15730,Patsy,F,11,3232330,15660
15731,Peach,F,11,3232341,15334
15732,Peregrin,M,11,3232352,15470
15733,Peyten,F,11,3232363,15259
15734,Phenyx,F,11,3232374,15340
15735,Philemon,M,11,3232385,15693
15736,Phynix,F,11,3232396,15116
15737,Pinchos,M,11,3232407,15318
15738,Polo,M,11,3232418,15864
15739,Pragya,F,11,3232429,15603
15740,Pranika,F,11,3232440,15755
15741,Pranshi,F,11,3232451,15447
15742,Pratham,M,11,3232462,15911
15743,Quinnly,F,11,3232473,15483
15744,Quintavious,M,11,3232484,15711
15745,Qusay,M,11,3232495,15180
15746,Raayan,M,11,3232506,15370
15747,Raea,F,11,3232517,15245
15748,Raed,M,11,3232528,15183
15749,Raelah,F,11,3232539,15260
15750,Raelan,F,11,3232550,15784
15751,Rahiem,M,11,3232561,15430
15752,Rahsaan,M,11,3232572,15263
15753,Raini,F,11,3232583,15802
15754,Ramelo,M,11,3232594,15538
15755,Ramiah,F,11,3232605,15577
15756,Ramier,M,11,3232616,15170
15757,Ramoni,F,11,3232627,15870
15758,Ranbir,M,11,3232638,15542
15759,Rapheal,M,11,3232649,15109
15760,Rashaud,M,11,3232660,15820
15761,Rasheem,M,11,3232671,15748
15762,Rasul,M,11,3232682,15041
15763,Rayanne,F,11,3232693,15805
15764,Raynah,F,11,3232704,15039
15765,Raynie,F,11,3232715,15878
15766,Rayshaun,M,11,3232726,15139
15767,Rayson,M,11,3232737,15915
15768,Rediet,F,11,3232748,15295
15769,Rees,M,11,3232759,15845
15770,Regis,M,11,3232770,15856
15771,Reiley,F,11,3232781,15898
15772,Reizy,F,11,3232792,15171
15773,Renan,M,11,3232803,15692
15774,Revere,M,11,3232814,15270
15775,Reynold,M,11,3232825,15815
15776,Rhaella,F,11,3232836,15181
15777,Rhilynn,F,11,3232847,15146
15778,Rhona,F,11,3232858,15819
15779,Rhylei,F,11,3232869,15279
15780,Rhylynn,F,11,3232880,15841
15781,Ricco,M,11,3232891,15552
15782,Rielyn,F,11,3232902,15928
15783,Rigdon,M,11,3232913,15429
15784,Righteous,M,11,3232924,15129
15785,Rigley,M,11,3232935,15842
15786,Rihana,F,11,3232946,15899
15787,Riott,M,11,3232957,15448
15788,Rishiv,M,11,3232968,15377
15789,Roc,M,11,3232979,15500
15790,Rocko,M,11,3232990,15148
15791,Rohit,M,11,3233001,15608
15792,Rollin,M,11,3233012,15861
15793,Roniya,F,11,3233023,15665
15794,Rosamaria,F,11,3233034,15627
15795,Rosanne,F,11,3233045,15278
15796,Royelle,F,11,3233056,15173
15797,Rozalia,F,11,3233067,15234
15798,Ruah,F,11,3233078,15065
15799,Ruaraidh,M,11,3233089,15545
15800,Rubani,F,11,3233100,15588
15801,Rufino,M,11,3233111,15531
15802,Rukia,F,11,3233122,15432
15803,Ruqaya,F,11,3233133,15716
15804,Ryelee,F,11,3233144,15507
15805,Saafir,M,11,3233155,15285
15806,Saahil,M,11,3233166,15179
15807,Saban,M,11,3233177,15133
15808,Sael,M,11,3233188,15521
15809,Safari,F,11,3233199,15114
15810,Saia,F,11,3233210,15688
15811,Saidy,F,11,3233221,15051
15812,Saim,M,11,3233232,15932
15813,Saima,F,11,3233243,15543
15814,Saivon,M,11,3233254,15936
15815,Saje,F,11,3233265,15258
15816,Sakinah,F,11,3233276,15886
15817,Salaya,F,11,3233287,15849
15818,Sanaiya,F,11,3233298,15551
15819,Sandor,M,11,3233309,15223
15820,Sani,F,11,3233320,15555
15821,Santy,M,11,3233331,15703
15822,Sarae,F,11,3233342,15290
15823,Sarahann,F,11,3233353,15579
15824,Sarkis,M,11,3233364,15177
15825,Satya,F,11,3233375,15484
15826,Saverio,M,11,3233386,15084
15827,Sayan,M,11,3233397,15094
15828,Sayvion,M,11,3233408,15444
15829,Scarlytt,F,11,3233419,15208
15830,Sefora,F,11,3233430,15907
15831,Semir,M,11,3233441,15310
15832,Sender,M,11,3233452,15644
15833,Seraiah,F,11,3233463,15351
15834,Shad,M,11,3233474,15403
15835,Shahad,F,11,3233485,15694
15836,Shahzad,M,11,3233496,15700
15837,Shahzain,M,11,3233507,15416
15838,Shamira,F,11,3233518,15615
15839,Shamiya,F,11,3233529,15931
15840,Shamiyah,F,11,3233540,15862
15841,Sharvi,F,11,3233551,15216
15842,Sharvil,M,11,3233562,15021
15843,Shasta,F,11,3233573,15757
15844,Shelbi,F,11,3233584,15190
15845,Shilah,F,11,3233595,15942
15846,Shloima,M,11,3233606,15979
15847,Shrihaan,M,11,3233617,15514
15848,Shylynn,F,11,3233628,15572
15849,Siani,F,11,3233639,15423
15850,Sibley,F,11,3233650,15929
15851,Sidratul,F,11,3233661,15814
15852,Sinead,F,11,3233672,15037
15853,Siomara,F,11,3233683,15460
15854,Skender,M,11,3233694,15472
15855,Skylinn,F,11,3233705,15912
15856,Sneha,F,11,3233716,15896
15857,Sofiah,F,11,3233727,15122
15858,Solomiya,F,11,3233738,15810
15859,Spruha,F,11,3233749,15597
15860,Stafford,M,11,3233760,15986
15861,Stormee,F,11,3233771,15063
15862,Sua,F,11,3233782,15638
15863,Suhas,M,11,3233793,15532
15864,Sumner,M,11,3233804,15456
15865,Synthia,F,11,3233815,15091
15866,Taher,M,11,3233826,15389
15867,Tahmir,M,11,3233837,15336
15868,Taji,M,11,3233848,15525
15869,Takumi,M,11,3233859,15061
15870,Tallula,F,11,3233870,15889
15871,Tamina,F,11,3233881,15858
15872,Tanaya,F,11,3233892,15162
15873,Taqwa,F,11,3233903,15166
15874,Tavi,F,11,3233914,15058
15875,Tayana,F,11,3233925,15585
15876,Tayten,M,11,3233936,15069
15877,Tayvin,M,11,3233947,15601
15878,Teah,F,11,3233958,15024
15879,Teighlor,F,11,3233969,15695
15880,Teon,M,11,3233980,15436
15881,Terriana,F,11,3233991,15013
15882,Terron,M,11,3234002,15963
15883,Teuila,F,11,3234013,15030
15884,Texas,M,11,3234024,15759
15885,Thoren,M,11,3234035,15559
15886,Tiegan,F,11,3234046,15779
15887,Tien,M,11,3234057,15457
15888,Tiffani,F,11,3234068,15832
15889,Timberlee,F,11,3234079,15006
15890,Timberly,F,11,3234090,15767
15891,Tinzley,F,11,3234101,15869
15892,Tiya,F,11,3234112,15908
15893,Tomasz,M,11,3234123,15690
15894,Toussaint,M,11,3234134,15399
15895,Tove,F,11,3234145,15752
15896,Traevon,M,11,3234156,15008
15897,Traniyah,F,11,3234167,15650
15898,Trevaughn,M,11,3234178,15595
15899,Treveon,M,11,3234189,15302
15900,Tryston,M,11,3234200,15019
15901,Tuleen,F,11,3234211,15683
15902,Tulio,M,11,3234222,15609
15903,Tylasia,F,11,3234233,15702
15904,Tyliah,F,11,3234244,15596
15905,Tyliyah,F,11,3234255,15992
15906,Tysean,M,11,3234266,15141
15907,Tyshun,M,11,3234277,15426
15908,Tzipporah,F,11,3234288,15015
15909,Urias,M,11,3234299,15078
15910,Urie,M,11,3234310,15335
15911,Vadhir,M,11,3234321,15045
15912,Valeri,F,11,3234332,15090
15913,Varenya,F,11,3234343,15256
15914,Varshini,F,11,3234354,15235
15915,Vaughan,M,11,3234365,15655
15916,Vedanshi,F,11,3234376,15482
15917,Velvet,F,11,3234387,15315
15918,Ventus,M,11,3234398,15612
15919,Viaansh,M,11,3234409,15602
15920,Viansh,M,11,3234420,15174
15921,Vickie,F,11,3234431,15511
15922,Vinicius,M,11,3234442,15679
15923,Vinnie,M,11,3234453,15710
15924,Vishaan,M,11,3234464,15085
15925,Vitaly,M,11,3234475,15782
15926,Warrior,M,11,3234486,15080
15927,Wasim,M,11,3234497,15145
15928,Whyatt,M,11,3234508,15991
15929,Wilhemina,F,11,3234519,15934
15930,Wrynn,F,11,3234530,15188
15931,Wyler,M,11,3234541,15699
15932,Wyman,M,11,3234552,15734
15933,Xain,M,11,3234563,15765
15934,Xaviar,M,11,3234574,15863
15935,Xaylen,M,11,3234585,15309
15936,Xerxes,M,11,3234596,15527
15937,Xinyi,F,11,3234607,15553
15938,Xya,F,11,3234618,15562
15939,Xyler,M,11,3234629,15645
15940,Xzavien,M,11,3234640,15118
15941,Xzayvier,M,11,3234651,15951
15942,Yachet,F,11,3234662,15727
15943,Yamilett,F,11,3234673,15471
15944,Yamilette,F,11,3234684,15721
15945,Yaquelin,F,11,3234695,15320
15946,Yarelin,F,11,3234706,15405
15947,Yashua,M,11,3234717,15217
15948,Yasira,F,11,3234728,15651
15949,Yasmani,M,11,3234739,15897
15950,Yassine,M,11,3234750,15580
15951,Yazid,M,11,3234761,15346
15952,Yerachmiel,M,11,3234772,15769
15953,Yiming,M,11,3234783,15250
15954,Yiyang,M,11,3234794,15829
15955,Yocelin,F,11,3234805,15751
15956,Yochanan,M,11,3234816,15747
15957,Yohann,M,11,3234827,15333
15958,Yoona,F,11,3234838,15156
15959,Yordani,M,11,3234849,15273
15960,Yuan,M,11,3234860,15790
15961,Yugan,M,11,3234871,15009
15962,Yuli,F,11,3234882,15493
15963,Yuliet,F,11,3234893,15283
15964,Yuriana,F,11,3234904,15328
15965,Yuvansh,M,11,3234915,15973
15966,Yves,M,11,3234926,15976
15967,Yvonna,F,11,3234937,15631
15968,Zaha,F,11,3234948,15077
15969,Zahirah,F,11,3234959,15762
15970,Zahria,F,11,3234970,15020
15971,Zaidy,F,11,3234981,15491
15972,Zakhai,M,11,3234992,15640
15973,Zalena,F,11,3235003,15534
15974,Zamayah,F,11,3235014,15241
15975,Zanya,F,11,3235025,15242
15976,Zanyia,F,11,3235036,15115
15977,Zaviah,F,11,3235047,15517
15978,Zea,F,11,3235058,15093
15979,Zebulun,M,11,3235069,15197
15980,Zel,M,11,3235080,15778
15981,Zela,F,11,3235091,15914
15982,Zelah,F,11,3235102,15617
15983,Zellie,F,11,3235113,15059
15984,Zenna,F,11,3235124,15592
15985,Zephan,M,11,3235135,15892
15986,Zeplin,M,11,3235146,15796
15987,Zhion,M,11,3235157,15300
15988,Ziair,M,11,3235168,15257
15989,Zissel,F,11,3235179,15265
15990,Zohaib,M,11,3235190,15446
15991,Zohra,F,11,3235201,15729
15992,Zolah,F,11,3235212,15458
15993,Zowie,F,11,3235223,15485
15994,Zuly,F,11,3235234,15652
15995,Zurii,F,11,3235245,15621
15996,Zy,M,11,3235256,15981
15997,Zyden,M,11,3235267,15888
15998,Zyeir,M,11,3235278,15167
15999,Aadith,M,10,3235288,15826
16000,Aala,F,10,3235298,16609
16001,Aaliyan,M,10,3235308,16917
16002,Aalyiah,F,10,3235318,16170
16003,Aaris,M,10,3235328,16119
16004,Aaryah,F,10,3235338,16865
16005,Aashritha,F,10,3235348,16972
16006,Aason,M,10,3235358,16392
16007,Aavyan,M,10,3235368,16304
16008,Abdifatah,M,10,3235378,16685
16009,Abdinasir,M,10,3235388,16862
16010,Abdulkareem,M,10,3235398,16702
16011,Abrahim,M,10,3235408,16127
16012,Abria,F,10,3235418,16798
16013,Abrie,F,10,3235428,16858
16014,Adabella,F,10,3235438,16551
16015,Addiel,M,10,3235448,16596
16016,Addileigh,F,10,3235458,16834
16017,Addonis,M,10,3235468,16439
16018,Adeel,M,10,3235478,16315
16019,Adeola,F,10,3235488,16510
16020,Adirah,F,10,3235498,16080
16021,Adlynn,F,10,3235508,16395
16022,Adreana,F,10,3235518,16734
16023,Adriela,F,10,3235528,16067
16024,Adylynn,F,10,3235538,16824
16025,Aeiress,F,10,3235548,16666
16026,Aesir,M,10,3235558,16054
16027,Afifa,F,10,3235568,16212
16028,Agustus,M,10,3235578,16146
16029,Ahanu,M,10,3235588,16583
16030,Ahil,M,10,3235598,16580
16031,Ahlana,F,10,3235608,16491
16032,Ahmaya,F,10,3235618,16674
16033,Ahmeer,M,10,3235628,16391
16034,Ahmod,M,10,3235638,16038
16035,Ai,F,10,3235648,16902
16036,Aidden,M,10,3235658,16526
16037,Aidin,M,10,3235668,16282
16038,Airah,F,10,3235678,16832
16039,Airyanna,F,10,3235688,16921
16040,Aiyanah,F,10,3235698,16479
16041,Akilan,M,10,3235708,16065
16042,Akiya,F,10,3235718,16291
16043,Akylah,F,10,3235728,16610
16044,Alabama,F,10,3235738,16918
16045,Alaena,F,10,3235748,16781
16046,Alaria,F,10,3235758,16172
16047,Albion,M,10,3235768,16909
16048,Alcides,M,10,3235778,16060
16049,Alejo,M,10,3235788,16961
16050,Alene,F,10,3235798,16498
16051,Alesandro,M,10,3235808,16227
16052,Aleta,F,10,3235818,16431
16053,Aletha,F,10,3235828,16679
16054,Alexandr,M,10,3235838,16486
16055,Alicja,F,10,3235848,16139
16056,Alik,M,10,3235858,16853
16057,Alin,F,10,3235868,16690
16058,Alinea,F,10,3235878,16777
16059,Alishba,F,10,3235888,16787
16060,Alisyn,F,10,3235898,16611
16061,Aliviana,F,10,3235908,16105
16062,Alivianna,F,10,3235918,16272
16063,Aliviya,F,10,3235928,16562
16064,Alixander,M,10,3235938,16898
16065,Aliyas,M,10,3235948,16168
16066,Allani,F,10,3235958,16765
16067,Allianna,F,10,3235968,16606
16068,Allyn,M,10,3235978,16846
16069,Aloy,F,10,3235988,16523
16070,Alyn,F,10,3235998,16923
16071,Amabella,F,10,3236008,16761
16072,Amairah,F,10,3236018,16029
16073,Amazin,F,10,3236028,16631
16074,Ameilia,F,10,3236038,16943
16075,Amelina,F,10,3236048,16198
16076,Ameriah,F,10,3236058,16693
16077,Ammara,F,10,3236068,16558
16078,Amoria,F,10,3236078,16010
16079,Amrutha,F,10,3236088,16459
16080,Amyrical,F,10,3236098,16539
16081,Anabelen,F,10,3236108,16673
16082,Anah,F,10,3236118,16914
16083,Anahlia,F,10,3236128,16021
16084,Anaiz,F,10,3236138,16774
16085,Analena,F,10,3236148,16967
16086,Analie,F,10,3236158,16265
16087,Anarose,F,10,3236168,16145
16088,Anastacio,M,10,3236178,16980
16089,Anastazja,F,10,3236188,16047
16090,Anayiah,F,10,3236198,16543
16091,Ancel,M,10,3236208,16795
16092,Andelyn,F,10,3236218,16848
16093,Andon,M,10,3236228,16686
16094,Andriel,M,10,3236238,16143
16095,Andriy,M,10,3236248,16828
16096,Andru,M,10,3236258,16238
16097,Anelise,F,10,3236268,16340
16098,Anevay,F,10,3236278,16018
16099,Angelino,M,10,3236288,16134
16100,Angeliz,F,10,3236298,16386
16101,Angelle,F,10,3236308,16399
16102,Angelynn,F,10,3236318,16442
16103,Anise,F,10,3236328,16033
16104,Anjelica,F,10,3236338,16149
16105,Annais,F,10,3236348,16379
16106,Annaleia,F,10,3236358,16305
16107,Annalena,F,10,3236368,16138
16108,Annasofia,F,10,3236378,16072
16109,Ansen,M,10,3236388,16167
16110,Anthoni,M,10,3236398,16633
16111,Antwain,M,10,3236408,16463
16112,Anzlee,F,10,3236418,16991
16113,Aodhan,M,10,3236428,16163
16114,Aous,M,10,3236438,16598
16115,Apollos,M,10,3236448,16483
16116,Apolo,M,10,3236458,16527
16117,Aqeel,M,10,3236468,16650
16118,Arcadio,M,10,3236478,16951
16119,Arek,M,10,3236488,16097
16120,Argenis,M,10,3236498,16113
16121,Arihanna,F,10,3236508,16400
16122,Arista,F,10,3236518,16214
16123,Ariyel,F,10,3236528,16183
16124,Ariz,M,10,3236538,16492
16125,Arlena,F,10,3236548,16482
16126,Arnell,M,10,3236558,16802
16127,Arora,F,10,3236568,16552
16128,Arshiya,F,10,3236578,16000
16129,Artemus,M,10,3236588,16839
16130,Aryav,M,10,3236598,16554
16131,Asaf,M,10,3236608,16144
16132,Asaun,M,10,3236618,16752
16133,Asenath,F,10,3236628,16426
16134,Ashford,M,10,3236638,16840
16135,Ashvika,F,10,3236648,16641
16136,Aslynn,F,10,3236658,16445
16137,Asyah,F,10,3236668,16039
16138,Athyna,F,10,3236678,16155
16139,Aubre,F,10,3236688,16623
16140,Aubreyanna,F,10,3236698,16735
16141,Audyn,F,10,3236708,16407
16142,Aunesti,F,10,3236718,16247
16143,Autumnrose,F,10,3236728,16489
16144,Avaa,F,10,3236738,16809
16145,Avaiya,F,10,3236748,16023
16146,Avalene,F,10,3236758,16245
16147,Avayla,F,10,3236768,16576
16148,Avel,M,10,3236778,16397
16149,Avrumy,M,10,3236788,16874
16150,Avynn,F,10,3236798,16415
16151,Axeton,M,10,3236808,16377
16152,Ayash,M,10,3236818,16974
16153,Ayse,F,10,3236828,16027
16154,Ayvin,M,10,3236838,16636
16155,Ayzlee,F,10,3236848,16354
16156,Azaleigh,F,10,3236858,16192
16157,Azavier,M,10,3236868,16333
16158,Azrah,F,10,3236878,16436
16159,Baden,M,10,3236888,16194
16160,Baelynn,F,10,3236898,16682
16161,Bailyn,F,10,3236908,16782
16162,Baird,M,10,3236918,16406
16163,Barnes,M,10,3236928,16313
16164,Basim,M,10,3236938,16857
16165,Bassy,F,10,3236948,16742
16166,Belicia,F,10,3236958,16357
16167,Bellanie,F,10,3236968,16229
16168,Bellarae,F,10,3236978,16959
16169,Beni,M,10,3236988,16740
16170,Beyonce,F,10,3236998,16506
16171,Biruk,M,10,3237008,16088
16172,Blaike,F,10,3237018,16836
16173,Blain,M,10,3237028,16746
16174,Blessence,F,10,3237038,16404
16175,Blimi,F,10,3237048,16561
16176,Blyss,F,10,3237058,16725
16177,Bohan,M,10,3237068,16197
16178,Bowan,M,10,3237078,16151
16179,Bowe,M,10,3237088,16891
16180,Bracken,M,10,3237098,16723
16181,Braelen,M,10,3237108,16437
16182,Braeley,F,10,3237118,16829
16183,Braun,M,10,3237128,16490
16184,Braydee,F,10,3237138,16441
16185,Breckan,M,10,3237148,16505
16186,Breken,M,10,3237158,16323
16187,Breleigh,F,10,3237168,16901
16188,Brexleigh,F,10,3237178,16237
16189,Breydon,M,10,3237188,16131
16190,Breylan,M,10,3237198,16288
16191,Brionna,F,10,3237208,16768
16192,Bristyl,F,10,3237218,16755
16193,Briyanna,F,10,3237228,16311
16194,Bronwen,F,10,3237238,16708
16195,Brookleigh,F,10,3237248,16283
16196,Brookson,M,10,3237258,16927
16197,Bruk,M,10,3237268,16886
16198,Brylei,F,10,3237278,16006
16199,Brynlei,F,10,3237288,16778
16200,Brysin,M,10,3237298,16349
16201,Brysyn,M,10,3237308,16969
16202,Cadie,F,10,3237318,16253
16203,Caelia,F,10,3237328,16936
16204,Caige,M,10,3237338,16388
16205,Caleel,M,10,3237348,16692
16206,Calel,M,10,3237358,16585
16207,Calhoun,M,10,3237368,16863
16208,Caliann,F,10,3237378,16089
16209,Camdin,M,10,3237388,16255
16210,Camp,M,10,3237398,16713
16211,Candon,M,10,3237408,16153
16212,Caralyn,F,10,3237418,16831
16213,Carlitos,M,10,3237428,16733
16214,Carolann,F,10,3237438,16964
16215,Carolin,F,10,3237448,16467
16216,Cassidi,F,10,3237458,16418
16217,Cassiopeia,F,10,3237468,16654
16218,Cateleya,F,10,3237478,16999
16219,Catelynn,F,10,3237488,16417
16220,Catharine,F,10,3237498,16688
16221,Catie,F,10,3237508,16421
16222,Cayenne,F,10,3237518,16509
16223,Cayli,F,10,3237528,16776
16224,Chaise,M,10,3237538,16599
16225,Chassity,F,10,3237548,16256
16226,Cherysh,F,10,3237558,16711
16227,Chevi,F,10,3237568,16081
16228,Christabella,F,10,3237578,16387
16229,Christophe,M,10,3237588,16298
16230,Ciani,F,10,3237598,16811
16231,Clementina,F,10,3237608,16976
16232,Cornelio,M,10,3237618,16093
16233,Creeden,M,10,3237628,16266
16234,Cressida,F,10,3237638,16055
16235,Cub,M,10,3237648,16520
16236,Cung,M,10,3237658,16983
16237,Daaron,M,10,3237668,16343
16238,Dadrian,M,10,3237678,16707
16239,Daileen,F,10,3237688,16169
16240,Daina,F,10,3237698,16383
16241,Daivon,M,10,3237708,16731
16242,Daja,F,10,3237718,16805
16243,Dalis,F,10,3237728,16001
16244,Dalon,M,10,3237738,16998
16245,Damiana,F,10,3237748,16177
16246,Damond,M,10,3237758,16178
16247,Danay,F,10,3237768,16915
16248,Danger,M,10,3237778,16157
16249,Danish,M,10,3237788,16296
16250,Dannia,F,10,3237798,16073
16251,Dannika,F,10,3237808,16251
16252,Danyela,F,10,3237818,16897
16253,Darel,M,10,3237828,16366
16254,Darianny,F,10,3237838,16285
16255,Darkiel,M,10,3237848,16274
16256,Dartanian,M,10,3237858,16854
16257,Dashton,M,10,3237868,16293
16258,Davinah,F,10,3237878,16022
16259,Dayden,M,10,3237888,16953
16260,Daylah,F,10,3237898,16150
16261,Dayon,M,10,3237908,16513
16262,Daziah,F,10,3237918,16833
16263,Dearius,M,10,3237928,16988
16264,Deem,F,10,3237938,16062
16265,Degan,M,10,3237948,16140
16266,Dehlani,F,10,3237958,16481
16267,Dehlia,F,10,3237968,16176
16268,Deilani,F,10,3237978,16662
16269,Dejour,M,10,3237988,16454
16270,Delayna,F,10,3237998,16165
16271,Deleon,M,10,3238008,16076
16272,Delfino,M,10,3238018,16457
16273,Delicia,F,10,3238028,16689
16274,Demaya,F,10,3238038,16480
16275,Demere,M,10,3238048,16215
16276,Demetra,F,10,3238058,16264
16277,Demitria,F,10,3238068,16514
16278,Demontae,M,10,3238078,16537
16279,Demri,F,10,3238088,16995
16280,Denae,F,10,3238098,16443
16281,Denna,F,10,3238108,16687
16282,Derya,F,10,3238118,16822
16283,Desta,F,10,3238128,16433
16284,Destani,F,10,3238138,16911
16285,Devaeh,F,10,3238148,16700
16286,Devanny,F,10,3238158,16605
16287,Devanshi,F,10,3238168,16389
16288,Devonna,F,10,3238178,16225
16289,Devontay,M,10,3238188,16200
16290,Deyanira,F,10,3238198,16012
16291,Deyjah,F,10,3238208,16152
16292,Dhruvi,F,10,3238218,16588
16293,Diallo,M,10,3238228,16586
16294,Diante,M,10,3238238,16031
16295,Dimitrius,M,10,3238248,16904
16296,Diyari,M,10,3238258,16658
16297,Djeneba,F,10,3238268,16393
16298,Dmarion,M,10,3238278,16470
16299,Dmoni,M,10,3238288,16607
16300,Domanic,M,10,3238298,16595
16301,Dominika,F,10,3238308,16549
16302,Dominion,M,10,3238318,16621
16303,Domonick,M,10,3238328,16086
16304,Donovyn,M,10,3238338,16222
16305,Drevion,M,10,3238348,16195
16306,Duchess,F,10,3238358,16879
16307,Dudley,M,10,3238368,16435
16308,Dusti,F,10,3238378,16582
16309,Dyami,M,10,3238388,16187
16310,Dylynn,F,10,3238398,16612
16311,Eadie,F,10,3238408,16818
16312,Edda,F,10,3238418,16461
16313,Ediany,F,10,3238428,16535
16314,Eduin,M,10,3238438,16759
16315,Edyth,F,10,3238448,16946
16316,Edythe,F,10,3238458,16760
16317,Eilan,M,10,3238468,16462
16318,Eizen,M,10,3238478,16115
16319,Elaysia,F,10,3238488,16408
16320,Elchonon,M,10,3238498,16893
16321,Eldin,M,10,3238508,16234
16322,Eleanna,F,10,3238518,16299
16323,Electra,F,10,3238528,16112
16324,Elek,M,10,3238538,16474
16325,Elhadj,M,10,3238548,16358
16326,Elisabella,F,10,3238558,16851
16327,Eliska,F,10,3238568,16664
16328,Elius,M,10,3238578,16948
16329,Elliannah,F,10,3238588,16511
16330,Ellierose,F,10,3238598,16133
16331,Ellody,F,10,3238608,16962
16332,Eloni,F,10,3238618,16058
16333,Elorah,F,10,3238628,16205
16334,Elvina,F,10,3238638,16478
16335,Emara,F,10,3238648,16235
16336,Emberlynne,F,10,3238658,16896
16337,Emilson,M,10,3238668,16578
16338,Emirah,F,10,3238678,16161
16339,Emlynn,F,10,3238688,16095
16340,Emmalou,F,10,3238698,16516
16341,Emmanual,M,10,3238708,16337
16342,Emmily,F,10,3238718,16930
16343,Empryss,F,10,3238728,16575
16344,Emryk,M,10,3238738,16318
16345,Enzleigh,F,10,3238748,16202
16346,Eoghan,M,10,3238758,16028
16347,Eon,M,10,3238768,16986
16348,Erandy,F,10,3238778,16785
16349,Erdem,M,10,3238788,16125
16350,Erian,M,10,3238798,16979
16351,Erilyn,F,10,3238808,16540
16352,Erilynn,F,10,3238818,16084
16353,Erioluwa,F,10,3238828,16730
16354,Eryk,M,10,3238838,16345
16355,Esias,M,10,3238848,16485
16356,Esta,F,10,3238858,16497
16357,Evania,F,10,3238868,16984
16358,Evannie,F,10,3238878,16880
16359,Eyoab,M,10,3238888,16294
16360,Ezekyel,M,10,3238898,16521
16361,Ezmerelda,F,10,3238908,16773
16362,Fadumo,F,10,3238918,16757
16363,Fantasia,F,10,3238928,16450
16364,Fauna,F,10,3238938,16071
16365,Fayelynn,F,10,3238948,16952
16366,Febe,F,10,3238958,16341
16367,Feras,M,10,3238968,16016
16368,Filipe,M,10,3238978,16367
16369,Fitzwilliam,M,10,3238988,16635
16370,Florencio,M,10,3238998,16468
16371,Florian,M,10,3239008,16228
16372,Fordham,M,10,3239018,16968
16373,Fouad,M,10,3239028,16981
16374,Frantz,M,10,3239038,16786
16375,Gabbi,F,10,3239048,16710
16376,Gabriele,M,10,3239058,16860
16377,Galina,F,10,3239068,16784
16378,Garvin,M,10,3239078,16900
16379,Gates,M,10,3239088,16538
16380,Gatsby,M,10,3239098,16206
16381,Gehrig,M,10,3239108,16597
16382,Genecis,F,10,3239118,16405
16383,Geovanna,F,10,3239128,16602
16384,Gerrard,M,10,3239138,16342
16385,Ghazi,M,10,3239148,16739
16386,Giani,M,10,3239158,16503
16387,Gila,F,10,3239168,16419
16388,Ginna,F,10,3239178,16402
16389,Gissel,F,10,3239188,16803
16390,Gleb,M,10,3239198,16977
16391,Goldyn,F,10,3239208,16656
16392,Graceann,F,10,3239218,16048
16393,Graceleigh,F,10,3239228,16935
16394,Gracelin,F,10,3239238,16522
16395,Gracilyn,F,10,3239248,16617
16396,Grantley,M,10,3239258,16182
16397,Graylin,M,10,3239268,16180
16398,Greysan,M,10,3239278,16622
16399,Griffon,M,10,3239288,16262
16400,Guiliana,F,10,3239298,16838
16401,Gunter,M,10,3239308,16659
16402,Gurman,M,10,3239318,16542
16403,Gustave,M,10,3239328,16218
16404,Hadicha,F,10,3239338,16141
16405,Hailo,F,10,3239348,16353
16406,Halee,F,10,3239358,16721
16407,Halyn,F,10,3239368,16226
16408,Hamdi,F,10,3239378,16385
16409,Hannahgrace,F,10,3239388,16051
16410,Happy,F,10,3239398,16307
16411,Harfateh,M,10,3239408,16644
16412,Harshil,M,10,3239418,16997
16413,Haskell,M,10,3239428,16217
16414,Hassaan,M,10,3239438,16706
16415,Havok,M,10,3239448,16191
16416,Hawwa,F,10,3239458,16306
16417,Hayah,F,10,3239468,16519
16418,Hayla,F,10,3239478,16156
16419,Hazaiah,M,10,3239488,16933
16420,Hazeley,F,10,3239498,16748
16421,Hendryx,M,10,3239508,16965
16422,Henlie,F,10,3239518,16593
16423,Hercules,M,10,3239528,16899
16424,Herson,M,10,3239538,16308
16425,Hinsley,F,10,3239548,16766
16426,Hiromi,F,10,3239558,16819
16427,Hiya,F,10,3239568,16698
16428,Hser,F,10,3239578,16118
16429,Ihan,M,10,3239588,16083
16430,Ikaia,M,10,3239598,16695
16431,Iktan,M,10,3239608,16820
16432,Ileen,F,10,3239618,16347
16433,Iliyah,F,10,3239628,16026
16434,Illyana,F,10,3239638,16753
16435,Ilma,F,10,3239648,16640
16436,Imad,M,10,3239658,16603
16437,Imir,M,10,3239668,16929
16438,Imon,M,10,3239678,16066
16439,Inori,F,10,3239688,16966
16440,Intisar,F,10,3239698,16230
16441,Irys,F,10,3239708,16259
16442,Isabelly,F,10,3239718,16939
16443,Ishaanvi,F,10,3239728,16199
16444,Isileli,M,10,3239738,16475
16445,Islam,M,10,3239748,16056
16446,Isobella,F,10,3239758,16142
16447,Ivannia,F,10,3239768,16545
16448,Ivelle,F,10,3239778,16059
16449,Ivett,F,10,3239788,16954
16450,Ivin,M,10,3239798,16564
16451,Ivoree,F,10,3239808,16232
16452,Izhan,M,10,3239818,16005
16453,Izzabelle,F,10,3239828,16346
16454,Jabin,M,10,3239838,16566
16455,Jac,M,10,3239848,16447
16456,Jacarri,M,10,3239858,16581
16457,Jacek,M,10,3239868,16569
16458,Jachin,M,10,3239878,16203
16459,Jacieon,M,10,3239888,16770
16460,Jacksyn,M,10,3239898,16233
16461,Jadie,F,10,3239908,16881
16462,Jaelene,F,10,3239918,16842
16463,Jaeliana,F,10,3239928,16382
16464,Jahmal,M,10,3239938,16242
16465,Jahn,M,10,3239948,16667
16466,Jaiah,F,10,3239958,16830
16467,Jaiana,F,10,3239968,16529
16468,Jaiel,M,10,3239978,16638
16469,Jaielle,F,10,3239988,16843
16470,Jaisa,F,10,3239998,16591
16471,Jaiveon,M,10,3240008,16905
16472,Jakin,M,10,3240018,16763
16473,Jakyah,F,10,3240028,16173
16474,Jaleia,F,10,3240038,16940
16475,Jalin,M,10,3240048,16684
16476,Jamaine,M,10,3240058,16866
16477,Jamall,M,10,3240068,16244
16478,Jamaree,M,10,3240078,16430
16479,Jamarkus,M,10,3240088,16907
16480,Jamian,M,10,3240098,16727
16481,Jamias,M,10,3240108,16258
16482,Jamori,M,10,3240118,16808
16483,Jamyia,F,10,3240128,16277
16484,Janah,F,10,3240138,16424
16485,Janaiya,F,10,3240148,16960
16486,Janani,F,10,3240158,16726
16487,Janari,M,10,3240168,16719
16488,Janat,F,10,3240178,16696
16489,Janayla,F,10,3240188,16652
16490,Jandiel,M,10,3240198,16123
16491,Janeli,F,10,3240208,16396
16492,Jani,F,10,3240218,16246
16493,Jantzen,M,10,3240228,16451
16494,Janyia,F,10,3240238,16675
16495,Japhet,M,10,3240248,16213
16496,Jaquarius,M,10,3240258,16241
16497,Jaquelyn,F,10,3240268,16729
16498,Jaret,M,10,3240278,16101
16499,Jasia,F,10,3240288,16791
16500,Jasier,M,10,3240298,16924
16501,Jaslin,F,10,3240308,16487
16502,Jasraj,M,10,3240318,16568
16503,Jatavion,M,10,3240328,16414
16504,Jawan,M,10,3240338,16916
16505,Jayjay,M,10,3240348,16004
16506,Jaylanni,F,10,3240358,16328
16507,Jaylina,F,10,3240368,16950
16508,Jayloni,F,10,3240378,16500
16509,Jayvan,M,10,3240388,16344
16510,Jayvier,M,10,3240398,16370
16511,Jazir,M,10,3240408,16546
16512,Jeancarlo,M,10,3240418,16090
16513,Jeannine,F,10,3240428,16280
16514,Jeanpaul,M,10,3240438,16057
16515,Jenavie,F,10,3240448,16890
16516,Jeneen,F,10,3240458,16322
16517,Jenisis,F,10,3240468,16449
16518,Jeniyah,F,10,3240478,16327
16519,Jennika,F,10,3240488,16064
16520,Jennyfer,F,10,3240498,16100
16521,Jeovanny,M,10,3240508,16672
16522,Jeremiyah,M,10,3240518,16009
16523,Jeriko,M,10,3240528,16303
16524,Jerusha,F,10,3240538,16049
16525,Jeshurun,M,10,3240548,16458
16526,Jesica,F,10,3240558,16737
16527,Jeylani,F,10,3240568,16627
16528,Jhenesis,F,10,3240578,16579
16529,Jiayi,F,10,3240588,16330
16530,Jina,F,10,3240598,16678
16531,Jisselle,F,10,3240608,16469
16532,Joannah,F,10,3240618,16738
16533,Joelene,F,10,3240628,16920
16534,Johnni,F,10,3240638,16614
16535,Jonna,F,10,3240648,16985
16536,Josai,M,10,3240658,16207
16537,Josedejesus,M,10,3240668,16261
16538,Josiahs,M,10,3240678,16751
16539,Jove,M,10,3240688,16823
16540,Jovee,F,10,3240698,16352
16541,Jovita,F,10,3240708,16813
16542,Jozelyn,F,10,3240718,16669
16543,Juanmanuel,M,10,3240728,16877
16544,Juhi,F,10,3240738,16416
16545,Julieanna,F,10,3240748,16783
16546,Julionna,F,10,3240758,16970
16547,Juliyah,F,10,3240768,16887
16548,Junius,M,10,3240778,16092
16549,Jurnei,F,10,3240788,16126
16550,Kabella,F,10,3240798,16767
16551,Kadan,M,10,3240808,16024
16552,Kaedence,F,10,3240818,16452
16553,Kaedon,M,10,3240828,16011
16554,Kahaan,M,10,3240838,16870
16555,Kahlaya,F,10,3240848,16326
16556,Kahmir,M,10,3240858,16639
16557,Kaidin,M,10,3240868,16159
16558,Kail,M,10,3240878,16189
16559,Kaire,M,10,3240888,16756
16560,Kaivon,M,10,3240898,16533
16561,Kaiyden,M,10,3240908,16032
16562,Kalai,F,10,3240918,16557
16563,Kaliann,F,10,3240928,16676
16564,Kaliope,F,10,3240938,16661
16565,Kalliopi,F,10,3240948,16438
16566,Kalypso,F,10,3240958,16355
16567,Kalyse,F,10,3240968,16608
16568,Kamarah,F,10,3240978,16971
16569,Kamellia,F,10,3240988,16994
16570,Kamile,F,10,3240998,16637
16571,Kao,M,10,3241008,16814
16572,Kaptain,M,10,3241018,16106
16573,Karielle,F,10,3241028,16137
16574,Karlito,M,10,3241038,16109
16575,Kartik,M,10,3241048,16175
16576,Kaselyn,F,10,3241058,16570
16577,Kashif,M,10,3241068,16160
16578,Kasmir,M,10,3241078,16758
16579,Kaspen,M,10,3241088,16249
16580,Kassiani,F,10,3241098,16162
16581,Kassidee,F,10,3241108,16565
16582,Katelin,F,10,3241118,16872
16583,Kaveon,M,10,3241128,16645
16584,Kawthar,F,10,3241138,16632
16585,Kaylonnie,F,10,3241148,16841
16586,Kaytlin,F,10,3241158,16536
16587,Kayven,M,10,3241168,16409
16588,Kayzen,M,10,3241178,16103
16589,Kazimir,M,10,3241188,16680
16590,Kearie,F,10,3241198,16892
16591,Keera,F,10,3241208,16124
16592,Keerthana,F,10,3241218,16957
16593,Keian,M,10,3241228,16041
16594,Keiari,F,10,3241238,16348
16595,Keirra,F,10,3241248,16806
16596,Keithen,M,10,3241258,16932
16597,Kelce,F,10,3241268,16044
16598,Kelijah,M,10,3241278,16572
16599,Kelilah,F,10,3241288,16931
16600,Keloni,F,10,3241298,16359
16601,Kelsei,F,10,3241308,16648
16602,Kendallyn,F,10,3241318,16135
16603,Kenechukwu,M,10,3241328,16369
16604,Keng,M,10,3241338,16196
16605,Kennard,M,10,3241348,16488
16606,Kennedee,F,10,3241358,16446
16607,Kennen,M,10,3241368,16079
16608,Kensy,F,10,3241378,16129
16609,Kentley,F,10,3241388,16455
16610,Keone,M,10,3241398,16992
16611,Kesley,F,10,3241408,16577
16612,Keyontae,M,10,3241418,16254
16613,Keysi,F,10,3241428,16903
16614,Khady,F,10,3241438,16132
16615,Khaylani,F,10,3241448,16762
16616,Kherington,F,10,3241458,16750
16617,Khilan,M,10,3241468,16845
16618,Khysen,M,10,3241478,16413
16619,Ki,M,10,3241488,16036
16620,Kiano,M,10,3241498,16671
16621,Kila,F,10,3241508,16847
16622,Killua,M,10,3241518,16573
16623,Kimara,F,10,3241528,16574
16624,Kimberleigh,F,10,3241538,16128
16625,Kimmy,F,10,3241548,16077
16626,Kinda,F,10,3241558,16096
16627,Kinzlie,F,10,3241568,16494
16628,Kirtan,M,10,3241578,16772
16629,Kmya,F,10,3241588,16171
16630,Koree,F,10,3241598,16799
16631,Korianna,F,10,3241608,16937
16632,Korrine,F,10,3241618,16697
16633,Kourtland,M,10,3241628,16653
16634,Krissy,F,10,3241638,16002
16635,Kristoffer,M,10,3241648,16381
16636,Krithvik,M,10,3241658,16889
16637,Kriya,F,10,3241668,16741
16638,Krystiana,F,10,3241678,16290
16639,Kwaku,M,10,3241688,16368
16640,Kyanne,F,10,3241698,16094
16641,Kyley,F,10,3241708,16649
16642,Kylyn,F,10,3241718,16518
16643,Kyndle,F,10,3241728,16310
16644,Kynzlei,F,10,3241738,16973
16645,Kypton,M,10,3241748,16403
16646,Kyros,M,10,3241758,16356
16647,Lafayette,M,10,3241768,16800
16648,Lagertha,F,10,3241778,16372
16649,Laiyla,F,10,3241788,16871
16650,Lakendrick,M,10,3241798,16507
16651,Lala,F,10,3241808,16361
16652,Lalo,M,10,3241818,16660
16653,Lambert,M,10,3241828,16185
16654,Lanyah,F,10,3241838,16239
16655,Laraya,F,10,3241848,16179
16656,Lauretta,F,10,3241858,16098
16657,Lavaughn,M,10,3241868,16037
16658,Laveyah,F,10,3241878,16780
16659,Lawsyn,F,10,3241888,16643
16660,Layali,F,10,3241898,16852
16661,Laycie,F,10,3241908,16594
16662,Leeani,F,10,3241918,16476
16663,Leeasia,F,10,3241928,16844
16664,Leelynd,M,10,3241938,16615
16665,Leenah,F,10,3241948,16332
16666,Leili,F,10,3241958,16364
16667,Leisha,F,10,3241968,16665
16668,Lelah,F,10,3241978,16394
16669,Lemmy,M,10,3241988,16625
16670,Leron,M,10,3241998,16715
16671,Lexander,M,10,3242008,16003
16672,Liahna,F,10,3242018,16286
16673,Liamjames,M,10,3242028,16941
16674,Liliani,F,10,3242038,16849
16675,Lindon,M,10,3242048,16289
16676,Livingston,M,10,3242058,16363
16677,Loana,F,10,3242068,16788
16678,Locklan,M,10,3242078,16221
16679,Loralye,F,10,3242088,16319
16680,Lorcan,M,10,3242098,16362
16681,Lorenz,M,10,3242108,16317
16682,Louka,M,10,3242118,16560
16683,Loyd,M,10,3242128,16878
16684,Luann,F,10,3242138,16534
16685,Lulia,F,10,3242148,16236
16686,Luxe,M,10,3242158,16427
16687,Luxx,M,10,3242168,16339
16688,Luzelena,F,10,3242178,16082
16689,Lyda,F,10,3242188,16504
16690,Lyrique,F,10,3242198,16694
16691,Madalyne,F,10,3242208,16070
16692,Madelene,F,10,3242218,16553
16693,Madisynn,F,10,3242228,16210
16694,Maezlyn,F,10,3242238,16384
16695,Maggy,F,10,3242248,16423
16696,Mahima,F,10,3242258,16190
16697,Mahlik,M,10,3242268,16107
16698,Mahrosh,F,10,3242278,16835
16699,Mailynn,F,10,3242288,16703
16700,Mairim,F,10,3242298,16749
16701,Makaia,F,10,3242308,16663
16702,Makaii,M,10,3242318,16270
16703,Makaya,F,10,3242328,16895
16704,Maki,M,10,3242338,16434
16705,Maks,M,10,3242348,16120
16706,Malai,F,10,3242358,16701
16707,Malikhai,M,10,3242368,16279
16708,Manasvi,F,10,3242378,16208
16709,Mandi,F,10,3242388,16320
16710,Maniyah,F,10,3242398,16728
16711,Manreet,F,10,3242408,16769
16712,Marabella,F,10,3242418,16501
16713,Marcon,M,10,3242428,16013
16714,Marena,F,10,3242438,16091
16715,Margarette,F,10,3242448,16136
16716,Mariadejesus,F,10,3242458,16460
16717,Mariaguadalupe,F,10,3242468,16297
16718,Marinette,F,10,3242478,16275
16719,Marisabel,F,10,3242488,16008
16720,Marita,F,10,3242498,16154
16721,Marlaina,F,10,3242508,16547
16722,Marren,F,10,3242518,16186
16723,Marsai,F,10,3242528,16864
16724,Martinez,M,10,3242538,16913
16725,Maryclaire,F,10,3242548,16779
16726,Maryiah,F,10,3242558,16744
16727,Maryjo,F,10,3242568,16240
16728,Marysol,F,10,3242578,16657
16729,Maryuri,F,10,3242588,16360
16730,Masie,F,10,3242598,16130
16731,Masson,M,10,3242608,16532
16732,Matthais,M,10,3242618,16938
16733,Matviy,M,10,3242628,16912
16734,Maximilien,M,10,3242638,16211
16735,Maxston,M,10,3242648,16604
16736,Maykol,M,10,3242658,16975
16737,Maymuna,F,10,3242668,16797
16738,Mays,M,10,3242678,16677
16739,Maytal,F,10,3242688,16050
16740,Mazzie,F,10,3242698,16085
16741,Mccartney,F,10,3242708,16747
16742,Mccrae,M,10,3242718,16947
16743,Mckenzee,F,10,3242728,16148
16744,Mckynzie,F,10,3242738,16046
16745,Meaghan,F,10,3242748,16224
16746,Mechel,M,10,3242758,16014
16747,Meg,F,10,3242768,16563
16748,Meilah,F,10,3242778,16630
16749,Meladee,F,10,3242788,16512
16750,Melaine,F,10,3242798,16110
16751,Melida,F,10,3242808,16718
16752,Melvyn,M,10,3242818,16302
16753,Mely,F,10,3242828,16651
16754,Memori,F,10,3242838,16440
16755,Menna,F,10,3242848,16017
16756,Meri,F,10,3242858,16267
16757,Meritxell,F,10,3242868,16894
16758,Merlyn,F,10,3242878,16867
16759,Merrik,M,10,3242888,16668
16760,Miara,F,10,3242898,16942
16761,Mickael,M,10,3242908,16556
16762,Miela,F,10,3242918,16231
16763,Mihaan,M,10,3242928,16906
16764,Mikaila,F,10,3242938,16620
16765,Mikaya,F,10,3242948,16704
16766,Mikaylah,F,10,3242958,16626
16767,Milcah,F,10,3242968,16116
16768,Milee,F,10,3242978,16996
16769,Mileigh,F,10,3242988,16925
16770,Milliano,M,10,3242998,16471
16771,Miquel,M,10,3243008,16268
16772,Mir,M,10,3243018,16771
16773,Mirela,F,10,3243028,16331
16774,Miro,M,10,3243038,16910
16775,Miryam,F,10,3243048,16019
16776,Miski,F,10,3243058,16374
16777,Mitch,M,10,3243068,16025
16778,Mitra,F,10,3243078,16099
16779,Miylah,F,10,3243088,16448
16780,Mizuki,F,10,3243098,16147
16781,Mj,M,10,3243108,16709
16782,Moani,F,10,3243118,16373
16783,Mohid,M,10,3243128,16453
16784,Mohini,F,10,3243138,16592
16785,Mohsen,M,10,3243148,16466
16786,Moiz,M,10,3243158,16812
16787,Monalisa,F,10,3243168,16764
16788,Moosa,M,10,3243178,16420
16789,Morocco,M,10,3243188,16624
16790,Muaad,M,10,3243198,16716
16791,Muhamed,M,10,3243208,16724
16792,Muhammadamin,M,10,3243218,16792
16793,Muneeb,M,10,3243228,16825
16794,Murdoch,M,10,3243238,16035
16795,Muscab,M,10,3243248,16745
16796,Muzamil,M,10,3243258,16705
16797,Myaire,M,10,3243268,16271
16798,Myalynn,F,10,3243278,16956
16799,Myleah,F,10,3243288,16263
16800,Mylynn,F,10,3243298,16371
16801,Nadja,F,10,3243308,16472
16802,Naeemah,F,10,3243318,16248
16803,Nafi,M,10,3243328,16525
16804,Naiah,F,10,3243338,16882
16805,Nairi,F,10,3243348,16601
16806,Nairn,M,10,3243358,16502
16807,Nakari,F,10,3243368,16816
16808,Nakya,F,10,3243378,16827
16809,Nareh,F,10,3243388,16252
16810,Naser,M,10,3243398,16260
16811,Nataniel,M,10,3243408,16390
16812,Naysha,F,10,3243418,16629
16813,Neer,M,10,3243428,16919
16814,Neisha,F,10,3243438,16810
16815,Nekoda,M,10,3243448,16717
16816,Nelia,F,10,3243458,16958
16817,Neon,M,10,3243468,16982
16818,Nessiah,M,10,3243478,16312
16819,Nicolaus,M,10,3243488,16087
16820,Nikai,M,10,3243498,16324
16821,Nikan,M,10,3243508,16376
16822,Nimrat,F,10,3243518,16714
16823,Nimue,F,10,3243528,16473
16824,Niralya,F,10,3243538,16955
16825,Niyomi,F,10,3243548,16181
16826,Nizar,M,10,3243558,16873
16827,Noga,F,10,3243568,16826
16828,Nohea,F,10,3243578,16040
16829,Noman,M,10,3243588,16515
16830,Noori,F,10,3243598,16188
16831,Nourah,F,10,3243608,16616
16832,Noxx,M,10,3243618,16336
16833,Nuriyah,F,10,3243628,16220
16834,Nyana,F,10,3243638,16869
16835,Nylia,F,10,3243648,16628
16836,Olevia,F,10,3243658,16314
16837,Oliana,F,10,3243668,16108
16838,Olivine,F,10,3243678,16334
16839,Oluwatobiloba,M,10,3243688,16530
16840,Onyxx,M,10,3243698,16335
16841,Othello,M,10,3243708,16987
16842,Ozella,F,10,3243718,16007
16843,Pacen,M,10,3243728,16499
16844,Paighton,F,10,3243738,16712
16845,Paisleyann,F,10,3243748,16281
16846,Patterson,M,10,3243758,16122
16847,Paw,F,10,3243768,16495
16848,Payge,F,10,3243778,16257
16849,Penellope,F,10,3243788,16743
16850,Pernell,M,10,3243798,16075
16851,Perpetua,F,10,3243808,16350
16852,Peterson,M,10,3243818,16158
16853,Pharrell,M,10,3243828,16524
16854,Philo,M,10,3243838,16807
16855,Phoenixx,F,10,3243848,16496
16856,Phong,M,10,3243858,16720
16857,Pius,M,10,3243868,16398
16858,Pola,F,10,3243878,16861
16859,Porsha,F,10,3243888,16201
16860,Praneel,M,10,3243898,16868
16861,Pratt,M,10,3243908,16484
16862,Pria,F,10,3243918,16683
16863,Princetyn,M,10,3243928,16801
16864,Prithvi,M,10,3243938,16790
16865,Providence,F,10,3243948,16464
16866,Pryncess,F,10,3243958,16517
16867,Quavon,M,10,3243968,16069
16868,Quintrell,M,10,3243978,16193
16869,Rad,M,10,3243988,16219
16870,Raef,M,10,3243998,16928
16871,Rafa,M,10,3244008,16425
16872,Rafan,M,10,3244018,16401
16873,Rafsan,M,10,3244028,16292
16874,Ragan,F,10,3244038,16204
16875,Raheim,M,10,3244048,16375
16876,Raissa,F,10,3244058,16321
16877,Ramatoulaye,F,10,3244068,16736
16878,Ramell,M,10,3244078,16378
16879,Ramsay,M,10,3244088,16111
16880,Ranae,F,10,3244098,16600
16881,Reason,M,10,3244108,16287
16882,Rechy,F,10,3244118,16859
16883,Red,M,10,3244128,16300
16884,Rema,F,10,3244138,16584
16885,Remedi,F,10,3244148,16855
16886,Renad,F,10,3244158,16926
16887,Rev,M,10,3244168,16053
16888,Revin,M,10,3244178,16794
16889,Rhaegar,M,10,3244188,16174
16890,Rhyen,F,10,3244198,16102
16891,Rhylen,M,10,3244208,16989
16892,Riata,F,10,3244218,16493
16893,Richardson,M,10,3244228,16216
16894,Rielynn,F,10,3244238,16121
16895,Rileyrose,F,10,3244248,16276
16896,Rithik,M,10,3244258,16114
16897,Ritisha,F,10,3244268,16380
16898,Rodina,F,10,3244278,16052
16899,Rogen,M,10,3244288,16618
16900,Roiza,F,10,3244298,16429
16901,Romie,F,10,3244308,16316
16902,Ronell,M,10,3244318,16338
16903,Roniel,M,10,3244328,16908
16904,Roree,F,10,3244338,16030
16905,Rosamond,F,10,3244348,16456
16906,Rosilyn,F,10,3244358,16465
16907,Rossy,F,10,3244368,16477
16908,Rozen,M,10,3244378,16789
16909,Rubee,F,10,3244388,16544
16910,Rubyann,F,10,3244398,16278
16911,Rumor,F,10,3244408,16284
16912,Russ,M,10,3244418,16821
16913,Rutvi,F,10,3244428,16550
16914,Ruxton,M,10,3244438,16691
16915,Ryenn,F,10,3244448,16754
16916,Sabah,F,10,3244458,16559
16917,Sabbath,M,10,3244468,16884
16918,Sabin,M,10,3244478,16646
16919,Sabra,F,10,3244488,16104
16920,Sabre,F,10,3244498,16945
16921,Sabreen,F,10,3244508,16590
16922,Safira,F,10,3244518,16922
16923,Safwaan,M,10,3244528,16571
16924,Saheed,M,10,3244538,16422
16925,Sair,M,10,3244548,16410
16926,Sakshi,F,10,3244558,16775
16927,Salaar,M,10,3244568,16978
16928,Saleah,F,10,3244578,16164
16929,Saliha,F,10,3244588,16432
16930,Salima,F,10,3244598,16883
16931,Samani,F,10,3244608,16117
16932,Samba,M,10,3244618,16793
16933,Samiel,M,10,3244628,16875
16934,Samika,F,10,3244638,16045
16935,Samreen,F,10,3244648,16243
16936,Samwell,M,10,3244658,16508
16937,Samyla,F,10,3244668,16670
16938,Sanam,F,10,3244678,16365
16939,Sanay,M,10,3244688,16428
16940,Sanyiah,F,10,3244698,16329
16941,Saquan,M,10,3244708,16655
16942,Saquon,M,10,3244718,16412
16943,Saralynn,F,10,3244728,16269
16944,Savio,M,10,3244738,16528
16945,Sayde,F,10,3244748,16273
16946,Sayer,M,10,3244758,16647
16947,Sayesha,F,10,3244768,16074
16948,Sayf,M,10,3244778,16034
16949,Sayge,F,10,3244788,16567
16950,Seager,M,10,3244798,16856
16951,Seana,F,10,3244808,16934
16952,Sebastiano,M,10,3244818,16642
16953,Secret,F,10,3244828,16804
16954,Sekai,M,10,3244838,16949
16955,Seleni,F,10,3244848,16722
16956,Selenia,F,10,3244858,16876
16957,Seniyah,F,10,3244868,16309
16958,Serana,F,10,3244878,16061
16959,Sergey,M,10,3244888,16732
16960,Shaddai,F,10,3244898,16613
16961,Shadia,F,10,3244908,16548
16962,Shaheen,M,10,3244918,16042
16963,Shaheer,M,10,3244928,16555
16964,Shahid,M,10,3244938,16411
16965,Shailee,F,10,3244948,16531
16966,Shaily,F,10,3244958,16015
16967,Shaima,F,10,3244968,16250
16968,Shakir,M,10,3244978,16796
16969,Shalaya,F,10,3244988,16699
16970,Shamya,F,10,3244998,16619
16971,Shant,M,10,3245008,16888
16972,Shantelle,F,10,3245018,16301
16973,Shanya,F,10,3245028,16166
16974,Shariah,F,10,3245038,16837
16975,Shaye,F,10,3245048,16993
16976,Shealyn,F,10,3245058,16043
16977,Sheccid,F,10,3245068,16078
16978,Sherri,F,10,3245078,16541
16979,Sherrod,M,10,3245088,16990
16980,Shimshon,M,10,3245098,16681
16981,Shivya,F,10,3245108,16587
16982,Shray,M,10,3245118,16325
16983,Shrika,F,10,3245128,16815
16984,Shya,F,10,3245138,16209
16985,Shyanna,F,10,3245148,16589
16986,Siam,M,10,3245158,16444
16987,Sihana,F,10,3245168,16351
16988,Siler,M,10,3245178,16817
16989,Siniyah,F,10,3245188,16020
16990,Siyon,M,10,3245198,16295
16991,Socorro,F,10,3245208,16885
16992,Solimar,F,10,3245218,16223
16993,Solina,F,10,3245228,16944
16994,Sophiarose,F,10,3245238,16184
16995,Sorren,M,10,3245248,16634
16996,Srihitha,F,10,3245258,16850
16997,Sriyansh,M,10,3245268,16068
16998,Sruly,M,10,3245278,16063
16999,Stan,M,10,3245288,16963
17000,Starling,F,10,3245298,17673
17001,Stasia,F,10,3245308,17402
17002,Stellah,F,10,3245318,17321
17003,Stevenson,M,10,3245328,17388
17004,Stiven,M,10,3245338,17035
17005,Stuti,F,10,3245348,17386
17006,Suhaila,F,10,3245358,17236
17007,Sujey,F,10,3245368,17546
17008,Sumire,F,10,3245378,17995
17009,Summerrose,F,10,3245388,17925
17010,Suriya,F,10,3245398,17297
17011,Syana,F,10,3245408,17072
17012,Syier,M,10,3245418,17315
17013,Symphany,F,10,3245428,17287
17014,Syniah,F,10,3245438,17544
17015,Taiya,F,10,3245448,17189
17016,Takeo,M,10,3245458,17780
17017,Talin,M,10,3245468,17939
17018,Talina,F,10,3245478,17799
17019,Tallie,F,10,3245488,17949
17020,Tanvika,F,10,3245498,17368
17021,Tanylah,F,10,3245508,17931
17022,Tarak,M,10,3245518,17042
17023,Tashi,M,10,3245528,17249
17024,Tavis,M,10,3245538,17669
17025,Tayo,M,10,3245548,17303
17026,Tayon,M,10,3245558,17691
17027,Tayva,F,10,3245568,17047
17028,Tegh,M,10,3245578,17884
17029,Tenoch,M,10,3245588,17763
17030,Tera,F,10,3245598,17253
17031,Terryn,F,10,3245608,17619
17032,Teyla,F,10,3245618,17575
17033,Teyo,M,10,3245628,17490
17034,Thania,F,10,3245638,17762
17035,Tiam,M,10,3245648,17873
17036,Tifeoluwa,M,10,3245658,17312
17037,Tiffanie,F,10,3245668,17981
17038,Tighe,M,10,3245678,17554
17039,Tilia,F,10,3245688,17462
17040,Timothee,M,10,3245698,17737
17041,Tisha,F,10,3245708,17919
17042,Toluwanimi,M,10,3245718,17199
17043,Tonatiuh,M,10,3245728,17004
17044,Topher,M,10,3245738,17589
17045,Torianna,F,10,3245748,17582
17046,Torie,F,10,3245758,17043
17047,Torrie,F,10,3245768,17962
17048,Torunn,F,10,3245778,17351
17049,Toshiro,M,10,3245788,17159
17050,Toure,M,10,3245798,17390
17051,Trajan,M,10,3245808,17434
17052,Travaris,M,10,3245818,17455
17053,Tremon,M,10,3245828,17116
17054,Trew,M,10,3245838,17969
17055,Truleigh,F,10,3245848,17660
17056,Tryce,M,10,3245858,17250
17057,Tulsa,F,10,3245868,17336
17058,Tyger,M,10,3245878,17269
17059,Tynleigh,F,10,3245888,17296
17060,Uhtred,M,10,3245898,17519
17061,Uzay,M,10,3245908,17478
17062,Val,M,10,3245918,17138
17063,Valena,F,10,3245928,17361
17064,Vallie,F,10,3245938,17932
17065,Valora,F,10,3245948,17251
17066,Valynn,F,10,3245958,17597
17067,Vara,F,10,3245968,17608
17068,Vash,M,10,3245978,17401
17069,Vedaant,M,10,3245988,17547
17070,Veena,F,10,3245998,17678
17071,Veira,F,10,3246008,17033
17072,Velia,F,10,3246018,17653
17073,Ventura,M,10,3246028,17787
17074,Verenice,F,10,3246038,17472
17075,Vidhi,F,10,3246048,17898
17076,Vidit,M,10,3246058,17233
17077,Vidyuth,M,10,3246068,17484
17078,Viliami,M,10,3246078,17234
17079,Vin,M,10,3246088,17773
17080,Vitaliy,M,10,3246098,17456
17081,Vivansh,M,10,3246108,17571
17082,Waldo,M,10,3246118,17366
17083,Washington,M,10,3246128,17406
17084,Wateen,F,10,3246138,17636
17085,Weller,M,10,3246148,17280
17086,Wesam,M,10,3246158,17423
17087,Weylin,M,10,3246168,17912
17088,Whalen,M,10,3246178,17854
17089,Wiktor,M,10,3246188,17987
17090,Wil,M,10,3246198,17183
17091,Wilde,M,10,3246208,17588
17092,Wilian,M,10,3246218,17991
17093,Wisam,M,10,3246228,17146
17094,Wise,M,10,3246238,17828
17095,Wisteria,F,10,3246248,17802
17096,Wryn,F,10,3246258,17585
17097,Wylde,M,10,3246268,17504
17098,Wynnter,F,10,3246278,17107
17099,Xamara,F,10,3246288,17759
17100,Xamira,F,10,3246298,17166
17101,Xariyah,F,10,3246308,17500
17102,Xen,M,10,3246318,17318
17103,Xi,M,10,3246328,17733
17104,Xophia,F,10,3246338,17512
17105,Xzayvion,M,10,3246348,17593
17106,Yakub,M,10,3246358,17729
17107,Yandriel,M,10,3246368,17732
17108,Yariana,F,10,3246378,17528
17109,Yazhini,F,10,3246388,17454
17110,Yedidya,M,10,3246398,17450
17111,Yeslin,F,10,3246408,17311
17112,Yessia,F,10,3246418,17228
17113,Yitta,F,10,3246428,17929
17114,Yoandri,M,10,3246438,17657
17115,Yonas,M,10,3246448,17141
17116,Yordi,M,10,3246458,17655
17117,Youssouf,M,10,3246468,17620
17118,Yu,M,10,3246478,17667
17119,Yuleimy,F,10,3246488,17031
17120,Yuritzy,F,10,3246498,17665
17121,Yuvika,F,10,3246508,17136
17122,Zaela,F,10,3246518,17151
17123,Zahmari,M,10,3246528,17071
17124,Zaion,M,10,3246538,17905
17125,Zakariyya,M,10,3246548,17524
17126,Zalynn,F,10,3246558,17697
17127,Zamzam,F,10,3246568,17446
17128,Zarahi,F,10,3246578,17013
17129,Zariel,F,10,3246588,17727
17130,Zarif,M,10,3246598,17161
17131,Zayley,F,10,3246608,17344
17132,Zayvon,M,10,3246618,17376
17133,Zeb,M,10,3246628,17064
17134,Zee,M,10,3246638,17795
17135,Zenayda,F,10,3246648,17133
17136,Zeon,M,10,3246658,17066
17137,Zeyla,F,10,3246668,17188
17138,Zeynab,F,10,3246678,17613
17139,Zhaviah,F,10,3246688,17858
17140,Zhyaire,M,10,3246698,17059
17141,Zikora,F,10,3246708,17576
17142,Zimir,M,10,3246718,17155
17143,Zimri,M,10,3246728,17788
17144,Zirwa,F,10,3246738,17720
17145,Zisha,M,10,3246748,17835
17146,Zoeh,F,10,3246758,17973
17147,Zoii,F,10,3246768,17906
17148,Zonnique,F,10,3246778,17587
17149,Zoraiz,M,10,3246788,17792
17150,Zorion,M,10,3246798,17580
17151,Zuzu,F,10,3246808,17506
17152,Zykeem,M,10,3246818,17304
17153,Zylas,M,10,3246828,17224
17154,Zyree,M,10,3246838,17115
17155,Aadhyasri,F,9,3246847,17826
17156,Aahaan,M,9,3246856,17326
17157,Aaima,F,9,3246865,17037
17158,Aakriti,F,9,3246874,17896
17159,Aalaysia,F,9,3246883,17805
17160,Aanshi,F,9,3246892,17565
17161,Aarian,M,9,3246901,17712
17162,Aariel,F,9,3246910,17491
17163,Aarionna,F,9,3246919,17870
17164,Aarvika,F,9,3246928,17814
17165,Aavash,M,9,3246937,17019
17166,Aayushi,F,9,3246946,17369
17167,Abdulhamid,M,9,3246955,17516
17168,Abdulraheem,M,9,3246964,17707
17169,Abdur,M,9,3246973,17255
17170,Abid,M,9,3246982,17641
17171,Abigaelle,F,9,3246991,17794
17172,Abra,F,9,3247000,17638
17173,Abree,F,9,3247009,17495
17174,Abrish,F,9,3247018,17257
17175,Aceon,M,9,3247027,17806
17176,Acre,M,9,3247036,17611
17177,Adabelle,F,9,3247045,17164
17178,Adalay,F,9,3247054,17463
17179,Adalea,F,9,3247063,17816
17180,Adaleen,F,9,3247072,17288
17181,Adaleine,F,9,3247081,17471
17182,Adalis,F,9,3247090,17863
17183,Addylin,F,9,3247099,17370
17184,Adeeb,M,9,3247108,17704
17185,Adelise,F,9,3247117,17764
17186,Adena,F,9,3247126,17616
17187,Adhvika,F,9,3247135,17635
17188,Adilenne,F,9,3247144,17178
17189,Adilyne,F,9,3247153,17217
17190,Adilynne,F,9,3247162,17643
17191,Adiyah,F,9,3247171,17355
17192,Adrea,F,9,3247180,17414
17193,Adrick,M,9,3247189,17433
17194,Adrie,F,9,3247198,17182
17195,Adrionna,F,9,3247207,17971
17196,Adryana,F,9,3247216,17309
17197,Afiya,F,9,3247225,17701
17198,Aftyn,F,9,3247234,17440
17199,Ahitana,F,9,3247243,17651
17200,Ahlia,F,9,3247252,17190
17201,Ahliyah,F,9,3247261,17302
17202,Ahmere,M,9,3247270,17021
17203,Ahmia,F,9,3247279,17347
17204,Ahmias,M,9,3247288,17977
17205,Ahsiah,M,9,3247297,17207
17206,Aiham,M,9,3247306,17918
17207,Ailanny,F,9,3247315,17017
17208,Aily,F,9,3247324,17277
17209,Airen,M,9,3247333,17941
17210,Aislee,F,9,3247342,17800
17211,Aitan,M,9,3247351,17444
17212,Aitor,M,9,3247360,17263
17213,Aizel,F,9,3247369,17024
17214,Ajit,M,9,3247378,17381
17215,Ajuni,F,9,3247387,17428
17216,Akin,M,9,3247396,17889
17217,Akshita,F,9,3247405,17383
17218,Aksil,M,9,3247414,17453
17219,Alayne,F,9,3247423,17074
17220,Alazae,F,9,3247432,17577
17221,Alberta,F,9,3247441,17801
17222,Alberth,M,9,3247450,17320
17223,Albi,M,9,3247459,17514
17224,Aleanna,F,9,3247468,17357
17225,Aleema,F,9,3247477,17377
17226,Alegra,F,9,3247486,17010
17227,Aleisa,F,9,3247495,17819
17228,Alera,F,9,3247504,17818
17229,Aleyla,F,9,3247513,17350
17230,Aleyssa,F,9,3247522,17294
17231,Alieu,M,9,3247531,17080
17232,Aliha,F,9,3247540,17026
17233,Alius,M,9,3247549,17052
17234,Alivea,F,9,3247558,17989
17235,Aliyan,M,9,3247567,17448
17236,Allanna,F,9,3247576,17231
17237,Allante,M,9,3247585,17703
17238,Allysen,F,9,3247594,17561
17239,Allysson,F,9,3247603,17232
17240,Alo,M,9,3247612,17364
17241,Alois,M,9,3247621,17470
17242,Alric,M,9,3247630,17245
17243,Alter,M,9,3247639,17569
17244,Alvie,M,9,3247648,17163
17245,Alyia,F,9,3247657,17644
17246,Alynn,F,9,3247666,17499
17247,Alyona,F,9,3247675,17204
17248,Alys,F,9,3247684,17214
17249,Alyss,F,9,3247693,17744
17250,Alyus,M,9,3247702,17649
17251,Alyxandria,F,9,3247711,17028
17252,Amaliah,F,9,3247720,17646
17253,Amanii,F,9,3247729,17430
17254,Amarisa,F,9,3247738,17827
17255,Amayla,F,9,3247747,17426
17256,Ameelia,F,9,3247756,17387
17257,Ameia,F,9,3247765,17339
17258,Ameilya,F,9,3247774,17392
17259,Americus,F,9,3247783,17834
17260,Amiera,F,9,3247792,17305
17261,Amilla,F,9,3247801,17055
17262,Amisha,F,9,3247810,17965
17263,Ammaar,M,9,3247819,17510
17264,Amnen,M,9,3247828,17714
17265,Amoya,F,9,3247837,17140
17266,Amrita,F,9,3247846,17091
17267,Amunet,F,9,3247855,17789
17268,Anabela,F,9,3247864,17409
17269,Anaclara,F,9,3247873,17380
17270,Anaija,F,9,3247882,17926
17271,Anajulia,F,9,3247891,17581
17272,Analyah,F,9,3247900,17095
17273,Ananiah,F,9,3247909,17642
17274,Andreea,F,9,3247918,17363
17275,Andreina,F,9,3247927,17120
17276,Andric,M,9,3247936,17515
17277,Angello,M,9,3247945,17065
17278,Anicia,F,9,3247954,17176
17279,Anil,M,9,3247963,17310
17280,Annalei,F,9,3247972,17586
17281,Annalisse,F,9,3247981,17298
17282,Annorah,F,9,3247990,17006
17283,Anokhi,F,9,3247999,17875
17284,Anori,F,9,3248008,17179
17285,Anoushka,F,9,3248017,17060
17286,Antonius,M,9,3248026,17864
17287,Antron,M,9,3248035,17424
17288,Antwoine,M,9,3248044,17172
17289,Anu,M,9,3248053,17479
17290,Anura,F,9,3248062,17564
17291,Anyelin,F,9,3248071,17460
17292,Anyia,F,9,3248080,17885
17293,Aragorn,M,9,3248089,17563
17294,Arianni,F,9,3248098,17412
17295,Ariarose,F,9,3248107,17494
17296,Ariell,F,9,3248116,17738
17297,Aristides,M,9,3248125,17385
17298,Ariv,M,9,3248134,17397
17299,Ariyella,F,9,3248143,17438
17300,Arkham,M,9,3248152,17502
17301,Arnez,M,9,3248161,17758
17302,Arnie,M,9,3248170,17917
17303,Arshaan,M,9,3248179,17893
17304,Artie,M,9,3248188,17048
17305,Aruvi,F,9,3248197,17782
17306,Aryaa,F,9,3248206,17661
17307,Arybella,F,9,3248215,17334
17308,Aryo,M,9,3248224,17650
17309,Asar,M,9,3248233,17441
17310,Aseneth,F,9,3248242,17627
17311,Ashanty,F,9,3248251,17354
17312,Ashlen,F,9,3248260,17067
17313,Ashvi,F,9,3248269,17014
17314,Ason,M,9,3248278,17285
17315,Astara,F,9,3248287,17016
17316,Astin,M,9,3248296,17895
17317,Atem,M,9,3248305,17175
17318,Atenea,F,9,3248314,17398
17319,Athanasia,F,9,3248323,17964
17320,Atzel,M,9,3248332,17708
17321,Atzi,F,9,3248341,17777
17322,Atziry,F,9,3248350,17185
17323,Audreyana,F,9,3248359,17859
17324,Aureus,M,9,3248368,17259
17325,Auriah,F,9,3248377,17604
17326,Auryn,F,9,3248386,17162
17327,Auset,F,9,3248395,17534
17328,Avaleen,F,9,3248404,17717
17329,Avanelle,F,9,3248413,17857
17330,Avarae,F,9,3248422,17447
17331,Averett,M,9,3248431,17525
17332,Avonna,F,9,3248440,17652
17333,Avontae,M,9,3248449,17813
17334,Avrianna,F,9,3248458,17726
17335,Axzel,M,9,3248467,17399
17336,Ayad,M,9,3248476,17103
17337,Aydrien,M,9,3248485,17940
17338,Aylanni,F,9,3248494,17923
17339,Ayline,F,9,3248503,17607
17340,Aymaan,M,9,3248512,17123
17341,Aynara,F,9,3248521,17090
17342,Ayomikun,M,9,3248530,17144
17343,Aysa,F,9,3248539,17206
17344,Ayshe,F,9,3248548,17451
17345,Ayvan,M,9,3248557,17675
17346,Ayyash,M,9,3248566,17724
17347,Ayzen,M,9,3248575,17322
17348,Azaleia,F,9,3248584,17025
17349,Azalya,F,9,3248593,17230
17350,Azalynn,F,9,3248602,17422
17351,Azarius,M,9,3248611,17160
17352,Azaryah,F,9,3248620,17404
17353,Azayah,M,9,3248629,17240
17354,Azaylea,F,9,3248638,17271
17355,Azeil,M,9,3248647,17111
17356,Azi,M,9,3248656,17289
17357,Azyah,F,9,3248665,17670
17358,Bambi,F,9,3248674,17654
17359,Bana,F,9,3248683,17848
17360,Bankston,M,9,3248692,17796
17361,Baran,F,9,3248701,17038
17362,Bawi,M,9,3248710,17301
17363,Behrett,M,9,3248719,17674
17364,Bence,M,9,3248728,17442
17365,Berta,F,9,3248737,17807
17366,Besan,F,9,3248746,17108
17367,Betsaida,F,9,3248755,17101
17368,Betselot,F,9,3248764,17609
17369,Bettie,F,9,3248773,17540
17370,Bhumi,F,9,3248782,17096
17371,Bison,M,9,3248791,17768
17372,Bladen,M,9,3248800,17821
17373,Blanton,M,9,3248809,17461
17374,Bloom,F,9,3248818,17579
17375,Bohden,M,9,3248827,17272
17376,Boluwatife,M,9,3248836,17086
17377,Bond,M,9,3248845,17212
17378,Borna,M,9,3248854,17465
17379,Bradon,M,9,3248863,17431
17380,Braelon,M,9,3248872,17776
17381,Braelynne,F,9,3248881,17637
17382,Bralen,M,9,3248890,17057
17383,Brance,M,9,3248899,17894
17384,Brand,M,9,3248908,17346
17385,Brasen,M,9,3248917,17348
17386,Braylah,F,9,3248926,17130
17387,Brayzen,M,9,3248935,17545
17388,Breella,F,9,3248944,17948
17389,Breezy,F,9,3248953,17698
17390,Brenin,M,9,3248962,17852
17391,Brenly,F,9,3248971,17486
17392,Brenlyn,F,9,3248980,17832
17393,Brenlynn,F,9,3248989,17811
17394,Breonna,F,9,3248998,17445
17395,Briell,F,9,3249007,17395
17396,Brigette,F,9,3249016,17094
17397,Brighten,M,9,3249025,17734
17398,Brinson,M,9,3249034,17887
17399,Brinton,M,9,3249043,17293
17400,Briston,M,9,3249052,17837
17401,Broxton,M,9,3249061,17833
17402,Bryceton,M,9,3249070,17983
17403,Brynzlee,F,9,3249079,17668
17404,Buchanan,M,9,3249088,17360
17405,Buxton,M,9,3249097,17165
17406,Caeson,M,9,3249106,17663
17407,Caiman,M,9,3249115,17337
17408,Cairn,M,9,3249124,17658
17409,Cairon,M,9,3249133,17840
17410,Caitriona,F,9,3249142,17680
17411,Calaya,F,9,3249151,17073
17412,Calcifer,M,9,3249160,17526
17413,Caldwell,M,9,3249169,17543
17414,Calea,F,9,3249178,17509
17415,Caleena,F,9,3249187,17292
17416,Caliope,F,9,3249196,17238
17417,Calysta,F,9,3249205,17910
17418,Cameila,F,9,3249214,17418
17419,Cammy,F,9,3249223,17275
17420,Camyah,F,9,3249232,17371
17421,Camyiah,F,9,3249241,17769
17422,Caniyah,F,9,3249250,17883
17423,Carah,F,9,3249259,17952
17424,Careem,M,9,3249268,17079
17425,Cario,M,9,3249277,17882
17426,Carisa,F,9,3249286,17930
17427,Carmelita,F,9,3249295,17335
17428,Carroll,M,9,3249304,17029
17429,Carwyn,M,9,3249313,17264
17430,Cashlynn,F,9,3249322,17552
17431,Cassady,F,9,3249331,17972
17432,Cataleia,F,9,3249340,17313
17433,Cataleyah,F,9,3249349,17867
17434,Cayce,M,9,3249358,17307
17435,Caydan,M,9,3249367,17700
17436,Caylei,F,9,3249376,17104
17437,Caylynn,F,9,3249385,17443
17438,Caysin,M,9,3249394,17951
17439,Celes,F,9,3249403,17030
17440,Cereza,F,9,3249412,17208
17441,Cevyn,F,9,3249421,17922
17442,Charliegh,F,9,3249430,17198
17443,Charlierose,F,9,3249439,17022
17444,Chatham,M,9,3249448,17261
17445,Chayla,F,9,3249457,17706
17446,Chaylee,F,9,3249466,17984
17447,Chigozirim,M,9,3249475,17851
17448,Chikaima,F,9,3249484,17839
17449,Chisom,F,9,3249493,17846
17450,Chosyn,F,9,3249502,17741
17451,Chozyn,M,9,3249511,17798
17452,Chrissa,F,9,3249520,17153
17453,Chrystian,M,9,3249529,17567
17454,Chyann,F,9,3249538,17498
17455,Cid,M,9,3249547,17999
17456,Clarisse,F,9,3249556,17020
17457,Clarita,F,9,3249565,17865
17458,Claudette,F,9,3249574,17843
17459,Clayne,M,9,3249583,17330
17460,Clayten,M,9,3249592,17928
17461,Cloie,F,9,3249601,17521
17462,Coburn,M,9,3249610,17808
17463,Coley,M,9,3249619,17602
17464,Collen,M,9,3249628,17936
17465,Coltrane,M,9,3249637,17359
17466,Connelly,F,9,3249646,17830
17467,Copelyn,F,9,3249655,17739
17468,Corryn,F,9,3249664,17437
17469,Cortney,F,9,3249673,17874
17470,Coumba,F,9,3249682,17507
17471,Cowen,M,9,3249691,17558
17472,Crista,F,9,3249700,17324
17473,Croy,M,9,3249709,17128
17474,Curran,M,9,3249718,17002
17475,Cylan,M,9,3249727,17098
17476,Cymone,F,9,3249736,17537
17477,Dagen,M,9,3249745,17927
17478,Dahir,M,9,3249754,17656
17479,Dahlila,F,9,3249763,17603
17480,Dailin,F,9,3249772,17262
17481,Dairon,M,9,3249781,17920
17482,Daishawn,M,9,3249790,17648
17483,Daisymae,F,9,3249799,17181
17484,Daiya,F,9,3249808,17945
17485,Daken,M,9,3249817,17008
17486,Dalana,F,9,3249826,17844
17487,Dalena,F,9,3249835,17950
17488,Dalyah,F,9,3249844,17308
17489,Dalynn,F,9,3249853,17781
17490,Damone,M,9,3249862,17213
17491,Damonii,M,9,3249871,17466
17492,Damyah,F,9,3249880,17039
17493,Damyan,M,9,3249889,17216
17494,Danella,F,9,3249898,17947
17495,Danette,F,9,3249907,17168
17496,Danila,F,9,3249916,17070
17497,Danilynn,F,9,3249925,17278
17498,Danner,M,9,3249934,17825
17499,Dantae,M,9,3249943,17725
17500,Dariella,F,9,3249952,17323
17501,Daryel,M,9,3249961,17340
17502,Dashley,F,9,3249970,17743
17503,Daveah,F,9,3249979,17872
17504,Davide,M,9,3249988,17273
17505,Davud,M,9,3249997,17909
17506,Daxen,M,9,3250006,17143
17507,Dayelin,F,9,3250015,17944
17508,Daylynn,F,9,3250024,17960
17509,Daymien,M,9,3250033,17282
17510,Deandra,F,9,3250042,17049
17511,Dee,M,9,3250051,17196
17512,Deejay,M,9,3250060,17477
17513,Del,M,9,3250069,17779
17514,Deliliah,F,9,3250078,17639
17515,Demaria,F,9,3250087,17458
17516,Demetrice,M,9,3250096,17215
17517,Demitra,F,9,3250105,17993
17518,Demiya,F,9,3250114,17681
17519,Dennhi,F,9,3250123,17266
17520,Derrius,M,9,3250132,17475
17521,Desai,M,9,3250141,17429
17522,Desiah,M,9,3250150,17358
17523,Dessiah,M,9,3250159,17938
17524,Destyn,M,9,3250168,17040
17525,Destyni,F,9,3250177,17845
17526,Devarsh,M,9,3250186,17921
17527,Deya,F,9,3250195,17000
17528,Dezyre,F,9,3250204,17881
17529,Dhalia,F,9,3250213,17076
17530,Dharius,M,9,3250222,17367
17531,Dian,M,9,3250231,17156
17532,Dillyn,F,9,3250240,17880
17533,Dionysus,M,9,3250249,17459
17534,Diyaan,M,9,3250258,17791
17535,Django,M,9,3250267,17605
17536,Dmya,F,9,3250276,17187
17537,Dnyla,F,9,3250285,17122
17538,Dodger,M,9,3250294,17812
17539,Domino,F,9,3250303,17550
17540,Dominus,M,9,3250312,17645
17541,Donal,M,9,3250321,17728
17542,Dorthy,F,9,3250330,17283
17543,Dragan,M,9,3250339,17405
17544,Drago,M,9,3250348,17270
17545,Draiden,M,9,3250357,17640
17546,Drayke,M,9,3250366,17192
17547,Draymond,M,9,3250375,17496
17548,Dreama,F,9,3250384,17391
17549,Dreu,M,9,3250393,17210
17550,Dreyton,M,9,3250402,17761
17551,Drucilla,F,9,3250411,17464
17552,Duru,F,9,3250420,17051
17553,Dutchess,F,9,3250429,17314
17554,Dymir,M,9,3250438,17904
17555,Ed,M,9,3250447,17871
17556,Edder,M,9,3250456,17082
17557,Edgard,M,9,3250465,17946
17558,Eeva,F,9,3250474,17970
17559,Efe,M,9,3250483,17688
17560,Effy,F,9,3250492,17562
17561,Eilani,F,9,3250501,17783
17562,Eiliyah,F,9,3250510,17689
17563,Eimi,F,9,3250519,17112
17564,Elahni,F,9,3250528,17598
17565,Elainna,F,9,3250537,17766
17566,Elaynah,F,9,3250546,17417
17567,Eleia,F,9,3250555,17631
17568,Elenah,F,9,3250564,17054
17569,Eleven,M,9,3250573,17227
17570,Elexia,F,9,3250582,17996
17571,Eliannie,F,9,3250591,17568
17572,Eligio,M,9,3250600,17485
17573,Elih,M,9,3250609,17551
17574,Elihana,F,9,3250618,17195
17575,Elikai,M,9,3250627,17584
17576,Elion,M,9,3250636,17513
17577,Ellany,F,9,3250645,17481
17578,Ellary,F,9,3250654,17836
17579,Elliona,F,9,3250663,17058
17580,Elsey,F,9,3250672,17220
17581,Emalina,F,9,3250681,17606
17582,Emereigh,F,9,3250690,17713
17583,Emilea,F,9,3250699,17152
17584,Emilene,F,9,3250708,17173
17585,Emiliya,F,9,3250717,17749
17586,Emillie,F,9,3250726,17685
17587,Emjay,F,9,3250735,17891
17588,Emmani,F,9,3250744,17956
17589,Emmanuela,F,9,3250753,17770
17590,Emmelynn,F,9,3250762,17349
17591,Emmersen,F,9,3250771,17501
17592,Emmory,F,9,3250780,17532
17593,Emmry,F,9,3250789,17809
17594,Eneko,M,9,3250798,17150
17595,Eniya,F,9,3250807,17935
17596,Ephrata,F,9,3250816,17592
17597,Epic,M,9,3250825,17352
17598,Eri,M,9,3250834,17804
17599,Eriyah,F,9,3250843,17088
17600,Erron,M,9,3250852,17379
17601,Esaiah,M,9,3250861,17943
17602,Esly,F,9,3250870,17476
17603,Estera,F,9,3250879,17696
17604,Ettie,F,9,3250888,17664
17605,Eunique,F,9,3250897,17916
17606,Evelise,F,9,3250906,17823
17607,Evelyna,F,9,3250915,17961
17608,Everlyrose,F,9,3250924,17847
17609,Evlynn,F,9,3250933,17790
17610,Evyana,F,9,3250942,17063
17611,Ezekiah,M,9,3250951,17497
17612,Ezias,M,9,3250960,17046
17613,Ezikiel,M,9,3250969,17378
17614,Ezme,F,9,3250978,17365
17615,Ezmia,F,9,3250987,17590
17616,Ezriah,M,9,3250996,17695
17617,Ezryn,M,9,3251005,17299
17618,Faeryn,F,9,3251014,17716
17619,Fallynn,F,9,3251023,17083
17620,Faryal,F,9,3251032,17268
17621,Fatumata,F,9,3251041,17628
17622,Federica,F,9,3251050,17338
17623,Field,M,9,3251059,17106
17624,Finian,M,9,3251068,17954
17625,Fionnuala,F,9,3251077,17757
17626,Fiza,F,9,3251086,17966
17627,Floki,M,9,3251095,17559
17628,Folasade,F,9,3251104,17284
17629,Frey,M,9,3251113,17247
17630,Galadriel,F,9,3251122,17482
17631,Gali,F,9,3251131,17736
17632,Garnet,F,9,3251140,17517
17633,Geana,F,9,3251149,17553
17634,Geanna,F,9,3251158,17530
17635,Gedalya,M,9,3251167,17719
17636,Gem,F,9,3251176,17218
17637,Genelle,F,9,3251185,17618
17638,Gentri,F,9,3251194,17986
17639,Geovonni,M,9,3251203,17092
17640,Germain,M,9,3251212,17097
17641,Giano,M,9,3251221,17771
17642,Giavonni,F,9,3251230,17276
17643,Giordana,F,9,3251239,17900
17644,Giovan,M,9,3251248,17279
17645,Giovannie,M,9,3251257,17087
17646,Given,M,9,3251266,17032
17647,Gladis,F,9,3251275,17219
17648,Glenna,F,9,3251284,17229
17649,Goliath,M,9,3251293,17634
17650,Gotti,M,9,3251302,17699
17651,Graciemae,F,9,3251311,17679
17652,Grantham,M,9,3251320,17600
17653,Graylon,M,9,3251329,17690
17654,Greenleigh,F,9,3251338,17731
17655,Greylynn,F,9,3251347,17243
17656,Gurbani,F,9,3251356,17132
17657,Gurshaan,M,9,3251365,17911
17658,Gurtej,M,9,3251374,17241
17659,Guthrie,M,9,3251383,17319
17660,Gwendoline,F,9,3251392,17730
17661,Hafiz,M,9,3251401,17427
17662,Haidar,M,9,3251410,17978
17663,Haitham,M,9,3251419,17157
17664,Haji,M,9,3251428,17963
17665,Hajira,F,9,3251437,17069
17666,Hakan,M,9,3251446,17842
17667,Halime,F,9,3251455,17974
17668,Hally,F,9,3251464,17373
17669,Hamidou,M,9,3251473,17625
17670,Hamze,M,9,3251482,17001
17671,Hananiah,M,9,3251491,17702
17672,Hanish,M,9,3251500,17529
17673,Harith,M,9,3251509,17752
17674,Harjas,M,9,3251518,17325
17675,Harman,M,9,3251527,17281
17676,Haruki,M,9,3251536,17407
17677,Harvin,M,9,3251545,17915
17678,Hasley,F,9,3251554,17765
17679,Hasna,F,9,3251563,17503
17680,Havanah,F,9,3251572,17797
17681,Havish,M,9,3251581,17968
17682,Haydyn,F,9,3251590,17480
17683,Hazell,F,9,3251599,17886
17684,Helenna,F,9,3251608,17225
17685,Henslie,F,9,3251617,17265
17686,Hephzibah,F,9,3251626,17093
17687,Herlinda,F,9,3251635,17290
17688,Hezakiah,M,9,3251644,17068
17689,Hilde,F,9,3251653,17982
17690,Hiroki,M,9,3251662,17174
17691,Hobie,M,9,3251671,17317
17692,Hoda,F,9,3251680,17081
17693,Holliday,F,9,3251689,17003
17694,Hunner,M,9,3251698,17760
17695,Husain,M,9,3251707,17036
17696,Hussam,M,9,3251716,17333
17697,Huxon,M,9,3251725,17223
17698,Hyacinth,F,9,3251734,17432
17699,Hylia,F,9,3251743,17810
17700,Hypatia,F,9,3251752,17341
17701,Ibhan,M,9,3251761,17662
17702,Icarus,M,9,3251770,17125
17703,Ilynn,F,9,3251779,17686
17704,Ilyssa,F,9,3251788,17329
17705,Imaad,M,9,3251797,17488
17706,Imanuel,M,9,3251806,17785
17707,Imaya,F,9,3251815,17439
17708,Imre,M,9,3251824,17541
17709,Infantboy,M,9,3251833,17011
17710,Inigo,M,9,3251842,17624
17711,Ioanna,F,9,3251851,17612
17712,Iqlas,F,9,3251860,17044
17713,Iran,M,9,3251869,17050
17714,Irelynd,F,9,3251878,17959
17715,Iren,M,9,3251887,17629
17716,Isabellamarie,F,9,3251896,17988
17717,Isaiahs,M,9,3251905,17901
17718,Ishaani,F,9,3251914,17139
17719,Ishak,M,9,3251923,17342
17720,Issei,M,9,3251932,17226
17721,Italee,F,9,3251941,17647
17722,Ithan,M,9,3251950,17267
17723,Iviana,F,9,3251959,17683
17724,Ivon,M,9,3251968,17957
17725,Ivry,F,9,3251977,17778
17726,Ivylynn,F,9,3251986,17145
17727,Iyanu,F,9,3251995,17403
17728,Jaber,M,9,3252004,17715
17729,Jabes,M,9,3252013,17169
17730,Jacai,M,9,3252022,17306
17731,Jacson,M,9,3252031,17328
17732,Jadan,M,9,3252040,17980
17733,Jadelin,F,9,3252049,17205
17734,Jadesola,F,9,3252058,17774
17735,Jadior,F,9,3252067,17890
17736,Jaece,M,9,3252076,17221
17737,Jaedan,M,9,3252085,17560
17738,Jaelynne,F,9,3252094,17142
17739,Jaeveon,M,9,3252103,17102
17740,Jafari,M,9,3252112,17549
17741,Jafeth,M,9,3252121,17535
17742,Jahbari,M,9,3252130,17124
17743,Jahel,M,9,3252139,17610
17744,Jahmire,M,9,3252148,17903
17745,Jahnelle,F,9,3252157,17493
17746,Jahni,F,9,3252166,17105
17747,Jahon,M,9,3252175,17483
17748,Jahzeel,M,9,3252184,17876
17749,Jahzier,M,9,3252193,17332
17750,Jaidy,F,9,3252202,17803
17751,Jaimarie,F,9,3252211,17772
17752,Jaisen,M,9,3252220,17193
17753,Jakaii,M,9,3252229,17953
17754,Jakel,M,9,3252238,17682
17755,Jalah,F,9,3252247,17745
17756,Jalei,F,9,3252256,17533
17757,Jamara,F,9,3252265,17850
17758,Jamariah,F,9,3252274,17327
17759,Jamilet,F,9,3252283,17119
17760,Jamonte,M,9,3252292,17817
17761,Janellie,F,9,3252301,17258
17762,Janelys,F,9,3252310,17413
17763,Janeva,F,9,3252319,17023
17764,Janila,F,9,3252328,17274
17765,Janise,F,9,3252337,17853
17766,Janissa,F,9,3252346,17147
17767,Jannie,F,9,3252355,17489
17768,Jansiel,M,9,3252364,17677
17769,Jaquay,M,9,3252373,17754
17770,Jaretssi,F,9,3252382,17256
17771,Jarian,M,9,3252391,17474
17772,Jaritza,F,9,3252400,17400
17773,Jaspen,M,9,3252409,17167
17774,Jatin,M,9,3252418,17711
17775,Javayah,F,9,3252427,17879
17776,Jaydrian,M,9,3252436,17137
17777,Jaymison,M,9,3252445,17672
17778,Jayzen,M,9,3252454,17877
17779,Jazari,F,9,3252463,17435
17780,Jazhiel,M,9,3252472,17121
17781,Jazion,M,9,3252481,17194
17782,Jazlyne,F,9,3252490,17362
17783,Jazlynne,F,9,3252499,17053
17784,Jazzlin,F,9,3252508,17034
17785,Jenaveve,F,9,3252517,17203
17786,Jeneva,F,9,3252526,17012
17787,Jennesis,F,9,3252535,17913
17788,Jenni,F,9,3252544,17129
17789,Jeovany,M,9,3252553,17747
17790,Jerard,M,9,3252562,17902
17791,Jeric,M,9,3252571,17623
17792,Jermey,M,9,3252580,17997
17793,Jerrett,M,9,3252589,17671
17794,Jesly,F,9,3252598,17793
17795,Jessup,M,9,3252607,17824
17796,Jetzabel,F,9,3252616,17345
17797,Jhade,F,9,3252625,17753
17798,Jhavia,F,9,3252634,17735
17799,Jishnu,M,9,3252643,17755
17800,Jiyana,F,9,3252652,17235
17801,Joaopedro,M,9,3252661,17566
17802,Jocabed,F,9,3252670,17511
17803,Joeangel,M,9,3252679,17457
17804,Joei,F,9,3252688,17841
17805,Jolan,M,9,3252697,17633
17806,Jolea,F,9,3252706,17934
17807,Jolissa,F,9,3252715,17750
17808,Jolyne,F,9,3252724,17469
17809,Jonte,M,9,3252733,17614
17810,Jos,M,9,3252742,17242
17811,Jrake,M,9,3252751,17411
17812,Juddson,M,9,3252760,17027
17813,Juelle,F,9,3252769,17829
17814,Juellz,M,9,3252778,17260
17815,Julani,F,9,3252787,17992
17816,Juliani,F,9,3252796,17408
17817,Jurgen,M,9,3252805,17722
17818,Juriel,M,9,3252814,17154
17819,Jurnii,F,9,3252823,17171
17820,Jyree,M,9,3252832,17117
17821,Jyri,M,9,3252841,17248
17822,Kable,M,9,3252850,17419
17823,Kacelynn,F,9,3252859,17202
17824,Kadi,F,9,3252868,17975
17825,Kaede,F,9,3252877,17860
17826,Kaeleb,M,9,3252886,17626
17827,Kahleel,M,9,3252895,17849
17828,Kahliyah,F,9,3252904,17868
17829,Kahmya,F,9,3252913,17815
17830,Kaileia,F,9,3252922,17775
17831,Kailia,F,9,3252931,17659
17832,Kailin,F,9,3252940,17421
17833,Kaisei,M,9,3252949,17372
17834,Kaislei,F,9,3252958,17177
17835,Kajuan,M,9,3252967,17599
17836,Kalanie,F,9,3252976,17820
17837,Kalanii,F,9,3252985,17158
17838,Kalaysia,F,9,3252994,17958
17839,Kaleab,M,9,3253003,17693
17840,Kalesi,F,9,3253012,17694
17841,Kalib,M,9,3253021,17751
17842,Kalis,F,9,3253030,17149
17843,Kallahan,M,9,3253039,17838
17844,Kalley,F,9,3253048,17985
17845,Kalmen,M,9,3253057,17375
17846,Kalyla,F,9,3253066,17621
17847,Kamariya,F,9,3253075,17170
17848,Kambreigh,F,9,3253084,17914
17849,Kambrey,F,9,3253093,17396
17850,Kamdin,M,9,3253102,17518
17851,Kameran,M,9,3253111,17467
17852,Kamerin,M,9,3253120,17831
17853,Kamreigh,F,9,3253129,17520
17854,Kanden,M,9,3253138,17572
17855,Kanijah,F,9,3253147,17197
17856,Kaos,M,9,3253156,17967
17857,Karalyne,F,9,3253165,17596
17858,Karcen,M,9,3253174,17897
17859,Kashdon,M,9,3253183,17878
17860,Kashtin,M,9,3253192,17109
17861,Kasi,F,9,3253201,17742
17862,Kasiah,M,9,3253210,17822
17863,Kaspar,M,9,3253219,17425
17864,Katlynn,F,9,3253228,17907
17865,Katrin,F,9,3253237,17723
17866,Kauan,M,9,3253246,17061
17867,Kayin,M,9,3253255,17786
17868,Kaylynne,F,9,3253264,17343
17869,Kaymarie,F,9,3253273,17186
17870,Kayon,M,9,3253282,17578
17871,Kayoni,F,9,3253291,17184
17872,Kayse,M,9,3253300,17542
17873,Kaysi,F,9,3253309,17118
17874,Kaysn,M,9,3253318,17710
17875,Kaziyah,F,9,3253327,17976
17876,Kazmir,M,9,3253336,17784
17877,Keaghan,M,9,3253345,17239
17878,Kealan,M,9,3253354,17583
17879,Keano,M,9,3253363,17505
17880,Keela,F,9,3253372,17756
17881,Keelen,M,9,3253381,17601
17882,Keeli,F,9,3253390,17356
17883,Keena,F,9,3253399,17077
17884,Keenen,M,9,3253408,17180
17885,Kefren,M,9,3253417,17622
17886,Kehinde,M,9,3253426,17191
17887,Kehlany,F,9,3253435,17007
17888,Keilana,F,9,3253444,17888
17889,Keilianys,F,9,3253453,17705
17890,Kel,M,9,3253462,17573
17891,Kelanie,F,9,3253471,17692
17892,Kelbi,F,9,3253480,17869
17893,Keliana,F,9,3253489,17084
17894,Kelin,M,9,3253498,17632
17895,Kelina,F,9,3253507,17594
17896,Kelise,F,9,3253516,17015
17897,Kelvyn,M,9,3253525,17452
17898,Kelyn,M,9,3253534,17382
17899,Kemily,F,9,3253543,17126
17900,Kendale,M,9,3253552,17127
17901,Kendel,M,9,3253561,17353
17902,Kendy,F,9,3253570,17538
17903,Keniya,F,9,3253579,17045
17904,Kenlyn,F,9,3253588,17018
17905,Keslee,F,9,3253597,17899
17906,Kessa,F,9,3253606,17222
17907,Kevontae,M,9,3253615,17615
17908,Kevonte,M,9,3253624,17394
17909,Keygan,M,9,3253633,17291
17910,Keyleigh,F,9,3253642,17110
17911,Keylen,F,9,3253651,17201
17912,Keziyah,F,9,3253660,17078
17913,Khabib,M,9,3253669,17468
17914,Khadim,M,9,3253678,17861
17915,Khair,M,9,3253687,17209
17916,Khalee,M,9,3253696,17005
17917,Khaleesy,F,9,3253705,17300
17918,Khaleo,M,9,3253714,17557
17919,Khaleyah,F,9,3253723,17767
17920,Khalib,M,9,3253732,17041
17921,Khalie,F,9,3253741,17131
17922,Khalief,M,9,3253750,17527
17923,Khaliel,M,9,3253759,17531
17924,Khalis,F,9,3253768,17389
17925,Khallie,F,9,3253777,17384
17926,Khamya,F,9,3253786,17393
17927,Khani,M,9,3253795,17449
17928,Khaos,M,9,3253804,17570
17929,Khareem,M,9,3253813,17998
17930,Kharlee,F,9,3253822,17056
17931,Kharlie,F,9,3253831,17676
17932,Kharsyn,M,9,3253840,17536
17933,Khash,M,9,3253849,17942
17934,Khayri,M,9,3253858,17244
17935,Khiree,M,9,3253867,17148
17936,Khiyah,F,9,3253876,17420
17937,Khodi,M,9,3253885,17862
17938,Khora,F,9,3253894,17085
17939,Khylani,F,9,3253903,17924
17940,Khyon,M,9,3253912,17473
17941,Kida,F,9,3253921,17687
17942,Kiefer,M,9,3253930,17740
17943,Kiko,M,9,3253939,17979
17944,Kindred,M,9,3253948,17487
17945,Kinsler,M,9,3253957,17099
17946,Kinze,F,9,3253966,17100
17947,Kinzey,F,9,3253975,17908
17948,Kinzi,F,9,3253984,17523
17949,Kinzy,F,9,3253993,17237
17950,Kiona,F,9,3254002,17933
17951,Kionna,F,9,3254011,17937
17952,Kipling,M,9,3254020,17955
17953,Kiren,M,9,3254029,17856
17954,Kiri,F,9,3254038,17591
17955,Kirstyn,F,9,3254047,17089
17956,Kishan,M,9,3254056,17994
17957,Kiva,F,9,3254065,17746
17958,Klair,F,9,3254074,17718
17959,Kmora,F,9,3254083,17114
17960,Knightley,F,9,3254092,17748
17961,Knightly,M,9,3254101,17211
17962,Knoxlee,M,9,3254110,17410
17963,Kodak,M,9,3254119,17416
17964,Koralyn,F,9,3254128,17295
17965,Kord,M,9,3254137,17200
17966,Korina,F,9,3254146,17574
17967,Kosisochukwu,M,9,3254155,17548
17968,Krimsyn,F,9,3254164,17135
17969,Kristianna,F,9,3254173,17617
17970,Kristof,M,9,3254182,17555
17971,Kueen,F,9,3254191,17684
17972,Kwesi,M,9,3254200,17286
17973,Kyeson,M,9,3254209,17009
17974,Kyheem,M,9,3254218,17892
17975,Kynd,F,9,3254227,17630
17976,Kyngsten,M,9,3254236,17062
17977,Kyo,M,9,3254245,17990
17978,Kyonna,F,9,3254254,17666
17979,Kyreese,M,9,3254263,17709
17980,Kyzar,M,9,3254272,17075
17981,Laelani,F,9,3254281,17134
17982,Lailyn,F,9,3254290,17855
17983,Laird,M,9,3254299,17252
17984,Laithan,M,9,3254308,17492
17985,Lakelan,M,9,3254317,17508
17986,Lakelee,F,9,3254326,17254
17987,Laklyn,F,9,3254335,17374
17988,Lalia,F,9,3254344,17331
17989,Lam,M,9,3254353,17316
17990,Lamelo,M,9,3254362,17415
17991,Lamine,M,9,3254371,17595
17992,Lanier,M,9,3254380,17246
17993,Lanita,F,9,3254389,17539
17994,Larae,F,9,3254398,17436
17995,Larell,M,9,3254407,17522
17996,Laritza,F,9,3254416,17866
17997,Larue,M,9,3254425,17113
17998,Laryah,F,9,3254434,17721
17999,Lashay,F,9,3254443,17556
18000,Latavion,M,9,3254452,18482
18001,Lateef,M,9,3254461,18521
18002,Latifa,F,9,3254470,18912
18003,Lauriel,F,9,3254479,18937
18004,Laury,F,9,3254488,18219
18005,Lavae,F,9,3254497,18470
18006,Lavonne,F,9,3254506,18110
18007,Layanne,F,9,3254515,18012
18008,Layelle,F,9,3254524,18730
18009,Laylarose,F,9,3254533,18628
18010,Laylen,F,9,3254542,18103
18011,Laythan,M,9,3254551,18400
18012,Leahni,F,9,3254560,18320
18013,Leart,M,9,3254569,18117
18014,Leeanne,F,9,3254578,18749
18015,Leelynn,F,9,3254587,18135
18016,Leeyah,F,9,3254596,18697
18017,Leihlani,F,9,3254605,18240
18018,Leilahni,F,9,3254614,18106
18019,Len,M,9,3254623,18928
18020,Lenah,F,9,3254632,18593
18021,Lenorah,F,9,3254641,18223
18022,Leonell,M,9,3254650,18998
18023,Leonila,F,9,3254659,18862
18024,Levar,M,9,3254668,18919
18025,Leyan,F,9,3254677,18407
18026,Leyani,F,9,3254686,18307
18027,Leydi,F,9,3254695,18707
18028,Liahm,M,9,3254704,18233
18029,Lianah,F,9,3254713,18319
18030,Lianni,F,9,3254722,18413
18031,Light,M,9,3254731,18027
18032,Liliuokalani,F,9,3254740,18927
18033,Lilyanah,F,9,3254749,18161
18034,Lilyani,F,9,3254758,18235
18035,Linette,F,9,3254767,18287
18036,Linnie,F,9,3254776,18733
18037,Lis,F,9,3254785,18796
18038,Lisandra,F,9,3254794,18136
18039,Liyu,F,9,3254803,18855
18040,Loah,F,9,3254812,18173
18041,Lochlainn,M,9,3254821,18738
18042,Lonna,F,9,3254830,18671
18043,Lonny,M,9,3254839,18608
18044,Loriann,F,9,3254848,18762
18045,Lorianne,F,9,3254857,18215
18046,Lorie,F,9,3254866,18948
18047,Lorin,F,9,3254875,18196
18048,Lorrie,F,9,3254884,18954
18049,Lovey,F,9,3254893,18669
18050,Loza,F,9,3254902,18040
18051,Lucette,F,9,3254911,18946
18052,Lucine,F,9,3254920,18490
18053,Lucyanna,F,9,3254929,18591
18054,Lunamae,F,9,3254938,18600
18055,Lunarae,F,9,3254947,18382
18056,Lura,F,9,3254956,18058
18057,Lyall,M,9,3254965,18009
18058,Lyann,F,9,3254974,18184
18059,Lykan,M,9,3254983,18224
18060,Lylith,F,9,3254992,18843
18061,Lyndy,F,9,3255001,18309
18062,Lynsey,F,9,3255010,18363
18063,Lynzee,F,9,3255019,18127
18064,Lyonel,M,9,3255028,18673
18065,Maasai,M,9,3255037,18994
18066,Macaulay,M,9,3255046,18777
18067,Maccabee,M,9,3255055,18819
18068,Machi,M,9,3255064,18782
18069,Macrae,M,9,3255073,18208
18070,Madalin,F,9,3255082,18936
18071,Maddeline,F,9,3255091,18838
18072,Madyn,F,9,3255100,18820
18073,Maev,F,9,3255109,18168
18074,Magda,F,9,3255118,18464
18075,Maguire,M,9,3255127,18687
18076,Mahathi,F,9,3255136,18824
18077,Mahelet,F,9,3255145,18253
18078,Mahli,F,9,3255154,18441
18079,Maileen,F,9,3255163,18420
18080,Maisa,F,9,3255172,18821
18081,Makaveli,M,9,3255181,18022
18082,Makda,F,9,3255190,18984
18083,Makye,M,9,3255199,18609
18084,Malauni,F,9,3255208,18148
18085,Malayasia,F,9,3255217,18500
18086,Malayshia,F,9,3255226,18648
18087,Maleeyah,F,9,3255235,18685
18088,Malinah,F,9,3255244,18539
18089,Malix,M,9,3255253,18606
18090,Malkiel,M,9,3255262,18201
18091,Mallex,M,9,3255271,18725
18092,Malon,F,9,3255280,18349
18093,Mani,M,9,3255289,18926
18094,Manvi,F,9,3255298,18380
18095,Marabelle,F,9,3255307,18604
18096,Marcelline,F,9,3255316,18061
18097,Mareli,F,9,3255325,18101
18098,Margalit,F,9,3255334,18754
18099,Mariaclara,F,9,3255343,18403
18100,Marianny,F,9,3255352,18145
18101,Maribeth,F,9,3255361,18086
18102,Marielys,F,9,3255370,18432
18103,Marifer,F,9,3255379,18716
18104,Mariko,F,9,3255388,18111
18105,Marilla,F,9,3255397,18083
18106,Mariluz,F,9,3255406,18379
18107,Marjory,F,9,3255415,18496
18108,Markelle,M,9,3255424,18952
18109,Markez,M,9,3255433,18841
18110,Martel,M,9,3255442,18664
18111,Martino,M,9,3255451,18473
18112,Maryella,F,9,3255460,18391
18113,Maryelle,F,9,3255469,18213
18114,Massa,F,9,3255478,18571
18115,Mataio,M,9,3255487,18641
18116,Matson,M,9,3255496,18365
18117,Mattheus,M,9,3255505,18302
18118,Mattisyn,F,9,3255514,18051
18119,Mauriana,F,9,3255523,18891
18120,Mavin,M,9,3255532,18566
18121,Maxten,M,9,3255541,18383
18122,Maybrie,F,9,3255550,18790
18123,Maye,F,9,3255559,18435
18124,Mazal,F,9,3255568,18036
18125,Mckai,M,9,3255577,18080
18126,Mckenlee,F,9,3255586,18584
18127,Mckensie,F,9,3255595,18331
18128,Meisha,F,9,3255604,18049
18129,Melana,F,9,3255613,18005
18130,Melanii,F,9,3255622,18212
18131,Melanni,F,9,3255631,18094
18132,Melik,M,9,3255640,18357
18133,Mella,F,9,3255649,18198
18134,Mellody,F,9,3255658,18085
18135,Memorie,F,9,3255667,18404
18136,Mercury,M,9,3255676,18430
18137,Meriem,F,9,3255685,18392
18138,Merric,M,9,3255694,18892
18139,Meshach,M,9,3255703,18045
18140,Mesiyah,M,9,3255712,18345
18141,Messiyah,M,9,3255721,18917
18142,Michalina,F,9,3255730,18703
18143,Mickenzie,F,9,3255739,18770
18144,Miel,F,9,3255748,18425
18145,Mielle,F,9,3255757,18122
18146,Mihail,M,9,3255766,18479
18147,Mikaele,M,9,3255775,18190
18148,Mikale,M,9,3255784,18834
18149,Mikayel,M,9,3255793,18717
18150,Mikeal,M,9,3255802,18832
18151,Minal,F,9,3255811,18698
18152,Minato,M,9,3255820,18099
18153,Mindel,F,9,3255829,18888
18154,Minette,F,9,3255838,18200
18155,Mirajane,F,9,3255847,18262
18156,Miria,F,9,3255856,18557
18157,Mishelle,F,9,3255865,18007
18158,Mitsuki,F,9,3255874,18010
18159,Miura,F,9,3255883,18090
18160,Miyonna,F,9,3255892,18524
18161,Moe,M,9,3255901,18857
18162,Moise,M,9,3255910,18990
18163,Mollee,F,9,3255919,18943
18164,Momodou,M,9,3255928,18848
18165,Montreal,M,9,3255937,18278
18166,Morad,M,9,3255946,18098
18167,Morayo,F,9,3255955,18529
18168,Mordekai,M,9,3255964,18534
18169,Mucad,M,9,3255973,18665
18170,Mutasim,M,9,3255982,18981
18171,Mykael,M,9,3255991,18444
18172,Mykenzie,F,9,3256000,18975
18173,Myloh,M,9,3256009,18165
18174,Mylon,M,9,3256018,18232
18175,Myrakle,F,9,3256027,18616
18176,Myrcella,F,9,3256036,18247
18177,Myson,M,9,3256045,18675
18178,Naazir,M,9,3256054,18966
18179,Nadim,M,9,3256063,18104
18180,Nahshon,M,9,3256072,18643
18181,Naimal,F,9,3256081,18724
18182,Naja,F,9,3256090,18078
18183,Najae,F,9,3256099,18115
18184,Nakiah,F,9,3256108,18066
18185,Nakira,F,9,3256117,18526
18186,Nakul,M,9,3256126,18372
18187,Naleigha,F,9,3256135,18507
18188,Naleyah,F,9,3256144,18487
18189,Namari,M,9,3256153,18586
18190,Namira,F,9,3256162,18806
18191,Namirah,F,9,3256171,18093
18192,Naol,M,9,3256180,18677
18193,Narjis,F,9,3256189,18786
18194,Nashawn,M,9,3256198,18305
18195,Nataley,F,9,3256207,18714
18196,Natalin,F,9,3256216,18217
18197,Natallie,F,9,3256225,18986
18198,Naven,M,9,3256234,18150
18199,Nayani,F,9,3256243,18931
18200,Nayelie,F,9,3256252,18158
18201,Nayvi,F,9,3256261,18494
18202,Nazifa,F,9,3256270,18789
18203,Nea,F,9,3256279,18434
18204,Neala,F,9,3256288,18248
18205,Neena,F,9,3256297,18646
18206,Neera,F,9,3256306,18809
18207,Nehlani,F,9,3256315,18360
18208,Nelvin,M,9,3256324,18226
18209,Neri,M,9,3256333,18932
18210,Nerissa,F,9,3256342,18141
18211,Neytiri,F,9,3256351,18598
18212,Ngozi,F,9,3256360,18759
18213,Nida,F,9,3256369,18845
18214,Nidia,F,9,3256378,18411
18215,Nieva,F,9,3256387,18410
18216,Niharika,F,9,3256396,18967
18217,Nik,M,9,3256405,18877
18218,Nikolette,F,9,3256414,18520
18219,Nilo,M,9,3256423,18164
18220,Nilsa,F,9,3256432,18405
18221,Niranjan,M,9,3256441,18337
18222,Niveah,F,9,3256450,18537
18223,Nixen,M,9,3256459,18602
18224,Niyanna,F,9,3256468,18823
18225,Noahjames,M,9,3256477,18625
18226,Noralee,F,9,3256486,18546
18227,Noriyah,F,9,3256495,18839
18228,Nouman,M,9,3256504,18544
18229,Novaa,F,9,3256513,18837
18230,Novarae,F,9,3256522,18059
18231,Nusaibah,F,9,3256531,18771
18232,Nusrat,F,9,3256540,18390
18233,Nyelah,F,9,3256549,18338
18234,Nyrah,F,9,3256558,18205
18235,Nyriah,F,9,3256567,18442
18236,Nyxon,M,9,3256576,18709
18237,Nzuri,F,9,3256585,18210
18238,Odilia,F,9,3256594,18699
18239,Olaf,M,9,3256603,18170
18240,Olani,F,9,3256612,18791
18241,Oluwashindara,F,9,3256621,18285
18242,Oluwatoni,F,9,3256630,18764
18243,Omaria,F,9,3256639,18817
18244,Omarii,M,9,3256648,18887
18245,Omid,M,9,3256657,18073
18246,Omran,M,9,3256666,18880
18247,Ondine,F,9,3256675,18765
18248,Oneal,M,9,3256684,18417
18249,Onix,M,9,3256693,18547
18250,Oryon,M,9,3256702,18457
18251,Oshen,M,9,3256711,18945
18252,Osyris,M,9,3256720,18312
18253,Otilia,F,9,3256729,18866
18254,Ovee,F,9,3256738,18130
18255,Ozil,M,9,3256747,18594
18256,Ozymandias,M,9,3256756,18662
18257,Paeton,F,9,3256765,18081
18258,Paiton,F,9,3256774,18634
18259,Parin,M,9,3256783,18590
18260,Park,M,9,3256792,18706
18261,Pasleigh,F,9,3256801,18348
18262,Paxten,M,9,3256810,18406
18263,Paysen,F,9,3256819,18503
18264,Payzleigh,F,9,3256828,18401
18265,Pema,F,9,3256837,18257
18266,Penelopy,F,9,3256846,18763
18267,Persephanie,F,9,3256855,18416
18268,Petronila,F,9,3256864,18569
18269,Philipp,M,9,3256873,18003
18270,Portlyn,F,9,3256882,18297
18271,Portlynn,F,9,3256891,18100
18272,Posy,F,9,3256900,18361
18273,Power,M,9,3256909,18041
18274,Pragyan,M,9,3256918,18308
18275,Prakriti,F,9,3256927,18501
18276,Pratyush,M,9,3256936,18718
18277,Priam,M,9,3256945,18436
18278,Prometheus,M,9,3256954,18951
18279,Pure,F,9,3256963,18497
18280,Quantez,M,9,3256972,18231
18281,Quashawn,M,9,3256981,18315
18282,Quincie,F,9,3256990,18326
18283,Quynh,F,9,3256999,18155
18284,Racheal,F,9,3257008,18077
18285,Raeden,M,9,3257017,18335
18286,Raedyn,F,9,3257026,18645
18287,Raees,M,9,3257035,18355
18288,Raelie,F,9,3257044,18979
18289,Raeven,F,9,3257053,18746
18290,Rafferty,M,9,3257062,18292
18291,Raielle,F,9,3257071,18702
18292,Raking,M,9,3257080,18455
18293,Raksha,F,9,3257089,18298
18294,Ralston,M,9,3257098,18295
18295,Ramin,M,9,3257107,18449
18296,Randa,F,9,3257116,18276
18297,Raniah,F,9,3257125,18558
18298,Raphaela,F,9,3257134,18958
18299,Rasha,F,9,3257143,18030
18300,Rasheen,M,9,3257152,18179
18301,Ravin,F,9,3257161,18580
18302,Ravya,F,9,3257170,18753
18303,Rayyona,F,9,3257179,18052
18304,Reagyn,F,9,3257188,18505
18305,Reata,F,9,3257197,18330
18306,Rehana,F,9,3257206,18828
18307,Reilyn,F,9,3257215,18585
18308,Rein,F,9,3257224,18583
18309,Reizel,F,9,3257233,18740
18310,Relena,F,9,3257242,18588
18311,Remii,F,9,3257251,18900
18312,Reveille,F,9,3257260,18424
18313,Reylin,F,9,3257269,18964
18314,Reyn,M,9,3257278,18042
18315,Reznor,M,9,3257287,18388
18316,Rhaegan,F,9,3257296,18071
18317,Rhia,F,9,3257305,18626
18318,Rhoan,M,9,3257314,18188
18319,Rhoen,M,9,3257323,18996
18320,Ridhima,F,9,3257332,18216
18321,Riordan,M,9,3257341,18570
18322,Rito,M,9,3257350,18163
18323,Riyann,F,9,3257359,18635
18324,Roane,M,9,3257368,18013
18325,Rodriquez,M,9,3257377,18515
18326,Roha,F,9,3257386,18481
18327,Rojelio,M,9,3257395,18636
18328,Rolen,M,9,3257404,18914
18329,Romulo,M,9,3257413,18750
18330,Ronal,M,9,3257422,18985
18331,Roohi,F,9,3257431,18885
18332,Rosalio,M,9,3257440,18573
18333,Rosana,F,9,3257449,18781
18334,Rosealyn,F,9,3257458,18448
18335,Roselynne,F,9,3257467,18722
18336,Roshawn,M,9,3257476,18960
18337,Rosibel,F,9,3257485,18273
18338,Royer,M,9,3257494,18592
18339,Ruqayya,F,9,3257503,18131
18340,Ruthanne,F,9,3257512,18333
18341,Ruthvik,M,9,3257521,18864
18342,Rutila,F,9,3257530,18587
18343,Rutvik,M,9,3257539,18549
18344,Ruwayda,F,9,3257548,18666
18345,Ryane,F,9,3257557,18195
18346,Rykker,M,9,3257566,18941
18347,Rylend,M,9,3257575,18854
18348,Ryliee,F,9,3257584,18999
18349,Sabiha,F,9,3257593,18265
18350,Sabirin,F,9,3257602,18414
18351,Sabri,M,9,3257611,18865
18352,Saga,F,9,3257620,18818
18353,Sager,M,9,3257629,18328
18354,Sahaan,M,9,3257638,18922
18355,Sahal,M,9,3257647,18560
18356,Sahiba,F,9,3257656,18230
18357,Saidee,F,9,3257665,18579
18358,Sailah,F,9,3257674,18844
18359,Sala,F,9,3257683,18288
18360,Samarion,M,9,3257692,18351
18361,Samhita,F,9,3257701,18620
18362,Sammantha,F,9,3257710,18344
18363,Samriddhi,F,9,3257719,18227
18364,Sanah,F,9,3257728,18658
18365,Sanders,M,9,3257737,18152
18366,Sanskriti,F,9,3257746,18206
18367,Saphia,F,9,3257755,18578
18368,Sapphyre,F,9,3257764,18015
18369,Saraia,F,9,3257773,18805
18370,Sarrinah,F,9,3257782,18183
18371,Sava,M,9,3257791,18732
18372,Savi,F,9,3257800,18846
18373,Sayd,M,9,3257809,18011
18374,Saylem,F,9,3257818,18681
18375,Sayyora,F,9,3257827,18089
18376,Sebastain,M,9,3257836,18779
18377,Sebastiana,F,9,3257845,18939
18378,Sedra,F,9,3257854,18447
18379,Sekhani,M,9,3257863,18787
18380,Seleem,M,9,3257872,18250
18381,Senan,M,9,3257881,18589
18382,Seraph,F,9,3257890,18773
18383,Serenitie,F,9,3257899,18980
18384,Sevi,F,9,3257908,18311
18385,Seydina,M,9,3257917,18710
18386,Shaia,F,9,3257926,18343
18387,Shaka,M,9,3257935,18026
18388,Shakai,M,9,3257944,18565
18389,Shamus,M,9,3257953,18969
18390,Shan,M,9,3257962,18142
18391,Shanvika,F,9,3257971,18607
18392,Sharav,M,9,3257980,18947
18393,Sharbel,M,9,3257989,18920
18394,Shashank,M,9,3257998,18705
18395,Shaylyn,F,9,3258007,18175
18396,Sheikh,M,9,3258016,18043
18397,Shelsy,F,9,3258025,18222
18398,Sherwin,M,9,3258034,18091
18399,Shivan,M,9,3258043,18532
18400,Shivika,F,9,3258052,18530
18401,Shoaib,M,9,3258061,18562
18402,Shomari,M,9,3258070,18491
18403,Shreyash,M,9,3258079,18686
18404,Shulamis,F,9,3258088,18471
18405,Shun,M,9,3258097,18564
18406,Shyheim,M,9,3258106,18538
18407,Shymir,M,9,3258115,18244
18408,Sidnee,F,9,3258124,18356
18409,Silus,M,9,3258133,18339
18410,Silvano,M,9,3258142,18109
18411,Sira,F,9,3258151,18802
18412,Sireen,F,9,3258160,18211
18413,Siris,M,9,3258169,18202
18414,Sirkingston,M,9,3258178,18883
18415,Slaton,M,9,3258187,18729
18416,Soheila,F,9,3258196,18816
18417,Solar,F,9,3258205,18181
18418,Solaris,M,9,3258214,18452
18419,Soley,F,9,3258223,18743
18420,Solon,M,9,3258232,18797
18421,Solvi,F,9,3258241,18511
18422,Sosaia,M,9,3258250,18852
18423,Sota,M,9,3258259,18421
18424,Sriansh,M,9,3258268,18509
18425,Sritha,F,9,3258277,18368
18426,Starlet,F,9,3258286,18835
18427,Starlette,F,9,3258295,18186
18428,Starlin,M,9,3258304,18156
18429,Steely,F,9,3258313,18574
18430,Stelios,M,9,3258322,18133
18431,Sterlin,M,9,3258331,18527
18432,Suede,F,9,3258340,18377
18433,Suhan,M,9,3258349,18633
18434,Sukaina,F,9,3258358,18991
18435,Surafel,M,9,3258367,18113
18436,Surai,F,9,3258376,18157
18437,Swecha,F,9,3258385,18182
18438,Sya,F,9,3258394,18989
18439,Sybella,F,9,3258403,18399
18440,Symphanie,F,9,3258412,18008
18441,Synai,F,9,3258421,18139
18442,Syrena,F,9,3258430,18623
18443,Taaliah,F,9,3258439,18239
18444,Tabatha,F,9,3258448,18054
18445,Taedyn,M,9,3258457,18063
18446,Taheem,M,9,3258466,18663
18447,Tahmid,M,9,3258475,18619
18448,Taia,F,9,3258484,18783
18449,Tajir,M,9,3258493,18419
18450,Takashi,M,9,3258502,18890
18451,Talayla,F,9,3258511,18575
18452,Taleia,F,9,3258520,18283
18453,Tally,F,9,3258529,18615
18454,Talmadge,M,9,3258538,18192
18455,Talmage,M,9,3258547,18458
18456,Tamika,F,9,3258556,18522
18457,Tamira,F,9,3258565,18160
18458,Tamzin,F,9,3258574,18397
18459,Tao,M,9,3258583,18134
18460,Tarun,M,9,3258592,18108
18461,Tatiyana,F,9,3258601,18684
18462,Tavior,M,9,3258610,18035
18463,Tayron,M,9,3258619,18445
18464,Teak,M,9,3258628,18977
18465,Teancum,M,9,3258637,18745
18466,Teller,M,9,3258646,18997
18467,Temur,M,9,3258655,18472
18468,Tena,F,9,3258664,18924
18469,Teniola,F,9,3258673,18851
18470,Tennison,M,9,3258682,18484
18471,Teron,M,9,3258691,18660
18472,Terren,M,9,3258700,18627
18473,Terrick,M,9,3258709,18095
18474,Terrill,M,9,3258718,18747
18475,Terriyah,F,9,3258727,18321
18476,Thai,M,9,3258736,18324
18477,Thessaly,F,9,3258745,18556
18478,Thoreau,M,9,3258754,18478
18479,Thorson,M,9,3258763,18899
18480,Thurman,M,9,3258772,18595
18481,Tiare,F,9,3258781,18102
18482,Timberlyn,F,9,3258790,18775
18483,Tiyanna,F,9,3258799,18748
18484,Toa,M,9,3258808,18769
18485,Tobyn,M,9,3258817,18074
18486,Toney,M,9,3258826,18280
18487,Tovia,M,9,3258835,18016
18488,Trany,F,9,3258844,18737
18489,Tremell,M,9,3258853,18712
18490,Treyon,M,9,3258862,18076
18491,Treyveon,M,9,3258871,18577
18492,Trezure,F,9,3258880,18950
18493,Trillion,M,9,3258889,18044
18494,Trishan,M,9,3258898,18327
18495,Trishika,F,9,3258907,18849
18496,Tyaira,F,9,3258916,18859
18497,Tyheem,M,9,3258925,18680
18498,Tyion,M,9,3258934,18272
18499,Tylia,F,9,3258943,18792
18500,Tylyn,M,9,3258952,18863
18501,Tyrann,M,9,3258961,18870
18502,Tyvon,M,9,3258970,18018
18503,Ulisses,M,9,3258979,18637
18504,Ulric,M,9,3258988,18701
18505,Ulrich,M,9,3258997,18021
18506,Umaiza,F,9,3259006,18469
18507,Urwa,F,9,3259015,18318
18508,Uwais,M,9,3259024,18334
18509,Vaanya,F,9,3259033,18020
18510,Vaden,M,9,3259042,18893
18511,Vaidehi,F,9,3259051,18780
18512,Valon,M,9,3259060,18831
18513,Valyn,F,9,3259069,18910
18514,Varvara,F,9,3259078,18639
18515,Vedder,M,9,3259087,18734
18516,Vegas,M,9,3259096,18234
18517,Vena,F,9,3259105,18642
18518,Vernell,M,9,3259114,18477
18519,Vihaanreddy,M,9,3259123,18310
18520,Viraansh,M,9,3259132,18499
18521,Vishwa,M,9,3259141,18171
18522,Vision,F,9,3259150,18313
18523,Vitali,M,9,3259159,18886
18524,Vivaansh,M,9,3259168,18004
18525,Vivek,M,9,3259177,18873
18526,Vivyana,F,9,3259186,18176
18527,Vyolet,F,9,3259195,18683
18528,Wander,M,9,3259204,18079
18529,Wania,F,9,3259213,18913
18530,Wasif,M,9,3259222,18836
18531,Whisper,F,9,3259231,18177
18532,Willliam,M,9,3259240,18293
18533,Winton,M,9,3259249,18774
18534,Wyat,M,9,3259258,18613
18535,Wyett,M,9,3259267,18957
18536,Wyn,M,9,3259276,18576
18537,Xael,M,9,3259285,18976
18538,Xaine,M,9,3259294,18867
18539,Xakai,M,9,3259303,18024
18540,Xochi,F,9,3259312,18402
18541,Xyah,F,9,3259321,18178
18542,Yadel,M,9,3259330,18512
18543,Yailin,F,9,3259339,18238
18544,Yaira,F,9,3259348,18429
18545,Yamilex,F,9,3259357,18906
18546,Yanky,M,9,3259366,18246
18547,Yar,F,9,3259375,18065
18548,Yarieliz,F,9,3259384,18284
18549,Yaw,M,9,3259393,18536
18550,Yaxeni,F,9,3259402,18291
18551,Yecheskel,M,9,3259411,18028
18552,Yeico,M,9,3259420,18266
18553,Yetzael,M,9,3259429,18367
18554,Yinuo,F,9,3259438,18450
18555,Yisel,F,9,3259447,18172
18556,Ynez,F,9,3259456,18393
18557,Yolani,F,9,3259465,18963
18558,Yomar,M,9,3259474,18559
18559,Yoni,M,9,3259483,18126
18560,York,M,9,3259492,18657
18561,Yousof,M,9,3259501,18252
18562,Yovanny,M,9,3259510,18023
18563,Yudith,F,9,3259519,18667
18564,Yujin,M,9,3259528,18868
18565,Yusei,M,9,3259537,18340
18566,Yuval,M,9,3259546,18199
18567,Yuven,M,9,3259555,18286
18568,Yuxi,F,9,3259564,18568
18569,Zacai,M,9,3259573,18785
18570,Zaelah,F,9,3259582,18418
18571,Zafar,M,9,3259591,18956
18572,Zafira,F,9,3259600,18930
18573,Zahkai,M,9,3259609,18029
18574,Zahkari,M,9,3259618,18895
18575,Zahlee,F,9,3259627,18651
18576,Zailen,M,9,3259636,18166
18577,Zainah,F,9,3259645,18325
18578,Zaivion,M,9,3259654,18412
18579,Zakye,M,9,3259663,18064
18580,Zalani,F,9,3259672,18462
18581,Zaliah,F,9,3259681,18254
18582,Zalika,F,9,3259690,18128
18583,Zamere,M,9,3259699,18826
18584,Zamyrah,F,9,3259708,18807
18585,Zaqueo,M,9,3259717,18480
18586,Zarae,F,9,3259726,18495
18587,Zarian,M,9,3259735,18366
18588,Zavia,F,9,3259744,18961
18589,Zaylei,F,9,3259753,18679
18590,Zayneb,F,9,3259762,18909
18591,Zeid,M,9,3259771,18752
18592,Zeplynn,F,9,3259780,18629
18593,Zeriyah,F,9,3259789,18624
18594,Zhari,F,9,3259798,18332
18595,Ziaan,M,9,3259807,18053
18596,Zoa,F,9,3259816,18601
18597,Zoegrace,F,9,3259825,18118
18598,Zohair,M,9,3259834,18784
18599,Zoltan,M,9,3259843,18046
18600,Zoren,M,9,3259852,18800
18601,Zoria,F,9,3259861,18582
18602,Zorie,F,9,3259870,18965
18603,Zuhair,M,9,3259879,18801
18604,Zuhal,F,9,3259888,18048
18605,Zvi,M,9,3259897,18440
18606,Zyer,M,9,3259906,18123
18607,Zykeria,F,9,3259915,18220
18608,Zylar,M,9,3259924,18934
18609,Zymira,F,9,3259933,18359
18610,Zyniah,F,9,3259942,18850
18611,Zynique,F,9,3259951,18268
18612,Zyrell,M,9,3259960,18955
18613,Zyrus,M,9,3259969,18682
18614,Zyva,F,9,3259978,18249
18615,Aahna,F,8,3259986,18322
18616,Aakil,M,8,3259994,18426
18617,Aalina,F,8,3260002,18876
18618,Aaralynn,F,8,3260010,18256
18619,Aarik,M,8,3260018,18972
18620,Aarohan,M,8,3260026,18929
18621,Aarunya,F,8,3260034,18610
18622,Aaryash,M,8,3260042,18611
18623,Aasiya,F,8,3260050,18461
18624,Abagale,F,8,3260058,18540
18625,Aban,M,8,3260066,18829
18626,Abdihakim,M,8,3260074,18185
18627,Abdulsamad,M,8,3260082,18204
18628,Abednego,M,8,3260090,18982
18629,Abhijot,M,8,3260098,18713
18630,Abimelec,M,8,3260106,18385
18631,Abiola,F,8,3260114,18236
18632,Aboubakar,M,8,3260122,18860
18633,Abrum,M,8,3260130,18739
18634,Abu,M,8,3260138,18282
18635,Acesen,M,8,3260146,18149
18636,Action,M,8,3260154,18603
18637,Acyn,M,8,3260162,18422
18638,Adalayah,F,8,3260170,18528
18639,Adalicia,F,8,3260178,18460
18640,Adalinn,F,8,3260186,18121
18641,Adamarie,F,8,3260194,18736
18642,Adasyn,F,8,3260202,18618
18643,Adaugo,F,8,3260210,18269
18644,Addalie,F,8,3260218,18088
18645,Ade,M,8,3260226,18146
18646,Adelee,F,8,3260234,18245
18647,Adell,F,8,3260242,18433
18648,Adely,F,8,3260250,18661
18649,Adiana,F,8,3260258,18514
18650,Adiela,F,8,3260266,18518
18651,Adileny,F,8,3260274,18423
18652,Aditri,F,8,3260282,18174
18653,Adreanna,F,8,3260290,18346
18654,Adreena,F,8,3260298,18151
18655,Adri,F,8,3260306,18225
18656,Adrianah,F,8,3260314,18723
18657,Adrin,M,8,3260322,18443
18658,Adryen,M,8,3260330,18033
18659,Advita,F,8,3260338,18830
18660,Adwaith,M,8,3260346,18916
18661,Aelynn,F,8,3260354,18553
18662,Aengus,M,8,3260362,18630
18663,Afomia,F,8,3260370,18237
18664,Afruza,F,8,3260378,18438
18665,Agamveer,M,8,3260386,18362
18666,Agape,M,8,3260394,18347
18667,Aggie,F,8,3260402,18075
18668,Agostino,M,8,3260410,18395
18669,Ahmelia,F,8,3260418,18394
18670,Ahmira,F,8,3260426,18923
18671,Ahmiyah,F,8,3260434,18531
18672,Ahmyah,F,8,3260442,18096
18673,Ahnesty,F,8,3260450,18731
18674,Ahniyah,F,8,3260458,18506
18675,Ahonesty,F,8,3260466,18260
18676,Ahria,F,8,3260474,18006
18677,Ahzab,M,8,3260482,18493
18678,Ahzir,M,8,3260490,18437
18679,Ailanni,F,8,3260498,18541
18680,Ainhara,F,8,3260506,18439
18681,Airyn,F,8,3260514,18203
18682,Aishleen,F,8,3260522,18055
18683,Aixa,F,8,3260530,18087
18684,Aiylah,F,8,3260538,18060
18685,Ajdin,M,8,3260546,18092
18686,Akif,M,8,3260554,18678
18687,Akito,M,8,3260562,18002
18688,Alandra,F,8,3260570,18034
18689,Alanoud,F,8,3260578,18995
18690,Alaster,M,8,3260586,18691
18691,Alauni,F,8,3260594,18795
18692,Alban,M,8,3260602,18788
18693,Aldan,M,8,3260610,18875
18694,Aldric,M,8,3260618,18894
18695,Aldrick,M,8,3260626,18453
18696,Aleesa,F,8,3260634,18408
18697,Aleesha,F,8,3260642,18711
18698,Aleila,F,8,3260650,18525
18699,Alessander,M,8,3260658,18861
18700,Alexsandro,M,8,3260666,18056
18701,Aleynna,F,8,3260674,18597
18702,Alhasan,M,8,3260682,18720
18703,Alianis,F,8,3260690,18554
18704,Alie,F,8,3260698,18154
18705,Alii,M,8,3260706,18968
18706,Alila,F,8,3260714,18144
18707,Aliou,M,8,3260722,18431
18708,Alisabeth,F,8,3260730,18869
18709,Aliviyah,F,8,3260738,18933
18710,Allaina,F,8,3260746,18676
18711,Alleyah,F,8,3260754,18489
18712,Allizon,F,8,3260762,18140
18713,Allyse,F,8,3260770,18214
18714,Alontae,M,8,3260778,18647
18715,Alonte,M,8,3260786,18119
18716,Alyis,M,8,3260794,18396
18717,Alyria,F,8,3260802,18902
18718,Alyxander,M,8,3260810,18289
18719,Alyzae,F,8,3260818,18533
18720,Amaani,F,8,3260826,18942
18721,Amadi,M,8,3260834,18543
18722,Amair,M,8,3260842,18267
18723,Amaj,M,8,3260850,18143
18724,Amalah,F,8,3260858,18881
18725,Amarionna,F,8,3260866,18741
18726,Amarya,F,8,3260874,18833
18727,Amazi,M,8,3260882,18953
18728,Ambika,F,8,3260890,18908
18729,Ambriel,F,8,3260898,18897
18730,Amei,F,8,3260906,18374
18731,Ameliagrace,F,8,3260914,18466
18732,Amelianna,F,8,3260922,18191
18733,Amijah,F,8,3260930,18032
18734,Amiliyah,F,8,3260938,18097
18735,Amilli,F,8,3260946,18304
18736,Amillio,M,8,3260954,18342
18737,Amirali,M,8,3260962,18700
18738,Amirr,M,8,3260970,18904
18739,Amiyla,F,8,3260978,18744
18740,Amiyra,F,8,3260986,18125
18741,Ammiel,M,8,3260994,18974
18742,Amorra,F,8,3261002,18649
18743,Amparo,F,8,3261010,18468
18744,Amyis,M,8,3261018,18814
18745,Amyriah,F,8,3261026,18050
18746,Amyrie,F,8,3261034,18915
18747,Amzie,F,8,3261042,18373
18748,Anael,F,8,3261050,18314
18749,Anahita,F,8,3261058,18281
18750,Analaura,F,8,3261066,18903
18751,Anaria,F,8,3261074,18241
18752,Anariah,F,8,3261082,18758
18753,Anastaisa,F,8,3261090,18884
18754,Andalyn,F,8,3261098,18656
18755,Andel,M,8,3261106,18062
18756,Andersson,M,8,3261114,18483
18757,Andreaz,M,8,3261122,18519
18758,Andrzej,M,8,3261130,18303
18759,Anelisse,F,8,3261138,18810
18760,Aneudy,M,8,3261146,18638
18761,Aneya,F,8,3261154,18704
18762,Aneyah,F,8,3261162,18475
18763,Angella,F,8,3261170,18084
18764,Angelys,F,8,3261178,18189
18765,Aniella,F,8,3261186,18498
18766,Aniketh,M,8,3261194,18973
18767,Aniko,F,8,3261202,18959
18768,Anira,F,8,3261210,18721
18769,Anis,M,8,3261218,18274
18770,Anisah,F,8,3261226,18825
18771,Anisten,F,8,3261234,18878
18772,Annaleise,F,8,3261242,18692
18773,Annalina,F,8,3261250,18369
18774,Annalucia,F,8,3261258,18037
18775,Anthoney,M,8,3261266,18889
18776,Anthonie,M,8,3261274,18944
18777,Antonietta,F,8,3261282,18378
18778,Antonyo,M,8,3261290,18229
18779,Antrell,M,8,3261298,18354
18780,Aradhana,F,8,3261306,18137
18781,Arafat,M,8,3261314,18221
18782,Araiah,F,8,3261322,18510
18783,Arami,F,8,3261330,18561
18784,Araseli,F,8,3261338,18350
18785,Archit,M,8,3261346,18853
18786,Areanna,F,8,3261354,18017
18787,Aree,F,8,3261362,18456
18788,Arena,F,8,3261370,18259
18789,Ariann,F,8,3261378,18371
18790,Ariha,F,8,3261386,18039
18791,Arihaan,M,8,3261394,18858
18792,Arihan,M,8,3261402,18162
18793,Arisbel,F,8,3261410,18751
18794,Arjana,F,8,3261418,18653
18795,Aroush,F,8,3261426,18962
18796,Arpi,F,8,3261434,18364
18797,Arryanna,F,8,3261442,18617
18798,Arseniy,M,8,3261450,18940
18799,Arshad,M,8,3261458,18306
18800,Arslan,M,8,3261466,18299
18801,Artavious,M,8,3261474,18798
18802,Artimus,M,8,3261482,18921
18803,Arushi,F,8,3261490,18659
18804,Aryabella,F,8,3261498,18935
18805,Aryann,F,8,3261506,18772
18806,Aryzona,F,8,3261514,18840
18807,Asahel,M,8,3261522,18696
18808,Asahn,M,8,3261530,18116
18809,Asena,F,8,3261538,18107
18810,Ashawn,M,8,3261546,18270
18811,Ashayla,F,8,3261554,18463
18812,Ashdon,M,8,3261562,18971
18813,Ashmi,F,8,3261570,18551
18814,Ashot,M,8,3261578,18599
18815,Asil,M,8,3261586,18621
18816,Aslam,M,8,3261594,18517
18817,Astryd,F,8,3261602,18251
18818,Athina,F,8,3261610,18545
18819,Athiran,M,8,3261618,18808
18820,Atlanna,F,8,3261626,18261
18821,Atreyus,M,8,3261634,18992
18822,Aubreanna,F,8,3261642,18911
18823,Aubryana,F,8,3261650,18047
18824,Audre,F,8,3261658,18614
18825,Audreigh,F,8,3261666,18563
18826,Aum,M,8,3261674,18376
18827,Aureliana,F,8,3261682,18067
18828,Aureliano,M,8,3261690,18879
18829,Ausha,F,8,3261698,18057
18830,Avaeah,F,8,3261706,18640
18831,Avakate,F,8,3261714,18290
18832,Aveen,F,8,3261722,18294
18833,Aveleen,F,8,3261730,18898
18834,Averianna,F,8,3261738,18415
18835,Averiee,F,8,3261746,18631
18836,Averii,F,8,3261754,18502
18837,Averyrose,F,8,3261762,18384
18838,Avis,F,8,3261770,18159
18839,Aviyon,M,8,3261778,18031
18840,Avondre,M,8,3261786,18605
18841,Avree,F,8,3261794,18264
18842,Avreen,F,8,3261802,18336
18843,Avrielle,F,8,3261810,18387
18844,Avrumi,M,8,3261818,18301
18845,Awtumn,F,8,3261826,18070
18846,Ayal,M,8,3261834,18197
18847,Ayane,F,8,3261842,18988
18848,Ayanni,F,8,3261850,18708
18849,Ayari,F,8,3261858,18341
18850,Ayiana,F,8,3261866,18552
18851,Ayliah,F,8,3261874,18218
18852,Aynslee,F,8,3261882,18072
18853,Ayodeji,M,8,3261890,18670
18854,Ayomi,F,8,3261898,18767
18855,Ayomiposi,M,8,3261906,18352
18856,Ayslinn,F,8,3261914,18905
18857,Ayviana,F,8,3261922,18842
18858,Ayyan,M,8,3261930,18596
18859,Azaliya,F,8,3261938,18069
18860,Azeez,M,8,3261946,18105
18861,Azhar,M,8,3261954,18169
18862,Azyla,F,8,3261962,18693
18863,Babacar,M,8,3261970,18277
18864,Bahja,F,8,3261978,18756
18865,Bailie,F,8,3261986,18316
18866,Bailor,M,8,3261994,18459
18867,Baily,F,8,3262002,18874
18868,Bain,M,8,3262010,18719
18869,Bakary,M,8,3262018,18694
18870,Baleria,F,8,3262026,18271
18871,Balin,M,8,3262034,18428
18872,Balqees,F,8,3262042,18856
18873,Barett,M,8,3262050,18389
18874,Barnaby,M,8,3262058,18467
18875,Baxley,M,8,3262066,18776
18876,Bayani,M,8,3262074,18794
18877,Bayard,M,8,3262082,18799
18878,Baylin,F,8,3262090,18516
18879,Baylynn,F,8,3262098,18550
18880,Bearon,M,8,3262106,18735
18881,Bekah,F,8,3262114,18255
18882,Belia,F,8,3262122,18925
18883,Bellemy,M,8,3262130,18427
18884,Bena,F,8,3262138,18650
18885,Benedetto,M,8,3262146,18180
18886,Benjen,M,8,3262154,18688
18887,Benni,F,8,3262162,18882
18888,Bennington,M,8,3262170,18907
18889,Bento,M,8,3262178,18300
18890,Beorn,M,8,3262186,18492
18891,Beryl,F,8,3262194,18228
18892,Betzabeth,F,8,3262202,18409
18893,Beverley,F,8,3262210,18978
18894,Bezalel,M,8,3262218,18726
18895,Bhuvika,F,8,3262226,18690
18896,Bijou,F,8,3262234,18508
18897,Billi,F,8,3262242,18446
18898,Bisma,F,8,3262250,18279
18899,Bodyn,M,8,3262258,18847
18900,Bolton,M,8,3262266,18655
18901,Bowdy,M,8,3262274,18386
18902,Bradie,F,8,3262282,18760
18903,Bran,M,8,3262290,18014
18904,Braxtynn,M,8,3262298,18124
18905,Braylinn,F,8,3262306,18632
18906,Breighlyn,F,8,3262314,18987
18907,Breindel,F,8,3262322,18317
18908,Brenan,M,8,3262330,18082
18909,Brexlie,F,8,3262338,18827
18910,Briceson,M,8,3262346,18668
18911,Brick,M,8,3262354,18757
18912,Brighid,F,8,3262362,18612
18913,Britt,M,8,3262370,18454
18914,Brodhi,M,8,3262378,18768
18915,Brolin,M,8,3262386,18258
18916,Bronxx,M,8,3262394,18488
18917,Brooklinn,F,8,3262402,18019
18918,Broox,M,8,3262410,18548
18919,Bryah,F,8,3262418,18296
18920,Brynnan,F,8,3262426,18523
18921,Brynnlie,F,8,3262434,18542
18922,Burklee,F,8,3262442,18755
18923,Cace,M,8,3262450,18153
18924,Caedence,F,8,3262458,18896
18925,Caelix,M,8,3262466,18001
18926,Caid,M,8,3262474,18275
18927,Caleigha,F,8,3262482,18038
18928,Caleya,F,8,3262490,18187
18929,Caliegh,F,8,3262498,18465
18930,Calil,M,8,3262506,18644
18931,Calyn,F,8,3262514,18871
18932,Camauri,M,8,3262522,18728
18933,Cambreigh,F,8,3262530,18949
18934,Camela,F,8,3262538,18811
18935,Camori,F,8,3262546,18766
18936,Camyra,F,8,3262554,18068
18937,Canary,F,8,3262562,18358
18938,Carliyah,F,8,3262570,18654
18939,Carsin,M,8,3262578,18742
18940,Carsynn,F,8,3262586,18370
18941,Cartel,M,8,3262594,18793
18942,Carvell,M,8,3262602,18353
18943,Casimiro,M,8,3262610,18476
18944,Caspar,M,8,3262618,18329
18945,Cassey,F,8,3262626,18112
18946,Catia,F,8,3262634,18025
18947,Catrina,F,8,3262642,18138
18948,Caulder,M,8,3262650,18983
18949,Caven,M,8,3262658,18167
18950,Cayetana,F,8,3262666,18243
18951,Caylor,M,8,3262674,18672
18952,Cecillia,F,8,3262682,18451
18953,Cedella,F,8,3262690,18375
18954,Celesta,F,8,3262698,18938
18955,Cerena,F,8,3262706,18398
18956,Chai,M,8,3262714,18486
18957,Chan,M,8,3262722,18513
18958,Chandra,F,8,3262730,18689
18959,Charlytte,F,8,3262738,18652
18960,Chaslyn,F,8,3262746,18761
18961,Chasten,M,8,3262754,18132
18962,Chelsi,F,8,3262762,18622
18963,Cher,F,8,3262770,18207
18964,Cherrish,F,8,3262778,18674
18965,Cheyann,F,8,3262786,18872
18966,Chezky,M,8,3262794,18485
18967,Chidubem,M,8,3262802,18129
18968,Chinaza,F,8,3262810,18381
18969,Chrishawn,M,8,3262818,18727
18970,Chrisley,F,8,3262826,18193
18971,Christion,M,8,3262834,18000
18972,Christo,M,8,3262842,18504
18973,Christyana,F,8,3262850,18120
18974,Chuck,M,8,3262858,18815
18975,Clodagh,F,8,3262866,18804
18976,Coe,M,8,3262874,18812
18977,Coletta,F,8,3262882,18715
18978,Collyn,F,8,3262890,18918
18979,Conlee,M,8,3262898,18209
18980,Cordarius,M,8,3262906,18803
18981,Corinn,F,8,3262914,18147
18982,Corissa,F,8,3262922,18555
18983,Corwyn,M,8,3262930,18813
18984,Corynne,F,8,3262938,18993
18985,Costa,M,8,3262946,18581
18986,Couture,F,8,3262954,18114
18987,Cova,F,8,3262962,18572
18988,Creedyn,M,8,3262970,18695
18989,Crystian,M,8,3262978,18263
18990,Curie,F,8,3262986,18901
18991,Cyleigh,F,8,3262994,18242
18992,Cyndi,F,8,3263002,18778
18993,Cyree,M,8,3263010,18567
18994,Cyriah,F,8,3263018,18535
18995,Czar,M,8,3263026,18323
18996,Daanya,F,8,3263034,18822
18997,Dacian,M,8,3263042,18194
18998,Daeja,F,8,3263050,18474
18999,Daequan,M,8,3263058,18970
19000,Daesyn,M,8,3263066,19285
19001,Dalarie,F,8,3263074,19423
19002,Daler,M,8,3263082,19422
19003,Dalery,F,8,3263090,19140
19004,Dalex,M,8,3263098,19985
19005,Dali,F,8,3263106,19034
19006,Dallon,M,8,3263114,19271
19007,Damara,F,8,3263122,19981
19008,Danasia,F,8,3263130,19068
19009,Danita,F,8,3263138,19226
19010,Dantrell,M,8,3263146,19012
19011,Danylo,M,8,3263154,19626
19012,Daphney,F,8,3263162,19951
19013,Darek,M,8,3263170,19530
19014,Dari,F,8,3263178,19616
19015,Darick,M,8,3263186,19658
19016,Daud,M,8,3263194,19692
19017,Davida,F,8,3263202,19803
19018,Davier,M,8,3263210,19173
19019,Dawt,F,8,3263218,19893
19020,Daxxon,M,8,3263226,19264
19021,Daylee,F,8,3263234,19480
19022,Dayquan,M,8,3263242,19015
19023,Deandria,F,8,3263250,19505
19024,Deara,F,8,3263258,19501
19025,Deidra,F,8,3263266,19035
19026,Delaine,F,8,3263274,19515
19027,Delanee,F,8,3263282,19853
19028,Delaynee,F,8,3263290,19161
19029,Delight,F,8,3263298,19001
19030,Delvon,M,8,3263306,19052
19031,Demarious,M,8,3263314,19136
19032,Demaris,F,8,3263322,19364
19033,Demarrion,M,8,3263330,19372
19034,Demii,F,8,3263338,19698
19035,Denasia,F,8,3263346,19594
19036,Deni,F,8,3263354,19182
19037,Deonni,F,8,3263362,19302
19038,Derricka,F,8,3263370,19027
19039,Derrik,M,8,3263378,19090
19040,Desmon,M,8,3263386,19816
19041,Dessie,F,8,3263394,19860
19042,Destry,M,8,3263402,19124
19043,Devron,M,8,3263410,19561
19044,Deyren,M,8,3263418,19157
19045,Deyvi,M,8,3263426,19061
19046,Dhanush,M,8,3263434,19668
19047,Dilyn,F,8,3263442,19760
19048,Dimitris,M,8,3263450,19910
19049,Dinora,F,8,3263458,19033
19050,Dione,M,8,3263466,19437
19051,Dionisio,M,8,3263474,19788
19052,Divyam,M,8,3263482,19369
19053,Domenik,M,8,3263490,19404
19054,Doniyor,M,8,3263498,19360
19055,Donn,M,8,3263506,19016
19056,Dontarius,M,8,3263514,19357
19057,Donyae,M,8,3263522,19252
19058,Doran,M,8,3263530,19387
19059,Dorina,F,8,3263538,19449
19060,Dorrian,M,8,3263546,19181
19061,Draxler,M,8,3263554,19660
19062,Draysen,M,8,3263562,19925
19063,Dreden,M,8,3263570,19278
19064,Drequan,M,8,3263578,19729
19065,Dshawn,M,8,3263586,19191
19066,Dubai,M,8,3263594,19745
19067,Duha,F,8,3263602,19864
19068,Dulcie,F,8,3263610,19044
19069,Dulcinea,F,8,3263618,19504
19070,Duran,M,8,3263626,19641
19071,Durrell,M,8,3263634,19869
19072,Dwaine,M,8,3263642,19204
19073,Dymond,F,8,3263650,19897
19074,Dyron,M,8,3263658,19872
19075,Eashan,M,8,3263666,19466
19076,Edge,M,8,3263674,19639
19077,Ediz,M,8,3263682,19677
19078,Edlyn,F,8,3263690,19836
19079,Edouard,M,8,3263698,19786
19080,Efrem,M,8,3263706,19738
19081,Eilam,M,8,3263714,19811
19082,Eiress,F,8,3263722,19309
19083,Eisen,M,8,3263730,19613
19084,Eknoor,F,8,3263738,19805
19085,Elaf,F,8,3263746,19461
19086,Elasia,F,8,3263754,19960
19087,Elcie,F,8,3263762,19822
19088,Elex,M,8,3263770,19365
19089,Eliahs,M,8,3263778,19689
19090,Elianie,F,8,3263786,19521
19091,Elijha,M,8,3263794,19238
19092,Elisei,M,8,3263802,19078
19093,Elisheba,F,8,3263810,19620
19094,Elita,F,8,3263818,19866
19095,Eliyannah,F,8,3263826,19073
19096,Elizandro,M,8,3263834,19243
19097,Eljay,M,8,3263842,19088
19098,Ellajean,F,8,3263850,19879
19099,Ellason,F,8,3263858,19457
19100,Elleanore,F,8,3263866,19659
19101,Elliah,F,8,3263874,19476
19102,Ellinore,F,8,3263882,19408
19103,Elliora,F,8,3263890,19317
19104,Ellisa,F,8,3263898,19519
19105,Elliston,F,8,3263906,19007
19106,Ellouise,F,8,3263914,19189
19107,Ellyanah,F,8,3263922,19942
19108,Elna,F,8,3263930,19329
19109,Elsbeth,F,8,3263938,19434
19110,Emanuelle,F,8,3263946,19036
19111,Emelio,M,8,3263954,19722
19112,Emelly,F,8,3263962,19922
19113,Emerich,M,8,3263970,19558
19114,Emiah,F,8,3263978,19967
19115,Emika,F,8,3263986,19764
19116,Emmajo,F,8,3263994,19569
19117,Emmakay,F,8,3264002,19413
19118,Emmalise,F,8,3264010,19720
19119,Emmaly,F,8,3264018,19110
19120,Emmamarie,F,8,3264026,19112
19121,Emylee,F,8,3264034,19041
19122,Enas,F,8,3264042,19206
19123,Endya,F,8,3264050,19232
19124,Ennio,M,8,3264058,19615
19125,Enola,F,8,3264066,19783
19126,Enso,M,8,3264074,19220
19127,Ericksen,M,8,3264082,19880
19128,Ermyas,M,8,3264090,19513
19129,Esli,F,8,3264098,19674
19130,Eslyn,F,8,3264106,19219
19131,Espn,M,8,3264114,19847
19132,Estefan,M,8,3264122,19598
19133,Esten,M,8,3264130,19096
19134,Esthela,F,8,3264138,19778
19135,Etana,F,8,3264146,19442
19136,Eulalie,F,8,3264154,19552
19137,Evalene,F,8,3264162,19299
19138,Evalette,F,8,3264170,19782
19139,Evamaria,F,8,3264178,19929
19140,Evangelyn,F,8,3264186,19265
19141,Evaristo,M,8,3264194,19524
19142,Even,M,8,3264202,19092
19143,Everick,M,8,3264210,19619
19144,Evgenia,F,8,3264218,19067
19145,Eyana,F,8,3264226,19168
19146,Ezria,F,8,3264234,19923
19147,Ezykiel,M,8,3264242,19809
19148,Ezzah,F,8,3264250,19185
19149,Fabien,M,8,3264258,19460
19150,Faelyn,F,8,3264266,19018
19151,Famous,M,8,3264274,19230
19152,Faron,M,8,3264282,19055
19153,Faruk,M,8,3264290,19077
19154,Faryn,F,8,3264298,19129
19155,Farzad,M,8,3264306,19800
19156,Fatmata,F,8,3264314,19208
19157,Fawad,M,8,3264322,19491
19158,Fayrouz,F,8,3264330,19540
19159,Fenet,F,8,3264338,19324
19160,Ferguson,M,8,3264346,19106
19161,Ferne,F,8,3264354,19600
19162,Ferran,M,8,3264362,19955
19163,Fielder,M,8,3264370,19924
19164,Filippa,F,8,3264378,19556
19165,Foxx,M,8,3264386,19825
19166,Franz,M,8,3264394,19126
19167,Frazier,M,8,3264402,19178
19168,Fredis,M,8,3264410,19459
19169,Freyah,F,8,3264418,19017
19170,Frimmy,F,8,3264426,19109
19171,Fyodor,M,8,3264434,19537
19172,Gaberiel,M,8,3264442,19009
19173,Gabi,F,8,3264450,19821
19174,Galena,F,8,3264458,19297
19175,Galo,M,8,3264466,19582
19176,Galvin,M,8,3264474,19761
19177,Gamora,F,8,3264482,19583
19178,Garang,M,8,3264490,19348
19179,Garfield,M,8,3264498,19253
19180,Gaspard,M,8,3264506,19311
19181,Gavon,M,8,3264514,19097
19182,Gayatri,F,8,3264522,19047
19183,Gennady,M,8,3264530,19197
19184,Gentrie,F,8,3264538,19292
19185,Geonni,M,8,3264546,19091
19186,Georges,M,8,3264554,19526
19187,Geovana,F,8,3264562,19450
19188,Geralyn,F,8,3264570,19686
19189,Gissell,F,8,3264578,19767
19190,Giulian,M,8,3264586,19732
19191,Givanni,M,8,3264594,19177
19192,Glendy,F,8,3264602,19295
19193,Graceanne,F,8,3264610,19902
19194,Gracemarie,F,8,3264618,19952
19195,Graycelynn,F,8,3264626,19164
19196,Grayton,M,8,3264634,19354
19197,Great,M,8,3264642,19020
19198,Greenley,F,8,3264650,19808
19199,Gregg,M,8,3264658,19072
19200,Gresham,M,8,3264666,19918
19201,Greylen,M,8,3264674,19221
19202,Greysun,M,8,3264682,19281
19203,Griff,M,8,3264690,19815
19204,Guillermina,F,8,3264698,19908
19205,Gurbaaj,M,8,3264706,19042
19206,Gwendalynn,F,8,3264714,19862
19207,Gweneviere,F,8,3264722,19637
19208,Gwenna,F,8,3264730,19233
19209,Gwyndolin,F,8,3264738,19827
19210,Haadi,M,8,3264746,19807
19211,Haani,F,8,3264754,19421
19212,Haaniya,F,8,3264762,19533
19213,Hadar,F,8,3264770,19306
19214,Hadden,M,8,3264778,19983
19215,Hadli,F,8,3264786,19625
19216,Haedyn,M,8,3264794,19431
19217,Haidy,F,8,3264802,19254
19218,Haisleigh,F,8,3264810,19156
19219,Halena,F,8,3264818,19675
19220,Halona,F,8,3264826,19679
19221,Hamda,F,8,3264834,19310
19222,Hamna,F,8,3264842,19263
19223,Hanniel,M,8,3264850,19057
19224,Hanzala,M,8,3264858,19536
19225,Hanzo,M,8,3264866,19603
19226,Haochen,M,8,3264874,19074
19227,Haoyu,M,8,3264882,19839
19228,Hardison,M,8,3264890,19314
19229,Harpergrace,F,8,3264898,19409
19230,Harshini,F,8,3264906,19246
19231,Hartlynn,F,8,3264914,19405
19232,Haston,M,8,3264922,19358
19233,Hatch,M,8,3264930,19436
19234,Hatem,M,8,3264938,19026
19235,Hayan,M,8,3264946,19394
19236,Haydin,M,8,3264954,19696
19237,Hayleen,F,8,3264962,19228
19238,Haylei,F,8,3264970,19577
19239,Hazim,M,8,3264978,19410
19240,Hazzel,F,8,3264986,19572
19241,Heilyn,F,8,3264994,19914
19242,Hektor,M,8,3265002,19149
19243,Helana,F,8,3265010,19973
19244,Helayna,F,8,3265018,19430
19245,Henzley,F,8,3265026,19114
19246,Hibah,F,8,3265034,19227
19247,Hibba,F,8,3265042,19632
19248,Hikma,F,8,3265050,19752
19249,Hili,F,8,3265058,19991
19250,Himani,F,8,3265066,19680
19251,Himari,F,8,3265074,19710
19252,Hipolito,M,8,3265082,19597
19253,Hiroto,M,8,3265090,19401
19254,Holdon,M,8,3265098,19153
19255,Hopelyn,F,8,3265106,19050
19256,Hopelynn,F,8,3265114,19835
19257,Horatio,M,8,3265122,19758
19258,Horizon,F,8,3265130,19915
19259,Horus,M,8,3265138,19213
19260,Hoss,M,8,3265146,19810
19261,Humayra,F,8,3265154,19882
19262,Hunt,M,8,3265162,19341
19263,Husaina,F,8,3265170,19494
19264,Huxten,M,8,3265178,19950
19265,Hyland,F,8,3265186,19602
19266,Idara,F,8,3265194,19871
19267,Ijeoma,F,8,3265202,19965
19268,Ilham,F,8,3265210,19503
19269,Ilia,F,8,3265218,19032
19270,Iliany,F,8,3265226,19303
19271,Illeana,F,8,3265234,19493
19272,Imri,M,8,3265242,19817
19273,Inaayah,F,8,3265250,19462
19274,Inci,F,8,3265258,19986
19275,Indyah,F,8,3265266,19342
19276,Infiniti,F,8,3265274,19647
19277,Iniyan,M,8,3265282,19571
19278,Inola,F,8,3265290,19949
19279,Iria,F,8,3265298,19326
19280,Iriel,F,8,3265306,19563
19281,Irish,F,8,3265314,19397
19282,Isaia,M,8,3265322,19388
19283,Isaly,F,8,3265330,19699
19284,Ishaana,F,8,3265338,19719
19285,Isom,M,8,3265346,19590
19286,Israela,F,8,3265354,19919
19287,Issabelle,F,8,3265362,19941
19288,Issael,M,8,3265370,19607
19289,Issiah,M,8,3265378,19081
19290,Itay,M,8,3265386,19225
19291,Itza,F,8,3265394,19917
19292,Ivannah,F,8,3265402,19497
19293,Iveigh,F,8,3265410,19251
19294,Ivi,F,8,3265418,19393
19295,Ivyona,F,8,3265426,19260
19296,Izeah,M,8,3265434,19567
19297,Izumi,F,8,3265442,19371
19298,Jabal,M,8,3265450,19966
19299,Jaccob,M,8,3265458,19039
19300,Jacyn,M,8,3265466,19926
19301,Jaeliyah,F,8,3265474,19990
19302,Jaevon,M,8,3265482,19448
19303,Jahaan,M,8,3265490,19086
19304,Jahira,F,8,3265498,19445
19305,Jahlaya,F,8,3265506,19485
19306,Jahlia,F,8,3265514,19510
19307,Jahniyah,F,8,3265522,19489
19308,Jahsi,M,8,3265530,19060
19309,Jahsiel,M,8,3265538,19063
19310,Jaicion,M,8,3265546,19995
19311,Jaion,M,8,3265554,19330
19312,Jaisiah,M,8,3265562,19685
19313,Jaiyanna,F,8,3265570,19049
19314,Jakota,M,8,3265578,19666
19315,Jakyia,F,8,3265586,19464
19316,Jakylie,F,8,3265594,19279
19317,Jalaiah,F,8,3265602,19376
19318,Jaleal,M,8,3265610,19993
19319,Jaleeah,F,8,3265618,19438
19320,Jalexi,F,8,3265626,19040
19321,Jaleyza,F,8,3265634,19245
19322,Jamaica,F,8,3265642,19890
19323,Jamarii,M,8,3265650,19754
19324,Jamiel,M,8,3265658,19331
19325,Jamielynn,F,8,3265666,19575
19326,Jamina,F,8,3265674,19875
19327,Jamis,M,8,3265682,19270
19328,Jamora,F,8,3265690,19386
19329,Janny,F,8,3265698,19541
19330,Janos,M,8,3265706,19128
19331,Janovia,F,8,3265714,19174
19332,Janziel,M,8,3265722,19723
19333,Japleen,F,8,3265730,19029
19334,Japneet,F,8,3265738,19498
19335,Jaris,M,8,3265746,19636
19336,Jasaiah,M,8,3265754,19832
19337,Jasan,M,8,3265762,19412
19338,Jashayla,F,8,3265770,19529
19339,Jasyah,M,8,3265778,19046
19340,Javanni,M,8,3265786,19345
19341,Javonta,M,8,3265794,19777
19342,Jaxxen,M,8,3265802,19284
19343,Jayari,M,8,3265810,19127
19344,Jaydeen,M,8,3265818,19179
19345,Jaydn,M,8,3265826,19102
19346,Jayke,M,8,3265834,19313
19347,Jaylena,F,8,3265842,19964
19348,Jaylianis,F,8,3265850,19419
19349,Jaymari,M,8,3265858,19684
19350,Jazbel,F,8,3265866,19172
19351,Jazell,F,8,3265874,19211
19352,Jazmina,F,8,3265882,19587
19353,Jazzie,F,8,3265890,19792
19354,Jedikiah,M,8,3265898,19322
19355,Jedson,M,8,3265906,19268
19356,Jefferey,M,8,3265914,19977
19357,Jemari,M,8,3265922,19134
19358,Jemere,M,8,3265930,19997
19359,Jennalyn,F,8,3265938,19849
19360,Jenner,M,8,3265946,19574
19361,Jerico,M,8,3265954,19740
19362,Jerik,M,8,3265962,19548
19363,Jerilyn,F,8,3265970,19212
19364,Jermias,M,8,3265978,19490
19365,Jerney,F,8,3265986,19794
19366,Jerod,M,8,3265994,19187
19367,Jerold,M,8,3266002,19770
19368,Jerrion,M,8,3266010,19850
19369,Jeslin,F,8,3266018,19857
19370,Jessey,M,8,3266026,19381
19371,Jette,F,8,3266034,19943
19372,Jetty,M,8,3266042,19931
19373,Jhael,M,8,3266050,19576
19374,Jhamari,M,8,3266058,19468
19375,Jhournee,F,8,3266066,19704
19376,Jio,M,8,3266074,19565
19377,Jisha,F,8,3266082,19823
19378,Jiyansh,M,8,3266090,19346
19379,Jlani,F,8,3266098,19021
19380,Joaly,F,8,3266106,19657
19381,Jocsan,M,8,3266114,19669
19382,Joeseph,M,8,3266122,19716
19383,Johaan,M,8,3266130,19703
19384,Johntae,M,8,3266138,19236
19385,Jomari,M,8,3266146,19518
19386,Jonuel,M,8,3266154,19283
19387,Joram,M,8,3266162,19470
19388,Jorian,M,8,3266170,19217
19389,Josejulian,M,8,3266178,19663
19390,Joshuan,M,8,3266186,19142
19391,Joule,F,8,3266194,19840
19392,Journeii,F,8,3266202,19070
19393,Joyelle,F,8,3266210,19367
19394,Joziyah,M,8,3266218,19062
19395,Jua,F,8,3266226,19714
19396,Juandedios,M,8,3266234,19828
19397,Juanito,M,8,3266242,19595
19398,Julious,M,8,3266250,19099
19399,Julyssa,F,8,3266258,19651
19400,Junah,M,8,3266266,19119
19401,Juston,M,8,3266274,19948
19402,Jvion,M,8,3266282,19982
19403,Jvon,M,8,3266290,19771
19404,Kabe,M,8,3266298,19095
19405,Kaceton,M,8,3266306,19874
19406,Kadar,M,8,3266314,19180
19407,Kadee,F,8,3266322,19455
19408,Kadmiel,M,8,3266330,19087
19409,Kaedan,M,8,3266338,19635
19410,Kaelee,F,8,3266346,19671
19411,Kaelem,M,8,3266354,19379
19412,Kaelie,F,8,3266362,19707
19413,Kahliah,F,8,3266370,19705
19414,Kahlo,M,8,3266378,19133
19415,Kahreem,M,8,3266386,19300
19416,Kaiani,F,8,3266394,19201
19417,Kaiba,M,8,3266402,19262
19418,Kaidy,F,8,3266410,19695
19419,Kaikane,M,8,3266418,19184
19420,Kailash,M,8,3266426,19315
19421,Kailei,F,8,3266434,19624
19422,Kailena,F,8,3266442,19340
19423,Kainaat,F,8,3266450,19075
19424,Kairie,M,8,3266458,19441
19425,Kairyn,M,8,3266466,19895
19426,Kaiva,F,8,3266474,19338
19427,Kaiyo,M,8,3266482,19726
19428,Kaj,M,8,3266490,19158
19429,Kaleeah,F,8,3266498,19796
19430,Kaliel,M,8,3266506,19892
19431,Kalo,M,8,3266514,19865
19432,Kamai,M,8,3266522,19111
19433,Kamalani,F,8,3266530,19137
19434,Kamariah,F,8,3266538,19000
19435,Kambryn,F,8,3266546,19655
19436,Kamdynn,M,8,3266554,19287
19437,Kammie,F,8,3266562,19564
19438,Kamree,F,8,3266570,19773
19439,Kamyrah,F,8,3266578,19670
19440,Kanav,M,8,3266586,19785
19441,Kandon,M,8,3266594,19359
19442,Kaneki,M,8,3266602,19739
19443,Kania,F,8,3266610,19589
19444,Kannyn,M,8,3266618,19406
19445,Kanya,F,8,3266626,19200
19446,Kaomi,F,8,3266634,19741
19447,Karcyn,M,8,3266642,19273
19448,Karden,M,8,3266650,19759
19449,Karia,F,8,3266658,19566
19450,Karlina,F,8,3266666,19912
19451,Karmine,M,8,3266674,19082
19452,Karolyna,F,8,3266682,19517
19453,Kartyr,F,8,3266690,19175
19454,Karya,F,8,3266698,19799
19455,Kashdyn,M,8,3266706,19416
19456,Kasher,M,8,3266714,19987
19457,Kashika,F,8,3266722,19665
19458,Kassem,M,8,3266730,19053
19459,Kasumi,F,8,3266738,19383
19460,Katianna,F,8,3266746,19568
19461,Katori,F,8,3266754,19812
19462,Katyayani,F,8,3266762,19426
19463,Kauai,M,8,3266770,19870
19464,Kavayah,F,8,3266778,19638
19465,Kayd,M,8,3266786,19580
19466,Kayleana,F,8,3266794,19528
19467,Kayleeann,F,8,3266802,19076
19468,Kayomi,F,8,3266810,19444
19469,Kayron,M,8,3266818,19848
19470,Kayston,M,8,3266826,19855
19471,Kaysyn,M,8,3266834,19867
19472,Kayvan,M,8,3266842,19118
19473,Kea,F,8,3266850,19502
19474,Kedric,M,8,3266858,19946
19475,Keean,M,8,3266866,19691
19476,Keene,M,8,3266874,19120
19477,Keerthi,F,8,3266882,19646
19478,Kehlanii,F,8,3266890,19854
19479,Keianna,F,8,3266898,19763
19480,Keidan,M,8,3266906,19122
19481,Keifer,M,8,3266914,19913
19482,Keighan,M,8,3266922,19974
19483,Keilanny,F,8,3266930,19352
19484,Keimoni,M,8,3266938,19937
19485,Kelcee,F,8,3266946,19715
19486,Keldrick,M,8,3266954,19748
19487,Keleah,F,8,3266962,19391
19488,Kelen,M,8,3266970,19363
19489,Keliyah,F,8,3266978,19192
19490,Kellyanne,F,8,3266986,19627
19491,Kemya,F,8,3266994,19100
19492,Kendahl,F,8,3267002,19415
19493,Kendan,M,8,3267010,19617
19494,Kendarius,M,8,3267018,19066
19495,Kendrell,M,8,3267026,19356
19496,Keneth,M,8,3267034,19266
19497,Kenise,F,8,3267042,19672
19498,Kenlei,F,8,3267050,19467
19499,Kenlin,M,8,3267058,19954
19500,Kenric,M,8,3267066,19830
19501,Kenrick,M,8,3267074,19768
19502,Kenta,M,8,3267082,19969
19503,Keoki,M,8,3267090,19433
19504,Keola,M,8,3267098,19687
19505,Keslyn,F,8,3267106,19522
19506,Kevari,M,8,3267114,19146
19507,Keynan,M,8,3267122,19162
19508,Keyoni,F,8,3267130,19005
19509,Keyron,M,8,3267138,19787
19510,Khadir,M,8,3267146,19428
19511,Khael,M,8,3267154,19107
19512,Khailani,F,8,3267162,19742
19513,Khalen,M,8,3267170,19717
19514,Khamarion,M,8,3267178,19894
19515,Khamia,F,8,3267186,19555
19516,Khamil,M,8,3267194,19591
19517,Khamiya,F,8,3267202,19868
19518,Khamiyah,F,8,3267210,19023
19519,Kharizma,F,8,3267218,19373
19520,Khasai,M,8,3267226,19534
19521,Khira,F,8,3267234,19473
19522,Khloi,F,8,3267242,19202
19523,Khoa,M,8,3267250,19272
19524,Khristina,F,8,3267258,19293
19525,Khup,M,8,3267266,19237
19526,Khyra,F,8,3267274,19392
19527,Khyre,M,8,3267282,19653
19528,Kiandre,M,8,3267290,19573
19529,Kianni,F,8,3267298,19258
19530,Kiany,F,8,3267306,19512
19531,Kiash,M,8,3267314,19734
19532,Kiet,M,8,3267322,19108
19533,Kilan,M,8,3267330,19690
19534,Kilo,M,8,3267338,19667
19535,Kilyan,M,8,3267346,19644
19536,Kimberli,F,8,3267354,19940
19537,Kimimila,F,8,3267362,19709
19538,Kimiya,F,8,3267370,19844
19539,Kincade,M,8,3267378,19614
19540,Kingsly,M,8,3267386,19751
19541,Kinlynn,F,8,3267394,19125
19542,Kirat,F,8,3267402,19656
19543,Kiril,M,8,3267410,19728
19544,Kiyoko,F,8,3267418,19288
19545,Kizzy,F,8,3267426,19355
19546,Klark,M,8,3267434,19094
19547,Klee,F,8,3267442,19339
19548,Kleigh,F,8,3267450,19834
19549,Kmarie,F,8,3267458,19025
19550,Koal,M,8,3267466,19333
19551,Kodee,F,8,3267474,19407
19552,Koko,F,8,3267482,19469
19553,Kolsten,M,8,3267490,19276
19554,Konstantina,F,8,3267498,19199
19555,Korin,M,8,3267506,19418
19556,Korrah,F,8,3267514,19291
19557,Kort,M,8,3267522,19645
19558,Kraig,M,8,3267530,19606
19559,Krymson,F,8,3267538,19593
19560,Kuiper,M,8,3267546,19570
19561,Kwasi,M,8,3267554,19631
19562,Kyann,F,8,3267562,19507
19563,Kyell,M,8,3267570,19737
19564,Kyleigha,F,8,3267578,19846
19565,Kylianna,F,8,3267586,19155
19566,Kynadi,F,8,3267594,19115
19567,Kyrii,M,8,3267602,19305
19568,Kysin,M,8,3267610,19420
19569,Kysir,M,8,3267618,19664
19570,Kyzir,M,8,3267626,19629
19571,Lace,F,8,3267634,19721
19572,Lacee,F,8,3267642,19621
19573,Lachlyn,F,8,3267650,19425
19574,Ladan,F,8,3267658,19911
19575,Laden,M,8,3267666,19886
19576,Lakeith,M,8,3267674,19256
19577,Lakenzie,F,8,3267682,19463
19578,Lalita,F,8,3267690,19753
19579,Lamaj,M,8,3267698,19141
19580,Lamin,M,8,3267706,19244
19581,Lariya,F,8,3267714,19735
19582,Larose,F,8,3267722,19863
19583,Larsen,M,8,3267730,19028
19584,Lathyn,M,8,3267738,19904
19585,Latisha,F,8,3267746,19389
19586,Latroy,M,8,3267754,19051
19587,Laurelei,F,8,3267762,19104
19588,Lavada,F,8,3267770,19282
19589,Lavaeh,F,8,3267778,19275
19590,Lavar,M,8,3267786,19312
19591,Lawayne,M,8,3267794,19323
19592,Layland,M,8,3267802,19963
19593,Laylianna,F,8,3267810,19496
19594,Laylin,F,8,3267818,19255
19595,Layoni,F,8,3267826,19361
19596,Leala,F,8,3267834,19581
19597,Leanny,F,8,3267842,19795
19598,Leeya,F,8,3267850,19998
19599,Leilanee,F,8,3267858,19150
19600,Leily,F,8,3267866,19443
19601,Leinani,F,8,3267874,19186
19602,Leire,F,8,3267882,19560
19603,Leiza,F,8,3267890,19818
19604,Lemar,M,8,3267898,19171
19605,Lennoxx,M,8,3267906,19084
19606,Leonarda,F,8,3267914,19116
19607,Leonella,F,8,3267922,19143
19608,Leto,M,8,3267930,19151
19609,Letticia,F,8,3267938,19500
19610,Levaeh,F,8,3267946,19267
19611,Levian,M,8,3267954,19550
19612,Lewi,M,8,3267962,19486
19613,Lewyn,M,8,3267970,19234
19614,Lexia,F,8,3267978,19927
19615,Lexiana,F,8,3267986,19694
19616,Leyda,F,8,3267994,19831
19617,Leyli,F,8,3268002,19861
19618,Lilie,F,8,3268010,19609
19619,Lilleigh,F,8,3268018,19586
19620,Lilliah,F,8,3268026,19843
19621,Lillymae,F,8,3268034,19750
19622,Lilygrace,F,8,3268042,19549
19623,Lindi,F,8,3268050,19532
19624,Linton,M,8,3268058,19235
19625,Lionell,M,8,3268066,19471
19626,Liorah,F,8,3268074,19610
19627,Lissandra,F,8,3268082,19905
19628,Litza,F,8,3268090,19544
19629,Livvie,F,8,3268098,19547
19630,Lizet,F,8,3268106,19144
19631,Llewellyn,M,8,3268114,19439
19632,Loay,M,8,3268122,19876
19633,Locklynn,F,8,3268130,19688
19634,Loreen,F,8,3268138,19030
19635,Lorelie,F,8,3268146,19435
19636,Lorynn,F,8,3268154,19724
19637,Lotte,F,8,3268162,19453
19638,Lovette,F,8,3268170,19520
19639,Lowsan,M,8,3268178,19697
19640,Luanne,F,8,3268186,19643
19641,Lucciana,F,8,3268194,19414
19642,Lui,M,8,3268202,19216
19643,Luisana,F,8,3268210,19842
19644,Luv,F,8,3268218,19130
19645,Luxury,F,8,3268226,19506
19646,Luzmarie,F,8,3268234,19612
19647,Lyanne,F,8,3268242,19417
19648,Lylian,F,8,3268250,19599
19649,Lylla,F,8,3268258,19887
19650,Lyman,M,8,3268266,19483
19651,Lynelle,F,8,3268274,19611
19652,Lynkon,M,8,3268282,19718
19653,Lynnly,F,8,3268290,19652
19654,Lyrika,F,8,3268298,19813
19655,Lys,F,8,3268306,19957
19656,Macilynn,F,8,3268314,19403
19657,Mackston,M,8,3268322,19080
19658,Maclane,M,8,3268330,19495
19659,Madai,F,8,3268338,19474
19660,Madox,M,8,3268346,19702
19661,Maeby,F,8,3268354,19166
19662,Maecyn,F,8,3268362,19559
19663,Magizhan,M,8,3268370,19516
19664,Maham,F,8,3268378,19928
19665,Mahlet,F,8,3268386,19898
19666,Maiana,F,8,3268394,19543
19667,Maico,M,8,3268402,19884
19668,Mairany,F,8,3268410,19775
19669,Maislyn,F,8,3268418,19154
19670,Maive,F,8,3268426,19584
19671,Maizlee,F,8,3268434,19662
19672,Maka,F,8,3268442,19301
19673,Makayah,F,8,3268450,19145
19674,Makenli,F,8,3268458,19374
19675,Makenly,F,8,3268466,19936
19676,Makensley,F,8,3268474,19592
19677,Makinzie,F,8,3268482,19319
19678,Makoto,M,8,3268490,19578
19679,Malacai,M,8,3268498,19398
19680,Malan,F,8,3268506,19523
19681,Maleea,F,8,3268514,19683
19682,Maleiyah,F,8,3268522,19939
19683,Malenie,F,8,3268530,19196
19684,Malhar,M,8,3268538,19975
19685,Malibu,F,8,3268546,19789
19686,Malillany,F,8,3268554,19257
19687,Malvin,M,8,3268562,19676
19688,Man,F,8,3268570,19475
19689,Mandie,F,8,3268578,19395
19690,Manelyk,F,8,3268586,19224
19691,Manessa,F,8,3268594,19933
19692,Manveer,M,8,3268602,19900
19693,Maranatha,F,8,3268610,19290
19694,Marcelous,M,8,3268618,19385
19695,Marella,F,8,3268626,19440
19696,Mariahlynn,F,8,3268634,19138
19697,Mariaisabel,F,8,3268642,19121
19698,Marialena,F,8,3268650,19465
19699,Marialuisa,F,8,3268658,19538
19700,Mariame,F,8,3268666,19286
19701,Mariavictoria,F,8,3268674,19458
19702,Mariem,F,8,3268682,19829
19703,Marieme,F,8,3268690,19873
19704,Marigny,F,8,3268698,19553
19705,Marija,F,8,3268706,19056
19706,Markee,M,8,3268714,19706
19707,Markeese,M,8,3268722,19484
19708,Marking,M,8,3268730,19681
19709,Markon,M,8,3268738,19650
19710,Marleigha,F,8,3268746,19744
19711,Marleyrose,F,8,3268754,19390
19712,Marlina,F,8,3268762,19222
19713,Marquavious,M,8,3268770,19856
19714,Martie,F,8,3268778,19375
19715,Marven,M,8,3268786,19551
19716,Marybelle,F,8,3268794,19349
19717,Maryfrances,F,8,3268802,19165
19718,Marylynn,F,8,3268810,19640
19719,Maryum,F,8,3268818,19269
19720,Massai,M,8,3268826,19308
19721,Mateen,M,8,3268834,19008
19722,Matilynn,F,8,3268842,19214
19723,Mattson,M,8,3268850,19820
19724,Maty,F,8,3268858,19878
19725,Maudie,F,8,3268866,19399
19726,Mayank,M,8,3268874,19596
19727,Maycen,M,8,3268882,19508
19728,Maylea,F,8,3268890,19979
19729,Mayze,F,8,3268898,19218
19730,Mazelyn,F,8,3268906,19402
19731,Mazey,F,8,3268914,19210
19732,Maziyah,F,8,3268922,19101
19733,Mccarthy,M,8,3268930,19766
19734,Mckaylee,F,8,3268938,19727
19735,Mckenley,F,8,3268946,19630
19736,Mckynleigh,F,8,3268954,19888
19737,Mclaren,M,8,3268962,19539
19738,Medora,F,8,3268970,19045
19739,Meesha,F,8,3268978,19384
19740,Mehnaz,F,8,3268986,19215
19741,Meilyn,F,8,3268994,19824
19742,Melayna,F,8,3269002,19148
19743,Melchor,M,8,3269010,19452
19744,Melianna,F,8,3269018,19123
19745,Meliha,F,8,3269026,19059
19746,Melinna,F,8,3269034,19048
19747,Meliza,F,8,3269042,19176
19748,Mellany,F,8,3269050,19921
19749,Melodii,F,8,3269058,19239
19750,Menelik,M,8,3269066,19194
19751,Merick,M,8,3269074,19693
19752,Merna,F,8,3269082,19131
19753,Merrin,F,8,3269090,19229
19754,Meyson,M,8,3269098,19259
19755,Mezziah,M,8,3269106,19223
19756,Miaa,F,8,3269114,19105
19757,Micael,M,8,3269122,19988
19758,Mico,M,8,3269130,19321
19759,Mihaela,F,8,3269138,19135
19760,Mihailo,M,8,3269146,19511
19761,Mikias,M,8,3269154,19296
19762,Milam,M,8,3269162,19838
19763,Milanna,F,8,3269170,19588
19764,Milca,F,8,3269178,19429
19765,Milica,F,8,3269186,19037
19766,Millar,M,8,3269194,19014
19767,Millard,M,8,3269202,19152
19768,Millian,F,8,3269210,19006
19769,Minaal,F,8,3269218,19432
19770,Miraj,M,8,3269226,19774
19771,Mirely,F,8,3269234,19623
19772,Mirryn,F,8,3269242,19736
19773,Mishita,F,8,3269250,19557
19774,Modesto,M,8,3269258,19896
19775,Mohan,M,8,3269266,19085
19776,Mohsin,M,8,3269274,19618
19777,Morgen,M,8,3269282,19400
19778,Morningstar,F,8,3269290,19784
19779,Mouhamad,M,8,3269298,19514
19780,Mounir,M,8,3269306,19833
19781,Moustafa,M,8,3269314,19169
19782,Mozes,M,8,3269322,19132
19783,Mubina,F,8,3269330,19478
19784,Muhamad,M,8,3269338,19885
19785,Muhanad,M,8,3269346,19858
19786,Murilo,M,8,3269354,19294
19787,Mustaf,M,8,3269362,19731
19788,Muzammil,M,8,3269370,19642
19789,Myani,F,8,3269378,19274
19790,Myleen,F,8,3269386,19622
19791,Mylei,F,8,3269394,19779
19792,Mylena,F,8,3269402,19298
19793,Myliyah,F,8,3269410,19069
19794,Naa,F,8,3269418,19019
19795,Naamah,F,8,3269426,19804
19796,Naaman,M,8,3269434,19730
19797,Nadal,M,8,3269442,19781
19798,Nadalyn,F,8,3269450,19604
19799,Nader,M,8,3269458,19477
19800,Nadra,F,8,3269466,19903
19801,Naiyana,F,8,3269474,19989
19802,Naleia,F,8,3269482,19909
19803,Nali,F,8,3269490,19002
19804,Nalini,F,8,3269498,19147
19805,Nallah,F,8,3269506,19093
19806,Nalu,M,8,3269514,19755
19807,Nanayaw,M,8,3269522,19038
19808,Nandan,M,8,3269530,19802
19809,Nang,M,8,3269538,19634
19810,Naraly,F,8,3269546,19304
19811,Narayani,F,8,3269554,19968
19812,Narciso,M,8,3269562,19446
19813,Naria,F,8,3269570,19901
19814,Nashon,M,8,3269578,19701
19815,Nasiir,M,8,3269586,19743
19816,Nasrin,F,8,3269594,19098
19817,Nassim,M,8,3269602,19318
19818,Natanel,M,8,3269610,19336
19819,Natori,F,8,3269618,19479
19820,Natsumi,F,8,3269626,19188
19821,Navea,F,8,3269634,19765
19822,Naveigh,F,8,3269642,19992
19823,Navina,F,8,3269650,19117
19824,Navraj,M,8,3269658,19382
19825,Nayef,M,8,3269666,19971
19826,Nayleen,F,8,3269674,19242
19827,Nehemyah,M,8,3269682,19366
19828,Neilani,F,8,3269690,19248
19829,Nel,F,8,3269698,19978
19830,Neliah,F,8,3269706,19891
19831,Nema,F,8,3269714,19525
19832,Neslihan,F,8,3269722,19004
19833,Netanya,F,8,3269730,19762
19834,Netra,F,8,3269738,19826
19835,Newell,M,8,3269746,19240
19836,Neylan,M,8,3269754,19700
19837,Nezar,M,8,3269762,19772
19838,Ngawang,M,8,3269770,19554
19839,Niasia,F,8,3269778,19956
19840,Niayla,F,8,3269786,19648
19841,Nickan,M,8,3269794,19633
19842,Nickolaus,M,8,3269802,19601
19843,Nickoli,M,8,3269810,19958
19844,Niel,M,8,3269818,19906
19845,Night,M,8,3269826,19427
19846,Nijah,F,8,3269834,19488
19847,Nimrit,F,8,3269842,19682
19848,Nithila,F,8,3269850,19350
19849,Nithin,M,8,3269858,19798
19850,Niyathi,F,8,3269866,19370
19851,Nohemy,F,8,3269874,19247
19852,Nohlan,M,8,3269882,19976
19853,Nole,M,8,3269890,19054
19854,Norina,F,8,3269898,19961
19855,Norrie,F,8,3269906,19756
19856,Norrin,M,8,3269914,19320
19857,Nuala,F,8,3269922,19769
19858,Nuchem,M,8,3269930,19654
19859,Nuriya,F,8,3269938,19527
19860,Nyala,F,8,3269946,19938
19861,Nyara,F,8,3269954,19011
19862,Nyella,F,8,3269962,19353
19863,Nyemah,F,8,3269970,19447
19864,Nyilah,F,8,3269978,19945
19865,Nyir,M,8,3269986,19031
19866,Nykia,F,8,3269994,19673
19867,Nykolas,M,8,3270002,19801
19868,Nyota,F,8,3270010,19250
19869,Nyza,F,8,3270018,19780
19870,Oaklea,F,8,3270026,19579
19871,Oaklei,F,8,3270034,19907
19872,Oceane,F,8,3270042,19749
19873,Oceanna,F,8,3270050,19347
19874,Odie,M,8,3270058,19231
19875,Odonis,M,8,3270066,19456
19876,Ohanna,F,8,3270074,19899
19877,Ojasvi,F,8,3270082,19261
19878,Olana,F,8,3270090,19103
19879,Olijah,M,8,3270098,19562
19880,Olimpia,F,8,3270106,19280
19881,Olivette,F,8,3270114,19814
19882,Oliviya,F,8,3270122,19959
19883,Oliyah,F,8,3270130,19883
19884,Olliana,F,8,3270138,19203
19885,Oluwadamilola,M,8,3270146,19277
19886,Oluwasemilore,F,8,3270154,19944
19887,Oluwatise,M,8,3270162,19725
19888,Omair,M,8,3270170,19424
19889,Omani,F,8,3270178,19163
19890,Onora,F,8,3270186,19996
19891,Oreoluwa,F,8,3270194,19806
19892,Osaze,M,8,3270202,19332
19893,Osborn,M,8,3270210,19542
19894,Osei,M,8,3270218,19335
19895,Osmond,M,8,3270226,19396
19896,Osten,M,8,3270234,19545
19897,Osvin,M,8,3270242,19064
19898,Ovadia,M,8,3270250,19159
19899,Ovie,M,8,3270258,19678
19900,Owynn,F,8,3270266,19481
19901,Paco,M,8,3270274,19984
19902,Pahal,F,8,3270282,19881
19903,Paisely,F,8,3270290,19962
19904,Paislei,F,8,3270298,19889
19905,Paitynn,F,8,3270306,19195
19906,Parish,F,8,3270314,19851
19907,Pascale,F,8,3270322,19757
19908,Patric,M,8,3270330,19241
19909,Peneloperose,F,8,3270338,19113
19910,Peretz,M,8,3270346,19207
19911,Phillips,M,8,3270354,19362
19912,Phiona,F,8,3270362,19852
19913,Phor,M,8,3270370,19010
19914,Pollyanna,F,8,3270378,19980
19915,Prahlad,M,8,3270386,19791
19916,Pranay,M,8,3270394,19661
19917,Prapti,F,8,3270402,19170
19918,Prentiss,M,8,3270410,19746
19919,Preslynn,F,8,3270418,19711
19920,Prestige,M,8,3270426,19022
19921,Priansh,M,8,3270434,19972
19922,Prosperity,F,8,3270442,19337
19923,Pruitt,M,8,3270450,19747
19924,Prynceton,M,8,3270458,19071
19925,Psalms,M,8,3270466,19934
19926,Purpose,F,8,3270474,19712
19927,Quantavious,M,8,3270482,19837
19928,Quetzally,F,8,3270490,19167
19929,Quillian,M,8,3270498,19043
19930,Quinci,F,8,3270506,19994
19931,Quinnleigh,F,8,3270514,19585
19932,Quinnton,M,8,3270522,19368
19933,Quintessa,F,8,3270530,19089
19934,Quintez,M,8,3270538,19487
19935,Quron,M,8,3270546,19797
19936,Raaga,F,8,3270554,19183
19937,Racquel,F,8,3270562,19793
19938,Radhya,F,8,3270570,19344
19939,Raelani,F,8,3270578,19841
19940,Raelen,F,8,3270586,19380
19941,Raelyne,F,8,3270594,19932
19942,Raeonna,F,8,3270602,19649
19943,Raeshawn,M,8,3270610,19845
19944,Raevynn,F,8,3270618,19351
19945,Rafay,M,8,3270626,19605
19946,Rafeef,F,8,3270634,19877
19947,Rafif,F,8,3270642,19713
19948,Rah,M,8,3270650,19249
19949,Raheel,F,8,3270658,19209
19950,Raif,M,8,3270666,19328
19951,Raiven,F,8,3270674,19608
19952,Raizo,M,8,3270682,19193
19953,Rajan,M,8,3270690,19083
19954,Ralyn,F,8,3270698,19790
19955,Ramani,F,8,3270706,19139
19956,Ramari,M,8,3270714,19535
19957,Ramata,F,8,3270722,19411
19958,Ramiz,M,8,3270730,19378
19959,Ramyah,F,8,3270738,19451
19960,Ramzy,M,8,3270746,19003
19961,Randon,M,8,3270754,19708
19962,Ranyla,F,8,3270762,19334
19963,Rarity,F,8,3270770,19482
19964,Rashed,M,8,3270778,19454
19965,Rashon,M,8,3270786,19546
19966,Raudel,M,8,3270794,19531
19967,Ravneet,F,8,3270802,19024
19968,Rawlins,M,8,3270810,19509
19969,Rayen,M,8,3270818,19916
19970,Raygen,F,8,3270826,19316
19971,Rayhaan,M,8,3270834,19492
19972,Rayni,F,8,3270842,19325
19973,Razi,M,8,3270850,19198
19974,Reagen,F,8,3270858,19377
19975,Rebekka,F,8,3270866,19327
19976,Reesa,F,8,3270874,19343
19977,Reeya,F,8,3270882,19205
19978,Reighan,F,8,3270890,19289
19979,Reika,F,8,3270898,19920
19980,Reiner,M,8,3270906,19160
19981,Remas,F,8,3270914,19947
19982,Remigio,M,8,3270922,19935
19983,Remini,F,8,3270930,19999
19984,Renaldo,M,8,3270938,19499
19985,Renard,M,8,3270946,19190
19986,Renate,F,8,3270954,19079
19987,Renaya,F,8,3270962,19953
19988,Renita,F,8,3270970,19819
19989,Revaan,M,8,3270978,19307
19990,Reyli,M,8,3270986,19472
19991,Rheanna,F,8,3270994,19930
19992,Rhilee,F,8,3271002,19058
19993,Rhiyan,F,8,3271010,19065
19994,Rhoslyn,F,8,3271018,19628
19995,Rhylyn,F,8,3271026,19970
19996,Rianne,F,8,3271034,19013
19997,Ridaan,M,8,3271042,19776
19998,Rilan,M,8,3271050,19733
19999,Rinnah,F,8,3271058,19859
20000,Rivan,M,8,3271066,20973
20001,Roanin,M,8,3271074,20494
20002,Rob,M,8,3271082,20947
20003,Rockland,M,8,3271090,20550
20004,Rocklin,M,8,3271098,20854
20005,Rogers,M,8,3271106,20146
20006,Rohin,M,8,3271114,20945
20007,Rollo,M,8,3271122,20529
20008,Romance,M,8,3271130,20440
20009,Romyn,M,8,3271138,20408
20010,Rosabel,F,8,3271146,20326
20011,Rosalba,F,8,3271154,20437
20012,Rosaura,F,8,3271162,20810
20013,Roseanne,F,8,3271170,20655
20014,Roshni,F,8,3271178,20216
20015,Rosi,F,8,3271186,20860
20016,Roxton,M,8,3271194,20092
20017,Rozana,F,8,3271202,20669
20018,Rua,F,8,3271210,20133
20019,Ruaan,M,8,3271218,20047
20020,Ruel,M,8,3271226,20999
20021,Rufina,F,8,3271234,20375
20022,Ruman,F,8,3271242,20969
20023,Rumer,F,8,3271250,20352
20024,Rustam,M,8,3271258,20355
20025,Ryeland,M,8,3271266,20928
20026,Ryelynn,F,8,3271274,20065
20027,Rykin,M,8,3271282,20787
20028,Ryleah,F,8,3271290,20654
20029,Saalih,M,8,3271298,20523
20030,Sabreena,F,8,3271306,20841
20031,Sabria,F,8,3271314,20144
20032,Saddie,F,8,3271322,20720
20033,Sahan,M,8,3271330,20211
20034,Saharah,F,8,3271338,20834
20035,Sahari,F,8,3271346,20271
20036,Sahirah,F,8,3271354,20831
20037,Sahrai,F,8,3271362,20827
20038,Saiyr,F,8,3271370,20756
20039,Sajad,M,8,3271378,20332
20040,Salam,F,8,3271386,20418
20041,Salar,M,8,3271394,20506
20042,Salimata,F,8,3271402,20151
20043,Salsabeel,F,8,3271410,20140
20044,Salsabil,F,8,3271418,20479
20045,Samaiyah,F,8,3271426,20046
20046,Samiha,F,8,3271434,20164
20047,Samraat,M,8,3271442,20128
20048,Samuele,M,8,3271450,20971
20049,Samuella,F,8,3271458,20721
20050,Samus,F,8,3271466,20870
20051,Samyiah,F,8,3271474,20136
20052,Sanish,M,8,3271482,20036
20053,Sanjeev,M,8,3271490,20818
20054,Santa,F,8,3271498,20001
20055,Sarahelizabeth,F,8,3271506,20263
20056,Saraii,F,8,3271514,20413
20057,Sareena,F,8,3271522,20142
20058,Saumya,F,8,3271530,20158
20059,Savant,M,8,3271538,20634
20060,Savaya,F,8,3271546,20172
20061,Saveah,F,8,3271554,20285
20062,Saveliy,M,8,3271562,20344
20063,Saydie,F,8,3271570,20772
20064,Sayid,M,8,3271578,20802
20065,Sebasthian,M,8,3271586,20445
20066,Seela,F,8,3271594,20572
20067,Seema,F,8,3271602,20833
20068,Sehrish,F,8,3271610,20028
20069,Seidy,F,8,3271618,20101
20070,Senia,F,8,3271626,20327
20071,Sequoyah,M,8,3271634,20024
20072,Sereia,F,8,3271642,20177
20073,Serenidy,F,8,3271650,20381
20074,Severiano,M,8,3271658,20913
20075,Sevn,M,8,3271666,20356
20076,Seyla,F,8,3271674,20848
20077,Shaanvi,F,8,3271682,20112
20078,Shaarvi,F,8,3271690,20579
20079,Shabnam,F,8,3271698,20638
20080,Shadi,M,8,3271706,20759
20081,Shaela,F,8,3271714,20527
20082,Shailyn,F,8,3271722,20460
20083,Shailynn,F,8,3271730,20147
20084,Shain,M,8,3271738,20640
20085,Shakeem,M,8,3271746,20039
20086,Shalva,F,8,3271754,20801
20087,Shamara,F,8,3271762,20922
20088,Shambhavi,F,8,3271770,20320
20089,Shameer,M,8,3271778,20647
20090,Shamiah,F,8,3271786,20926
20091,Shanmukh,M,8,3271794,20652
20092,Shara,F,8,3271802,20641
20093,Shatha,F,8,3271810,20583
20094,Shavon,F,8,3271818,20774
20095,Shazain,M,8,3271826,20993
20096,Shelsea,F,8,3271834,20725
20097,Shemuel,M,8,3271842,20083
20098,Sheri,F,8,3271850,20307
20099,Shevelle,F,8,3271858,20710
20100,Sheylin,F,8,3271866,20603
20101,Shiah,F,8,3271874,20425
20102,Shion,M,8,3271882,20031
20103,Shravan,M,8,3271890,20736
20104,Shreyaan,M,8,3271898,20497
20105,Shritha,F,8,3271906,20763
20106,Shruti,F,8,3271914,20567
20107,Shukri,F,8,3271922,20447
20108,Siegfried,M,8,3271930,20475
20109,Siennah,F,8,3271938,20515
20110,Sigourney,F,8,3271946,20035
20111,Silem,M,8,3271954,20043
20112,Simar,F,8,3271962,20732
20113,Simonne,F,8,3271970,20905
20114,Simrat,F,8,3271978,20726
20115,Sinclaire,F,8,3271986,20520
20116,Skanda,M,8,3271994,20371
20117,Skarleth,F,8,3272002,20166
20118,Skya,F,8,3272010,20429
20119,Skylarose,F,8,3272018,20303
20120,Smayan,M,8,3272026,20743
20121,Smyra,F,8,3272034,20208
20122,Sneyder,M,8,3272042,20300
20123,Sohana,F,8,3272050,20443
20124,Sonam,F,8,3272058,20470
20125,Sondor,F,8,3272066,20279
20126,Sonoma,F,8,3272074,20931
20127,Sophi,F,8,3272082,20078
20128,Sophiamarie,F,8,3272090,20050
20129,Soraiya,F,8,3272098,20458
20130,Soriah,F,8,3272106,20430
20131,Southern,M,8,3272114,20877
20132,Sparkle,F,8,3272122,20792
20133,Starlit,F,8,3272130,20463
20134,Starlyn,F,8,3272138,20297
20135,Steeley,F,8,3272146,20082
20136,Steelie,F,8,3272154,20086
20137,Steffan,M,8,3272162,20444
20138,Stellar,F,8,3272170,20481
20139,Stetsyn,M,8,3272178,20857
20140,Striker,M,8,3272186,20511
20141,Stylez,M,8,3272194,20094
20142,Sugey,F,8,3272202,20098
20143,Sukhmani,F,8,3272210,20704
20144,Sulema,F,8,3272218,20301
20145,Summerlyn,F,8,3272226,20584
20146,Sun,M,8,3272234,20576
20147,Sunjai,F,8,3272242,20286
20148,Suren,M,8,3272250,20866
20149,Suzan,F,8,3272258,20490
20150,Suzu,F,8,3272266,20191
20151,Sylvanas,F,8,3272274,20758
20152,Symphonie,F,8,3272282,20276
20153,Taaliyah,F,8,3272290,20574
20154,Tabria,F,8,3272298,20547
20155,Tacari,M,8,3272306,20373
20156,Taelin,F,8,3272314,20148
20157,Tahiri,F,8,3272322,20472
20158,Taika,M,8,3272330,20100
20159,Taivon,M,8,3272338,20908
20160,Taiyo,M,8,3272346,20435
20161,Tajay,M,8,3272354,20260
20162,Takira,F,8,3272362,20760
20163,Takyla,F,8,3272370,20275
20164,Talaiyah,F,8,3272378,20152
20165,Taliana,F,8,3272386,20296
20166,Talullah,F,8,3272394,20598
20167,Tam,M,8,3272402,20238
20168,Tamen,M,8,3272410,20380
20169,Tamyra,F,8,3272418,20054
20170,Tan,M,8,3272426,20087
20171,Tanishka,F,8,3272434,20416
20172,Tannen,M,8,3272442,20573
20173,Tansy,F,8,3272450,20204
20174,Taren,M,8,3272458,20902
20175,Tariya,F,8,3272466,20984
20176,Tatem,F,8,3272474,20824
20177,Tatym,F,8,3272482,20269
20178,Tavarus,M,8,3272490,20088
20179,Tavius,M,8,3272498,20616
20180,Taylinn,F,8,3272506,20975
20181,Tayte,M,8,3272514,20648
20182,Temiloluwa,F,8,3272522,20806
20183,Terreon,M,8,3272530,20867
20184,Terrianna,F,8,3272538,20819
20185,Terrin,M,8,3272546,20727
20186,Tex,M,8,3272554,20061
20187,Thadeus,M,8,3272562,20820
20188,Thailand,M,8,3272570,20735
20189,Theoren,M,8,3272578,20851
20190,Theory,F,8,3272586,20605
20191,Thorn,M,8,3272594,20705
20192,Thornton,M,8,3272602,20853
20193,Thoryn,M,8,3272610,20292
20194,Tiah,F,8,3272618,20397
20195,Tianah,F,8,3272626,20248
20196,Tiani,F,8,3272634,20396
20197,Tifa,F,8,3272642,20961
20198,Tiona,F,8,3272650,20608
20199,Tiyon,M,8,3272658,20188
20200,Toluwani,F,8,3272666,20864
20201,Toran,M,8,3272674,20135
20202,Toriana,F,8,3272682,20621
20203,Traylen,M,8,3272690,20203
20204,Trayton,M,8,3272698,20250
20205,Tres,M,8,3272706,20531
20206,Treven,M,8,3272714,20069
20207,Trevonte,M,8,3272722,20554
20208,Trinidy,F,8,3272730,20613
20209,Trumaine,M,8,3272738,20960
20210,Trystin,M,8,3272746,20761
20211,Tryton,M,8,3272754,20980
20212,Tyde,M,8,3272762,20207
20213,Tyjae,M,8,3272770,20404
20214,Tykeem,M,8,3272778,20258
20215,Tyrece,M,8,3272786,20302
20216,Tyrez,M,8,3272794,20495
20217,Tyriah,F,8,3272802,20181
20218,Tysin,M,8,3272810,20861
20219,Tziry,F,8,3272818,20570
20220,Udy,F,8,3272826,20183
20221,Umer,M,8,3272834,20575
20222,Uyen,F,8,3272842,20956
20223,Vahn,M,8,3272850,20985
20224,Vaibhav,M,8,3272858,20266
20225,Valentyna,F,8,3272866,20645
20226,Valerio,M,8,3272874,20563
20227,Vallery,F,8,3272882,20883
20228,Vannessa,F,8,3272890,20019
20229,Vanshika,F,8,3272898,20325
20230,Varad,M,8,3272906,20918
20231,Vasili,M,8,3272914,20559
20232,Vayu,M,8,3272922,20023
20233,Vedhika,F,8,3272930,20120
20234,Veeraj,M,8,3272938,20649
20235,Venecia,F,8,3272946,20339
20236,Venessa,F,8,3272954,20117
20237,Veya,F,8,3272962,20526
20238,Vi,F,8,3272970,20309
20239,Vianne,F,8,3272978,20639
20240,Vic,M,8,3272986,20179
20241,Vicki,F,8,3272994,20680
20242,Victoriah,F,8,3273002,20010
20243,Videlle,F,8,3273010,20364
20244,Vienne,F,8,3273018,20793
20245,Vijay,M,8,3273026,20675
20246,Vina,F,8,3273034,20541
20247,Vira,F,8,3273042,20847
20248,Vitalina,F,8,3273050,20027
20249,Vitoria,F,8,3273058,20129
20250,Vivie,F,8,3273066,20315
20251,Viya,F,8,3273074,20597
20252,Viyana,F,8,3273082,20508
20253,Vlada,F,8,3273090,20751
20254,Vuk,M,8,3273098,20278
20255,Vyolette,F,8,3273106,20894
20256,Waad,F,8,3273114,20007
20257,Wacey,M,8,3273122,20409
20258,Warda,F,8,3273130,20150
20259,Weiland,M,8,3273138,20363
20260,Westbrook,M,8,3273146,20588
20261,Weylon,M,8,3273154,20132
20262,Whitton,M,8,3273162,20406
20263,Willemina,F,8,3273170,20426
20264,Winfield,M,8,3273178,20667
20265,Winn,M,8,3273186,20394
20266,Winni,F,8,3273194,20108
20267,Wizdom,M,8,3273202,20353
20268,Wolfram,M,8,3273210,20453
20269,Woodley,M,8,3273218,20119
20270,Worth,M,8,3273226,20393
20271,Worthy,F,8,3273234,20920
20272,Wrangler,M,8,3273242,20097
20273,Wyleigh,F,8,3273250,20692
20274,Wyndham,M,8,3273258,20633
20275,Wysdom,F,8,3273266,20766
20276,Xavyer,M,8,3273274,20951
20277,Xayn,M,8,3273282,20542
20278,Xhaiden,M,8,3273290,20361
20279,Xiya,F,8,3273298,20790
20280,Yaelis,F,8,3273306,20033
20281,Yakelin,F,8,3273314,20251
20282,Yalina,F,8,3273322,20752
20283,Yamato,M,8,3273330,20118
20284,Yamina,F,8,3273338,20367
20285,Yancarlos,M,8,3273346,20057
20286,Yanitza,F,8,3273354,20932
20287,Yanziel,M,8,3273362,20149
20288,Yaphet,M,8,3273370,20749
20289,Yarexi,F,8,3273378,20717
20290,Yarianna,F,8,3273386,20715
20291,Yaritzy,F,8,3273394,20525
20292,Yaseer,M,8,3273402,20066
20293,Yasiin,M,8,3273410,20895
20294,Yaslyn,F,8,3273418,20131
20295,Yassen,M,8,3273426,20816
20296,Yaxiel,M,8,3273434,20934
20297,Yazir,M,8,3273442,20930
20298,Yeilin,F,8,3273450,20799
20299,Yeilyn,F,8,3273458,20811
20300,Yeira,F,8,3273466,20201
20301,Yekusiel,M,8,3273474,20474
20302,Yemaryam,F,8,3273482,20665
20303,Yenty,F,8,3273490,20449
20304,Yeremiah,M,8,3273498,20412
20305,Yian,M,8,3273506,20942
20306,Ylenia,F,8,3273514,20280
20307,Yoali,F,8,3273522,20982
20308,Yoav,M,8,3273530,20636
20309,Yordan,M,8,3273538,20650
20310,Yosmar,M,8,3273546,20422
20311,Yosra,F,8,3273554,20197
20312,Yosselin,F,8,3273562,20011
20313,Yuka,F,8,3273570,20060
20314,Yuktha,F,8,3273578,20185
20315,Yuliett,F,8,3273586,20977
20316,Yunior,M,8,3273594,20491
20317,Yusrah,F,8,3273602,20701
20318,Yussef,M,8,3273610,20845
20319,Yuvaansh,M,8,3273618,20519
20320,Yvanna,F,8,3273626,20477
20321,Yvie,F,8,3273634,20111
20322,Zacarri,M,8,3273642,20800
20323,Zacharie,M,8,3273650,20314
20324,Zacharyah,M,8,3273658,20431
20325,Zachry,M,8,3273666,20073
20326,Zadquiel,M,8,3273674,20202
20327,Zafir,M,8,3273682,20912
20328,Zahki,M,8,3273690,20789
20329,Zahrah,F,8,3273698,20954
20330,Zaier,M,8,3273706,20291
20331,Zakani,M,8,3273714,20417
20332,Zakara,F,8,3273722,20940
20333,Zakarie,M,8,3273730,20983
20334,Zakariyah,M,8,3273738,20723
20335,Zakayla,F,8,3273746,20944
20336,Zakk,M,8,3273754,20795
20337,Zakyah,F,8,3273762,20242
20338,Zanayah,F,8,3273770,20337
20339,Zani,F,8,3273778,20240
20340,Zarius,M,8,3273786,20342
20341,Zaron,M,8,3273794,20072
20342,Zaroon,M,8,3273802,20825
20343,Zaxon,M,8,3273810,20075
20344,Zaydn,M,8,3273818,20399
20345,Zayid,M,8,3273826,20989
20346,Zayleen,F,8,3273834,20503
20347,Zed,M,8,3273842,20137
20348,Zeddicus,M,8,3273850,20110
20349,Zeev,M,8,3273858,20209
20350,Zelina,F,8,3273866,20606
20351,Zeyna,F,8,3273874,20433
20352,Zhoie,F,8,3273882,20803
20353,Zidaan,M,8,3273890,20512
20354,Zierre,M,8,3273898,20707
20355,Zikra,F,8,3273906,20901
20356,Zira,F,8,3273914,20742
20357,Ziv,M,8,3273922,20287
20358,Ziylah,F,8,3273930,20041
20359,Zoel,F,8,3273938,20595
20360,Zohar,F,8,3273946,20003
20361,Zoraida,F,8,3273954,20329
20362,Zorina,F,8,3273962,20874
20363,Zuhayr,M,8,3273970,20897
20364,Zurri,F,8,3273978,20284
20365,Zyen,M,8,3273986,20552
20366,Zyeon,M,8,3273994,20556
20367,Zyhier,M,8,3274002,20255
20368,Zyia,F,8,3274010,20697
20369,Zylin,M,8,3274018,20020
20370,Zylo,M,8,3274026,20728
20371,Zyrie,M,8,3274034,20015
20372,Aadhavan,M,7,3274041,20372
20373,Aagam,M,7,3274048,20632
20374,Aalaiya,F,7,3274055,20411
20375,Aamna,F,7,3274062,20180
20376,Aaniya,F,7,3274069,20821
20377,Aaravi,F,7,3274076,20535
20378,Aari,M,7,3274083,20002
20379,Aarnavi,F,7,3274090,20439
20380,Aarvik,M,7,3274097,20764
20381,Aaryansh,M,7,3274104,20016
20382,Aashvik,M,7,3274111,20182
20383,Abbagail,F,7,3274118,20253
20384,Abdihafid,M,7,3274125,20293
20385,Abdirahim,M,7,3274132,20268
20386,Abdo,M,7,3274139,20879
20387,Abdulahad,M,7,3274146,20340
20388,Abdulhakim,M,7,3274153,20338
20389,Abdulkadir,M,7,3274160,20162
20390,Abdulkarim,M,7,3274167,20744
20391,Abdullatif,M,7,3274174,20469
20392,Abdulrahim,M,7,3274181,20668
20393,Abegail,F,7,3274188,20958
20394,Abhaya,F,7,3274195,20558
20395,Abhi,M,7,3274202,20658
20396,Abhiraj,M,7,3274209,20446
20397,Ablakat,F,7,3274216,20564
20398,Abraxas,M,7,3274223,20988
20399,Abubakarr,M,7,3274230,20145
20400,Aby,F,7,3274237,20323
20401,Acelin,M,7,3274244,20123
20402,Aceston,M,7,3274251,20663
20403,Ackley,M,7,3274258,20998
20404,Adain,M,7,3274265,20257
20405,Adalae,F,7,3274272,20156
20406,Adaleena,F,7,3274279,20049
20407,Adaleyza,F,7,3274286,20730
20408,Adalise,F,7,3274293,20486
20409,Adamae,F,7,3274300,20781
20410,Adamary,F,7,3274307,20239
20411,Adar,F,7,3274314,20102
20412,Addicus,M,7,3274321,20812
20413,Addilyne,F,7,3274328,20369
20414,Addylynn,F,7,3274335,20543
20415,Adefolarin,M,7,3274342,20581
20416,Adelso,M,7,3274349,20540
20417,Adeyemi,M,7,3274356,20237
20418,Adianna,F,7,3274363,20402
20419,Adlie,F,7,3274370,20138
20420,Adoniram,M,7,3274377,20846
20421,Adori,F,7,3274384,20555
20422,Adriane,F,7,3274391,20343
20423,Adrita,F,7,3274398,20442
20424,Advaita,F,7,3274405,20838
20425,Adwoa,F,7,3274412,20480
20426,Adyah,M,7,3274419,20856
20427,Adyant,M,7,3274426,20058
20428,Aelish,F,7,3274433,20544
20429,Aelita,F,7,3274440,20018
20430,Aeralyn,F,7,3274447,20899
20431,Aeri,F,7,3274454,20328
20432,Aerianna,F,7,3274461,20009
20433,Aerys,M,7,3274468,20264
20434,Aesyn,M,7,3274475,20383
20435,Africa,F,7,3274482,20549
20436,Ahavah,F,7,3274489,20594
20437,Ahking,M,7,3274496,20059
20438,Ahkir,M,7,3274503,20456
20439,Ahlayna,F,7,3274510,20358
20440,Ahleah,F,7,3274517,20186
20441,Ahmara,F,7,3274524,20739
20442,Ahniya,F,7,3274531,20627
20443,Ahnna,F,7,3274538,20776
20444,Ahriya,F,7,3274545,20274
20445,Ahtziri,F,7,3274552,20492
20446,Aidana,F,7,3274559,20349
20447,Aideen,F,7,3274566,20395
20448,Aidenjames,M,7,3274573,20478
20449,Aidon,M,7,3274580,20330
20450,Aihnoa,F,7,3274587,20308
20451,Aileena,F,7,3274594,20557
20452,Ailene,F,7,3274601,20345
20453,Ailie,F,7,3274608,20504
20454,Aimen,M,7,3274615,20622
20455,Airalynn,F,7,3274622,20842
20456,Airianna,F,7,3274629,20914
20457,Aisa,F,7,3274636,20228
20458,Aisen,M,7,3274643,20322
20459,Aitiana,F,7,3274650,20493
20460,Aizik,M,7,3274657,20869
20461,Aizley,F,7,3274664,20677
20462,Ajahni,M,7,3274671,20277
20463,Ajayceon,M,7,3274678,20488
20464,Ajayla,F,7,3274685,20466
20465,Ajeet,M,7,3274692,20571
20466,Akaiden,M,7,3274699,20876
20467,Akela,F,7,3274706,20370
20468,Akhilles,M,7,3274713,20589
20469,Akosua,F,7,3274720,20106
20470,Aksha,F,7,3274727,20407
20471,Akyrah,F,7,3274734,20987
20472,Akzel,M,7,3274741,20388
20473,Alaeyah,F,7,3274748,20482
20474,Alainna,F,7,3274755,20625
20475,Alakay,M,7,3274762,20788
20476,Alanya,F,7,3274769,20004
20477,Alarah,F,7,3274776,20365
20478,Alarick,M,7,3274783,20773
20479,Alayzia,F,7,3274790,20312
20480,Albara,M,7,3274797,20849
20481,Albeiro,M,7,3274804,20489
20482,Alecxander,M,7,3274811,20173
20483,Aleesi,F,7,3274818,20362
20484,Aleix,M,7,3274825,20392
20485,Alem,M,7,3274832,20835
20486,Alexio,M,7,3274839,20666
20487,Alexx,M,7,3274846,20270
20488,Alhaji,M,7,3274853,20716
20489,Alheli,F,7,3274860,20229
20490,Alikhan,M,7,3274867,20620
20491,Aliona,F,7,3274874,20936
20492,Allia,F,7,3274881,20167
20493,Allorah,F,7,3274888,20079
20494,Alouette,F,7,3274895,20660
20495,Alson,M,7,3274902,20160
20496,Althaea,F,7,3274909,20210
20497,Alysiana,F,7,3274916,20630
20498,Amaly,F,7,3274923,20154
20499,Amando,M,7,3274930,20214
20500,Amarachukwu,F,7,3274937,20582
20501,Amarae,F,7,3274944,20243
20502,Amariee,F,7,3274951,20125
20503,Amario,M,7,3274958,20679
20504,Ambra,F,7,3274965,20757
20505,Ambrosio,M,7,3274972,20171
20506,Ameelah,F,7,3274979,20580
20507,Amenah,F,7,3274986,20909
20508,Ameri,F,7,3274993,20298
20509,Amiee,F,7,3275000,20809
20510,Amika,F,7,3275007,20623
20511,Amiko,F,7,3275014,20986
20512,Amilea,F,7,3275021,20420
20513,Amilianna,F,7,3275028,20962
20514,Amiryah,F,7,3275035,20791
20515,Amitai,M,7,3275042,20682
20516,Amiyrah,F,7,3275049,20410
20517,Amonii,F,7,3275056,20379
20518,Amoray,F,7,3275063,20161
20519,Amram,M,7,3275070,20262
20520,Amulya,F,7,3275077,20915
20521,Amyracle,F,7,3275084,20071
20522,Amyree,F,7,3275091,20784
20523,Anab,F,7,3275098,20252
20524,Anahla,F,7,3275105,20755
20525,Analei,F,7,3275112,20796
20526,Analeyah,F,7,3275119,20528
20527,Analina,F,7,3275126,20113
20528,Analuisa,F,7,3275133,20184
20529,Analys,F,7,3275140,20734
20530,Ananda,F,7,3275147,20601
20531,Ananth,M,7,3275154,20674
20532,Anaylah,F,7,3275161,20888
20533,Andilyn,F,7,3275168,20400
20534,Andrina,F,7,3275175,20321
20535,Aneeka,F,7,3275182,20336
20536,Aneira,F,7,3275189,20467
20537,Anelle,F,7,3275196,20310
20538,Aneri,F,7,3275203,20745
20539,Anesa,F,7,3275210,20272
20540,Anezka,F,7,3275217,20168
20541,Angeleigh,F,7,3275224,20533
20542,Angelgabriel,M,7,3275231,20832
20543,Angelisse,F,7,3275238,20643
20544,Angelito,M,7,3275245,20939
20545,Anir,M,7,3275252,20565
20546,Anivia,F,7,3275259,20884
20547,Anka,F,7,3275266,20590
20548,Anker,M,7,3275273,20878
20549,Anllely,F,7,3275280,20661
20550,Annalisia,F,7,3275287,20044
20551,Annalize,F,7,3275294,20198
20552,Annarae,F,7,3275301,20946
20553,Annebelle,F,7,3275308,20265
20554,Annella,F,7,3275315,20013
20555,Anniah,F,7,3275322,20891
20556,Annisten,F,7,3275329,20192
20557,Annsleigh,F,7,3275336,20247
20558,Antavious,M,7,3275343,20617
20559,Antonette,F,7,3275350,20955
20560,Antonieta,F,7,3275357,20081
20561,Antwuan,M,7,3275364,20246
20562,Anuoluwa,F,7,3275371,20885
20563,Anza,F,7,3275378,20509
20564,Aoi,F,7,3275385,20966
20565,Aoibheann,F,7,3275392,20933
20566,Arabellah,F,7,3275399,20273
20567,Aracelli,F,7,3275406,20038
20568,Aradia,F,7,3275413,20306
20569,Araly,F,7,3275420,20505
20570,Aranea,F,7,3275427,20740
20571,Arbella,F,7,3275434,20767
20572,Arcadius,M,7,3275441,20454
20573,Arcangel,M,7,3275448,20858
20574,Archimedes,M,7,3275455,20614
20575,Ardi,M,7,3275462,20685
20576,Areeb,M,7,3275469,20943
20577,Arelys,F,7,3275476,20223
20578,Areyah,F,7,3275483,20155
20579,Arhaam,M,7,3275490,20995
20580,Ariadny,F,7,3275497,20536
20581,Ariebella,F,7,3275504,20359
20582,Arielly,F,7,3275511,20657
20583,Ariona,F,7,3275518,20534
20584,Arjay,M,7,3275525,20366
20585,Arjuna,M,7,3275532,20386
20586,Arli,F,7,3275539,20195
20587,Arlis,M,7,3275546,20814
20588,Armahni,M,7,3275553,20259
20589,Armanni,F,7,3275560,20964
20590,Armari,M,7,3275567,20335
20591,Armida,F,7,3275574,20194
20592,Armstrong,M,7,3275581,20206
20593,Arne,M,7,3275588,20225
20594,Arpan,M,7,3275595,20863
20595,Arrayah,F,7,3275602,20299
20596,Arrie,F,7,3275609,20318
20597,Arriella,F,7,3275616,20235
20598,Arriya,F,7,3275623,20311
20599,Arrya,F,7,3275630,20686
20600,Arsal,M,7,3275637,20830
20601,Arshaun,M,7,3275644,20360
20602,Artez,M,7,3275651,20212
20603,Arvik,M,7,3275658,20678
20604,Aryen,M,7,3275665,20485
20605,Aryes,M,7,3275672,20037
20606,Aryion,M,7,3275679,20304
20607,Aryonna,F,7,3275686,20005
20608,Arys,F,7,3275693,20927
20609,Aryssa,F,7,3275700,20607
20610,Arzu,F,7,3275707,20401
20611,Asahi,M,7,3275714,20139
20612,Ashely,F,7,3275721,20374
20613,Ashiyah,F,7,3275728,20341
20614,Ashli,F,7,3275735,20702
20615,Ashna,F,7,3275742,20808
20616,Ashya,F,7,3275749,20176
20617,Asinat,F,7,3275756,20076
20618,Aslin,F,7,3275763,20178
20619,Assiatou,F,7,3275770,20919
20620,Astou,F,7,3275777,20350
20621,Astrea,F,7,3275784,20952
20622,Athens,M,7,3275791,20850
20623,Atli,M,7,3275798,20780
20624,Aubrionna,F,7,3275805,20382
20625,Audemar,M,7,3275812,20829
20626,Audrea,F,7,3275819,20826
20627,Audrena,F,7,3275826,20045
20628,Aurel,M,7,3275833,20159
20629,Aurellia,F,7,3275840,20585
20630,Auren,M,7,3275847,20604
20631,Avalia,F,7,3275854,20560
20632,Avalise,F,7,3275861,20693
20633,Avannah,F,7,3275868,20768
20634,Avena,F,7,3275875,20464
20635,Avera,F,7,3275882,20187
20636,Avier,M,7,3275889,20165
20637,Aviraaj,M,7,3275896,20448
20638,Avishka,F,7,3275903,20130
20639,Avona,F,7,3275910,20114
20640,Avriel,M,7,3275917,20070
20641,Avriella,F,7,3275924,20465
20642,Avyansh,M,7,3275931,20227
20643,Awad,M,7,3275938,20903
20644,Awesome,M,7,3275945,20517
20645,Axis,M,7,3275952,20892
20646,Axsel,M,7,3275959,20731
20647,Axston,M,7,3275966,20483
20648,Aydien,M,7,3275973,20670
20649,Ayira,F,7,3275980,20656
20650,Aynsley,F,7,3275987,20691
20651,Ayriah,F,7,3275994,20644
20652,Ayriana,F,7,3276001,20959
20653,Ayrianna,F,7,3276008,20762
20654,Azahel,M,7,3276015,20053
20655,Azaira,F,7,3276022,20099
20656,Azal,F,7,3276029,20077
20657,Azaliyah,F,7,3276036,20231
20658,Azarel,M,7,3276043,20048
20659,Azarian,M,7,3276050,20738
20660,Azario,M,7,3276057,20317
20661,Azarya,F,7,3276064,20221
20662,Azavion,M,7,3276071,20224
20663,Azelle,F,7,3276078,20387
20664,Azena,F,7,3276085,20434
20665,Azmina,F,7,3276092,20569
20666,Azorah,F,7,3276099,20548
20667,Bahati,F,7,3276106,20331
20668,Bakr,M,7,3276113,20965
20669,Baldomero,M,7,3276120,20872
20670,Bam,M,7,3276127,20389
20671,Baraa,F,7,3276134,20771
20672,Bareerah,F,7,3276141,20706
20673,Battal,M,7,3276148,20068
20674,Beckhym,M,7,3276155,20017
20675,Becklyn,F,7,3276162,20991
20676,Belem,F,7,3276169,20398
20677,Bellen,F,7,3276176,20974
20678,Belsy,F,7,3276183,20813
20679,Beniah,M,7,3276190,20688
20680,Benicia,F,7,3276197,20459
20681,Benjimin,M,7,3276204,20424
20682,Benning,M,7,3276211,20288
20683,Benno,M,7,3276218,20599
20684,Bentli,F,7,3276225,20712
20685,Beowulf,M,7,3276232,20190
20686,Beza,F,7,3276239,20839
20687,Bhuvi,F,7,3276246,20473
20688,Bia,F,7,3276253,20970
20689,Bilaal,M,7,3276260,20141
20690,Bilen,F,7,3276267,20997
20691,Birdee,F,7,3276274,20283
20692,Birk,M,7,3276281,20218
20693,Blanka,F,7,3276288,20351
20694,Blayde,M,7,3276295,20234
20695,Blayre,F,7,3276302,20805
20696,Blayton,M,7,3276309,20577
20697,Bonifacio,M,7,3276316,20496
20698,Borys,M,7,3276323,20006
20699,Brace,M,7,3276330,20602
20700,Bradlyn,M,7,3276337,20882
20701,Braela,F,7,3276344,20637
20702,Braeya,F,7,3276351,20904
20703,Brahim,M,7,3276358,20103
20704,Braileigh,F,7,3276365,20522
20705,Brailen,M,7,3276372,20032
20706,Braxen,M,7,3276379,20127
20707,Breeana,F,7,3276386,20514
20708,Breia,F,7,3276393,20587
20709,Brena,F,7,3276400,20305
20710,Brendalyn,F,7,3276407,20539
20711,Brene,F,7,3276414,20972
20712,Brenn,M,7,3276421,20568
20713,Brentleigh,F,7,3276428,20696
20714,Brexlynn,F,7,3276435,20737
20715,Breyah,F,7,3276442,20124
20716,Breyer,M,7,3276449,20782
20717,Breylen,M,7,3276456,20084
20718,Breylin,M,7,3276463,20684
20719,Briannah,F,7,3276470,20502
20720,Briauna,F,7,3276477,20817
20721,Brida,F,7,3276484,20992
20722,Bridges,M,7,3276491,20873
20723,Brielynn,F,7,3276498,20289
20724,Brightly,F,7,3276505,20294
20725,Brinklee,F,7,3276512,20468
20726,Brinsley,F,7,3276519,20698
20727,Brisha,F,7,3276526,20532
20728,Brita,F,7,3276533,20733
20729,Bronte,F,7,3276540,20377
20730,Bronze,M,7,3276547,20391
20731,Browning,M,7,3276554,20405
20732,Brya,F,7,3276561,20121
20733,Bryella,F,7,3276568,20618
20734,Brynnlea,F,7,3276575,20074
20735,Bryony,F,7,3276582,20600
20736,Burech,M,7,3276589,20769
20737,Burhan,M,7,3276596,20929
20738,Burkleigh,F,7,3276603,20553
20739,Cabrini,F,7,3276610,20941
20740,Caely,F,7,3276617,20376
20741,Caffrey,M,7,3276624,20689
20742,Cahir,M,7,3276631,20651
20743,Cahlani,F,7,3276638,20671
20744,Cahri,F,7,3276645,20499
20745,Cainon,M,7,3276652,20586
20746,Caleo,M,7,3276659,20143
20747,Calianne,F,7,3276666,20729
20748,Callon,M,7,3276673,20056
20749,Camaria,F,7,3276680,20521
20750,Camoni,F,7,3276687,20510
20751,Campion,M,7,3276694,20794
20752,Canden,M,7,3276701,20981
20753,Carbon,M,7,3276708,20230
20754,Cardi,F,7,3276715,20282
20755,Carely,F,7,3276722,20537
20756,Carine,F,7,3276729,20924
20757,Carisma,F,7,3276736,20461
20758,Carleah,F,7,3276743,20153
20759,Carlena,F,7,3276750,20963
20760,Carlens,M,7,3276757,20700
20761,Cas,M,7,3276764,20200
20762,Caselyn,F,7,3276771,20174
20763,Casher,M,7,3276778,20427
20764,Casin,M,7,3276785,20095
20765,Cassien,M,7,3276792,20170
20766,Casten,M,7,3276799,20055
20767,Catarino,M,7,3276806,20062
20768,Catherina,F,7,3276813,20785
20769,Cathleen,F,7,3276820,20390
20770,Celest,F,7,3276827,20690
20771,Cerinity,F,7,3276834,20134
20772,Cezar,M,7,3276841,20886
20773,Chaithra,F,7,3276848,20646
20774,Chanan,M,7,3276855,20500
20775,Chaniyah,F,7,3276862,20104
20776,Chanley,F,7,3276869,20236
20777,Chaos,M,7,3276876,20906
20778,Charlianne,F,7,3276883,20507
20779,Charliemae,F,7,3276890,20378
20780,Charlii,F,7,3276897,20042
20781,Charline,F,7,3276904,20935
20782,Charlirose,F,7,3276911,20921
20783,Charlotterose,F,7,3276918,20862
20784,Chaselynn,F,7,3276925,20722
20785,Chastity,F,7,3276932,20193
20786,Chauncy,M,7,3276939,20746
20787,Chavi,F,7,3276946,20925
20788,Chavis,M,7,3276953,20610
20789,Chayim,M,7,3276960,20840
20790,Chayson,M,7,3276967,20578
20791,Chen,M,7,3276974,20994
20792,Cheri,F,7,3276981,20357
20793,Chesley,F,7,3276988,20415
20794,Cheveyo,M,7,3276995,20900
20795,Chisimdi,F,7,3277002,20714
20796,Choice,M,7,3277009,20865
20797,Chrishon,M,7,3277016,20836
20798,Christien,M,7,3277023,20022
20799,Chukwuka,M,7,3277030,20551
20800,Chynna,F,7,3277037,20948
20801,Cicilia,F,7,3277044,20354
20802,Cielle,F,7,3277051,20421
20803,Cinder,F,7,3277058,20384
20804,Cinderella,F,7,3277065,20911
20805,Cinthya,F,7,3277072,20452
20806,Cionna,F,7,3277079,20219
20807,Cira,F,7,3277086,20672
20808,Cloey,F,7,3277093,20052
20809,Coal,M,7,3277100,20724
20810,Columbus,M,7,3277107,20029
20811,Connar,M,7,3277114,20414
20812,Constantino,M,7,3277121,20232
20813,Coriana,F,7,3277128,20844
20814,Corianna,F,7,3277135,20881
20815,Corry,M,7,3277142,20244
20816,Corson,M,7,3277149,20713
20817,Cortlyn,F,7,3277156,20770
20818,Coyer,M,7,3277163,20115
20819,Creedon,M,7,3277170,20157
20820,Creston,M,7,3277177,20804
20821,Cricket,F,7,3277184,20085
20822,Crisbell,F,7,3277191,20673
20823,Cristi,F,7,3277198,20798
20824,Crowley,M,7,3277205,20368
20825,Cullin,M,7,3277212,20950
20826,Culver,M,7,3277219,20681
20827,Cyani,F,7,3277226,20852
20828,Czarina,F,7,3277233,20619
20829,Daciana,F,7,3277240,20256
20830,Dacre,M,7,3277247,20090
20831,Daenarys,F,7,3277254,20957
20832,Daesean,M,7,3277261,20471
20833,Dagmawi,M,7,3277268,20778
20834,Daichi,M,7,3277275,20213
20835,Dailah,F,7,3277282,20030
20836,Dailon,M,7,3277289,20592
20837,Daion,M,7,3277296,20561
20838,Daivion,M,7,3277303,20822
20839,Daiza,F,7,3277310,20718
20840,Daizee,F,7,3277317,20313
20841,Dakayla,F,7,3277324,20979
20842,Daksha,F,7,3277331,20765
20843,Dalayna,F,7,3277338,20871
20844,Daley,F,7,3277345,20450
20845,Daleyssa,F,7,3277352,20917
20846,Daliya,F,7,3277359,20423
20847,Dallie,F,7,3277366,20025
20848,Dallyn,M,7,3277373,20591
20849,Daltyn,M,7,3277380,20220
20850,Damaree,M,7,3277387,20562
20851,Damylah,F,7,3277394,20815
20852,Daniell,M,7,3277401,20566
20853,Daniyla,F,7,3277408,20687
20854,Daniylah,F,7,3277415,20217
20855,Danzel,M,7,3277422,20797
20856,Daphnee,F,7,3277429,20333
20857,Darasimi,F,7,3277436,20281
20858,Darly,F,7,3277443,20334
20859,Darris,M,7,3277450,20937
20860,Darwyn,M,7,3277457,20462
20861,Daryll,M,7,3277464,20807
20862,Daryus,M,7,3277471,20843
20863,Dava,F,7,3277478,20837
20864,Davarion,M,7,3277485,20953
20865,Davaughn,M,7,3277492,20910
20866,Daveena,F,7,3277499,20703
20867,Davell,M,7,3277506,20754
20868,Davinity,F,7,3277513,20996
20869,Dawoud,M,7,3277520,20498
20870,Dayleigh,F,7,3277527,20107
20871,Dayli,F,7,3277534,20596
20872,Daysen,M,7,3277541,20008
20873,Deacan,M,7,3277548,20783
20874,Deakin,M,7,3277555,20624
20875,Deanne,F,7,3277562,20695
20876,Dearie,F,7,3277569,20719
20877,Decarlos,M,7,3277576,20067
20878,Decklen,M,7,3277583,20990
20879,Decland,M,7,3277590,20064
20880,Deeksha,F,7,3277597,20859
20881,Deiondre,M,7,3277604,20196
20882,Dejanae,F,7,3277611,20753
20883,Deker,M,7,3277618,20254
20884,Dekoda,M,7,3277625,20545
20885,Dellah,F,7,3277632,20653
20886,Dellarae,F,7,3277639,20295
20887,Delma,F,7,3277646,20609
20888,Delon,M,7,3277653,20748
20889,Delorean,M,7,3277660,20093
20890,Delroy,M,7,3277667,20779
20891,Delsin,M,7,3277674,20976
20892,Delson,M,7,3277681,20893
20893,Demarquis,M,7,3277688,20347
20894,Demia,F,7,3277695,20916
20895,Demilade,M,7,3277702,20096
20896,Demirose,F,7,3277709,20875
20897,Demmi,F,7,3277716,20026
20898,Demonta,M,7,3277723,20419
20899,Demontay,M,7,3277730,20694
20900,Denari,M,7,3277737,20741
20901,Denham,M,7,3277744,20896
20902,Deniya,F,7,3277751,20855
20903,Dennison,M,7,3277758,20949
20904,Denylah,F,7,3277765,20786
20905,Dereon,M,7,3277772,20747
20906,Derianna,F,7,3277779,20629
20907,Derius,M,7,3277786,20662
20908,Deriyah,F,7,3277793,20021
20909,Derrin,M,7,3277800,20014
20910,Desiderio,M,7,3277807,20628
20911,Desteny,F,7,3277814,20750
20912,Devaj,M,7,3277821,20080
20913,Devani,F,7,3277828,20063
20914,Devanni,F,7,3277835,20887
20915,Devari,M,7,3277842,20432
20916,Deveah,F,7,3277849,20476
20917,Dewitt,M,7,3277856,20126
20918,Deylin,F,7,3277863,20457
20919,Deyon,M,7,3277870,20245
20920,Dezarae,F,7,3277877,20889
20921,Dezariah,F,7,3277884,20708
20922,Deziah,F,7,3277891,20775
20923,Dezlynn,F,7,3277898,20438
20924,Dezmen,M,7,3277905,20777
20925,Dhanvika,F,7,3277912,20428
20926,Dhatri,F,7,3277919,20261
20927,Dhyana,F,7,3277926,20403
20928,Diar,M,7,3277933,20518
20929,Dierre,M,7,3277940,20324
20930,Dieter,M,7,3277947,20967
20931,Dillian,M,7,3277954,20012
20932,Dilnura,F,7,3277961,20907
20933,Dilon,M,7,3277968,20709
20934,Dilreet,F,7,3277975,20890
20935,Dilsher,M,7,3277982,20593
20936,Dimitra,F,7,3277989,20676
20937,Diogo,M,7,3277996,20199
20938,Dioni,F,7,3278003,20823
20939,Divij,M,7,3278010,20538
20940,Divith,M,7,3278017,20530
20941,Divyan,M,7,3278024,20501
20942,Diyana,F,7,3278031,20385
20943,Diyora,F,7,3278038,20968
20944,Doba,F,7,3278045,20105
20945,Dollie,F,7,3278052,20346
20946,Dominque,M,7,3278059,20868
20947,Donaven,M,7,3278066,20898
20948,Donelle,M,7,3278073,20034
20949,Donia,F,7,3278080,20215
20950,Donye,M,7,3278087,20642
20951,Dorsa,F,7,3278094,20626
20952,Dory,F,7,3278101,20290
20953,Draizy,F,7,3278108,20040
20954,Dravin,M,7,3278115,20441
20955,Dray,M,7,3278122,20516
20956,Dreamer,M,7,3278129,20116
20957,Drey,M,7,3278136,20051
20958,Dupree,M,7,3278143,20880
20959,Durant,M,7,3278150,20249
20960,Durell,M,7,3278157,20109
20961,Duy,M,7,3278164,20189
20962,Dylanie,F,7,3278171,20978
20963,Dyllon,M,7,3278178,20169
20964,Dyuthi,F,7,3278185,20348
20965,Early,M,7,3278192,20205
20966,Eastlynn,F,7,3278199,20436
20967,Eastwood,M,7,3278206,20828
20968,Eboni,F,7,3278213,20635
20969,Edalynn,F,7,3278220,20000
20970,Edelweiss,F,7,3278227,20664
20971,Edelynn,F,7,3278234,20241
20972,Edianny,F,7,3278241,20513
20973,Edilberto,M,7,3278248,20923
20974,Edilson,M,7,3278255,20612
20975,Edyson,M,7,3278262,20222
20976,Ehab,M,7,3278269,20163
20977,Eidel,F,7,3278276,20524
20978,Eirik,M,7,3278283,20683
20979,Eito,M,7,3278290,20319
20980,Elainah,F,7,3278297,20451
20981,Elaiya,F,7,3278304,20267
20982,Elaria,F,7,3278311,20938
20983,Elegance,F,7,3278318,20089
20984,Elend,M,7,3278325,20091
20985,Elessia,F,7,3278332,20233
20986,Eliahna,F,7,3278339,20699
20987,Eliannys,F,7,3278346,20546
20988,Eliano,M,7,3278353,20484
20989,Elijaah,M,7,3278360,20487
20990,Elijahjames,M,7,3278367,20175
20991,Elior,M,7,3278374,20611
20992,Elison,M,7,3278381,20659
20993,Eliu,M,7,3278388,20455
20994,Eliyahna,F,7,3278395,20122
20995,Elizabelle,F,7,3278402,20316
20996,Elizabethann,F,7,3278409,20631
20997,Elizabethgrace,F,7,3278416,20615
20998,Elkanah,M,7,3278423,20226
20999,Elke,F,7,3278430,20711
21000,Elkin,M,7,3278437,21462
21001,Ellajane,F,7,3278444,21089
21002,Ellawyn,F,7,3278451,21251
21003,Elliann,F,7,3278458,21641
21004,Elliauna,F,7,3278465,21473
21005,Ellionna,F,7,3278472,21947
21006,Ellsie,F,7,3278479,21154
21007,Ellynor,F,7,3278486,21401
21008,Elmin,M,7,3278493,21225
21009,Elmira,F,7,3278500,21773
21010,Elonzo,M,7,3278507,21863
21011,Elowynn,F,7,3278514,21669
21012,Elrey,M,7,3278521,21074
21013,Elroi,M,7,3278528,21378
21014,Elston,M,7,3278535,21864
21015,Elyria,F,7,3278542,21447
21016,Elysse,F,7,3278549,21189
21017,Elzie,F,7,3278556,21113
21018,Emary,F,7,3278563,21220
21019,Emellia,F,7,3278570,21564
21020,Emeria,F,7,3278577,21155
21021,Emerlie,F,7,3278584,21742
21022,Emmalea,F,7,3278591,21562
21023,Emmara,F,7,3278598,21141
21024,Emmeric,M,7,3278605,21173
21025,Emmeryn,F,7,3278612,21870
21026,Emmilia,F,7,3278619,21988
21027,Emmilynn,F,7,3278626,21625
21028,Emmrie,F,7,3278633,21097
21029,Emonee,F,7,3278640,21316
21030,Emonte,M,7,3278647,21300
21031,Emra,F,7,3278654,21398
21032,Emron,M,7,3278661,21306
21033,Emslee,F,7,3278668,21441
21034,Emyah,F,7,3278675,21380
21035,Envi,F,7,3278682,21832
21036,Enzio,M,7,3278689,21954
21037,Ephrem,M,7,3278696,21799
21038,Eragon,M,7,3278703,21957
21039,Erial,F,7,3278710,21483
21040,Ericsson,M,7,3278717,21065
21041,Eriq,M,7,3278724,21324
21042,Ermelinda,F,7,3278731,21233
21043,Escanor,M,7,3278738,21171
21044,Eshaun,M,7,3278745,21298
21045,Esmael,M,7,3278752,21667
21046,Esmia,F,7,3278759,21417
21047,Esmie,F,7,3278766,21551
21048,Eson,M,7,3278773,21339
21049,Esper,M,7,3278780,21889
21050,Esrom,M,7,3278787,21493
21051,Etai,M,7,3278794,21909
21052,Euphemia,F,7,3278801,21117
21053,Euro,M,7,3278808,21495
21054,Evalea,F,7,3278815,21175
21055,Evalise,F,7,3278822,21809
21056,Evayah,F,7,3278829,21826
21057,Eveleen,F,7,3278836,21835
21058,Evella,F,7,3278843,21944
21059,Evonna,F,7,3278850,21151
21060,Ewaoluwa,F,7,3278857,21959
21061,Exton,M,7,3278864,21811
21062,Eymen,M,7,3278871,21969
21063,Eyoel,M,7,3278878,21496
21064,Ezaan,M,7,3278885,21020
21065,Ezan,M,7,3278892,21416
21066,Eze,M,7,3278899,21838
21067,Ezmay,F,7,3278906,21247
21068,Ezralynn,F,7,3278913,21424
21069,Fabiano,M,7,3278920,21698
21070,Facundo,M,7,3278927,21108
21071,Fadil,M,7,3278934,21678
21072,Fahed,M,7,3278941,21194
21073,Faithe,F,7,3278948,21466
21074,Fanuel,M,7,3278955,21381
21075,Fardowsa,F,7,3278962,21706
21076,Farha,F,7,3278969,21961
21077,Faria,F,7,3278976,21807
21078,Farisha,F,7,3278983,21990
21079,Fariza,F,7,3278990,21007
21080,Fartun,F,7,3278997,21374
21081,Fatih,M,7,3279004,21045
21082,Faya,F,7,3279011,21369
21083,Faythe,F,7,3279018,21453
21084,Feivel,M,7,3279025,21336
21085,Felicie,F,7,3279032,21144
21086,Fender,M,7,3279039,21396
21087,Fenleigh,F,7,3279046,21468
21088,Fenn,M,7,3279053,21433
21089,Fenwick,M,7,3279060,21828
21090,Feven,F,7,3279067,21481
21091,Finesse,M,7,3279074,21946
21092,Florentino,M,7,3279081,21543
21093,Floriana,F,7,3279088,21276
21094,Flourish,F,7,3279095,21488
21095,Flynt,M,7,3279102,21415
21096,Forrester,M,7,3279109,21293
21097,Franceska,F,7,3279116,21785
21098,Franchesco,M,7,3279123,21203
21099,Franck,M,7,3279130,21437
21100,Franny,F,7,3279137,21402
21101,Freyr,M,7,3279144,21921
21102,Frimy,F,7,3279151,21890
21103,Fynleigh,F,7,3279158,21615
21104,Fynley,F,7,3279165,21344
21105,Gabriellah,F,7,3279172,21603
21106,Gadi,M,7,3279179,21146
21107,Gahan,M,7,3279186,21328
21108,Gal,F,7,3279193,21825
21109,Gale,M,7,3279200,21851
21110,Galiana,F,7,3279207,21284
21111,Gamal,M,7,3279214,21319
21112,Ganeev,F,7,3279221,21252
21113,Gardenia,F,7,3279228,21814
21114,Gatlen,M,7,3279235,21559
21115,Gavriella,F,7,3279242,21817
21116,Genoveva,F,7,3279249,21965
21117,Genysis,F,7,3279256,21727
21118,Geonna,F,7,3279263,21530
21119,Geraldo,M,7,3279270,21303
21120,Ghia,F,7,3279277,21542
21121,Gianlucas,M,7,3279284,21919
21122,Gianluigi,M,7,3279291,21112
21123,Giddeon,M,7,3279298,21055
21124,Gilda,F,7,3279305,21158
21125,Giordano,M,7,3279312,21693
21126,Giorgi,M,7,3279319,21335
21127,Glorious,F,7,3279326,21379
21128,Goku,M,7,3279333,21174
21129,Gracelee,F,7,3279340,21598
21130,Graecyn,F,7,3279347,21482
21131,Grayleigh,F,7,3279354,21047
21132,Greenly,F,7,3279361,21523
21133,Greysi,F,7,3279368,21958
21134,Guenevere,F,7,3279375,21719
21135,Gulianna,F,7,3279382,21792
21136,Gurbaj,M,7,3279389,21013
21137,Gurnav,M,7,3279396,21771
21138,Gurneet,F,7,3279403,21057
21139,Gwendelyn,F,7,3279410,21769
21140,Gwendolyne,F,7,3279417,21534
21141,Gyan,M,7,3279424,21041
21142,Gynesis,F,7,3279431,21810
21143,Haaris,M,7,3279438,21975
21144,Haasini,F,7,3279445,21219
21145,Habibah,F,7,3279452,21104
21146,Hadara,F,7,3279459,21575
21147,Hadasah,F,7,3279466,21927
21148,Hadasha,F,7,3279473,21005
21149,Hadlynn,F,7,3279480,21611
21150,Hadriel,M,7,3279487,21508
21151,Hadyn,F,7,3279494,21197
21152,Haifa,F,7,3279501,21746
21153,Haila,F,7,3279508,21548
21154,Haim,M,7,3279515,21010
21155,Haja,F,7,3279522,21243
21156,Halana,F,7,3279529,21621
21157,Halani,F,7,3279536,21713
21158,Halayah,F,7,3279543,21448
21159,Halayna,F,7,3279550,21479
21160,Halden,M,7,3279557,21847
21161,Haleem,M,7,3279564,21666
21162,Haleema,F,7,3279571,21215
21163,Hallel,F,7,3279578,21740
21164,Halstyn,F,7,3279585,21218
21165,Handsome,M,7,3279592,21888
21166,Haniah,F,7,3279599,21006
21167,Hanin,F,7,3279606,21596
21168,Hanya,F,7,3279613,21014
21169,Harish,M,7,3279620,21122
21170,Harleyquinn,F,7,3279627,21208
21171,Harminee,F,7,3279634,21980
21172,Harshan,M,7,3279641,21660
21173,Harshith,M,7,3279648,21652
21174,Hartford,M,7,3279655,21177
21175,Hassen,M,7,3279662,21168
21176,Havannah,F,7,3279669,21314
21177,Hayaan,M,7,3279676,21063
21178,Haydan,M,7,3279683,21628
21179,Hayli,F,7,3279690,21791
21180,Haysley,F,7,3279697,21501
21181,Hazlynn,F,7,3279704,21410
21182,Heartly,F,7,3279711,21865
21183,Hebe,F,7,3279718,21242
21184,Hela,F,7,3279725,21454
21185,Helaman,M,7,3279732,21269
21186,Helia,F,7,3279739,21892
21187,Heloise,F,7,3279746,21555
21188,Hena,F,7,3279753,21993
21189,Henning,M,7,3279760,21682
21190,Henryjames,M,7,3279767,21262
21191,Hester,F,7,3279774,21092
21192,Hewan,F,7,3279781,21584
21193,Heyam,F,7,3279788,21753
21194,Heylin,F,7,3279795,21797
21195,Hilkiah,M,7,3279802,21885
21196,Hinson,M,7,3279809,21591
21197,Hiyan,M,7,3279816,21095
21198,Holleigh,F,7,3279823,21677
21199,Hollin,F,7,3279830,21579
21200,Hollynd,F,7,3279837,21309
21201,Hondo,M,7,3279844,21721
21202,Honeste,F,7,3279851,21071
21203,Honoka,F,7,3279858,21213
21204,Hughie,M,7,3279865,21759
21205,Huk,M,7,3279872,21370
21206,Husayn,M,7,3279879,21585
21207,Hutchison,M,7,3279886,21756
21208,Huxen,M,7,3279893,21231
21209,Huxleigh,F,7,3279900,21498
21210,Iaan,M,7,3279907,21485
21211,Iara,F,7,3279914,21624
21212,Ibaad,M,7,3279921,21409
21213,Iceland,F,7,3279928,21458
21214,Idania,F,7,3279935,21461
21215,Idrissa,M,7,3279942,21914
21216,Ifeanyichukwu,M,7,3279949,21861
21217,Ifechukwu,M,7,3279956,21659
21218,Ifrah,F,7,3279963,21214
21219,Iggy,M,7,3279970,21478
21220,Ihla,F,7,3279977,21226
21221,Ikal,M,7,3279984,21525
21222,Ilayah,F,7,3279991,21651
21223,Ilee,F,7,3279998,21843
21224,Illyanna,F,7,3280005,21882
21225,Illyria,F,7,3280012,21500
21226,Imana,F,7,3280019,21789
21227,Imronbek,M,7,3280026,21967
21228,Inaki,M,7,3280033,21601
21229,Indiyah,F,7,3280040,21320
21230,Inmer,M,7,3280047,21130
21231,Ioane,M,7,3280054,21869
21232,Iosefa,M,7,3280061,21056
21233,Irelia,F,7,3280068,21100
21234,Irmias,M,7,3280075,21115
21235,Isabellarose,F,7,3280082,21048
21236,Isack,M,7,3280089,21035
21237,Isan,M,7,3280096,21502
21238,Iskander,M,7,3280103,21279
21239,Islee,F,7,3280110,21024
21240,Isobelle,F,7,3280117,21691
21241,Issaiah,M,7,3280124,21470
21242,Italo,M,7,3280131,21537
21243,Itzayani,F,7,3280138,21576
21244,Ivalee,F,7,3280145,21157
21245,Ivann,M,7,3280152,21487
21246,Ivanshi,F,7,3280159,21292
21247,Iyanuoluwa,F,7,3280166,21569
21248,Iyra,F,7,3280173,21772
21249,Izac,M,7,3280180,21819
21250,Izack,M,7,3280187,21209
21251,Izaeah,M,7,3280194,21009
21252,Izara,F,7,3280201,21630
21253,Izayiah,M,7,3280208,21595
21254,Izic,M,7,3280215,21088
21255,Jaan,M,7,3280222,21281
21256,Jacere,M,7,3280229,21581
21257,Jachai,M,7,3280236,21384
21258,Jacobs,M,7,3280243,21859
21259,Jacorian,M,7,3280250,21159
21260,Jadence,F,7,3280257,21127
21261,Jadiah,M,7,3280264,21511
21262,Jadrian,M,7,3280271,21813
21263,Jadynn,F,7,3280278,21829
21264,Jaeshawn,M,7,3280285,21614
21265,Jago,M,7,3280292,21602
21266,Jahad,M,7,3280299,21116
21267,Jahaven,M,7,3280306,21923
21268,Jahcari,M,7,3280313,21250
21269,Jahcere,M,7,3280320,21253
21270,Jahdai,M,7,3280327,21702
21271,Jahdari,M,7,3280334,21079
21272,Jahid,M,7,3280341,21164
21273,Jahmai,M,7,3280348,21120
21274,Jahmar,M,7,3280355,21163
21275,Jahmarion,M,7,3280362,21084
21276,Jahri,M,7,3280369,21133
21277,Jahvier,M,7,3280376,21751
21278,Jaiceion,M,7,3280383,21265
21279,Jaidel,M,7,3280390,21554
21280,Jaidence,F,7,3280397,21350
21281,Jaier,M,7,3280404,21553
21282,Jaileigh,F,7,3280411,21920
21283,Jakaidyn,M,7,3280418,21408
21284,Jakara,F,7,3280425,21609
21285,Jakarter,M,7,3280432,21062
21286,Jakiah,F,7,3280439,21182
21287,Jakoda,M,7,3280446,21075
21288,Jalaina,F,7,3280453,21385
21289,Jalana,F,7,3280460,21329
21290,Jalanni,F,7,3280467,21805
21291,Jalasia,F,7,3280474,21636
21292,Jaleeyah,F,7,3280481,21322
21293,Jalex,M,7,3280488,21169
21294,Jalexa,F,7,3280495,21368
21295,Jali,F,7,3280502,21720
21296,Jalise,F,7,3280509,21310
21297,Jalonni,F,7,3280516,21290
21298,Jamai,M,7,3280523,21205
21299,Jamarrion,M,7,3280530,21517
21300,Jamelah,F,7,3280537,21705
21301,Jameslee,M,7,3280544,21232
21302,Jameya,F,7,3280551,21874
21303,Jamicah,M,7,3280558,21725
21304,Jamion,M,7,3280565,21206
21305,Jamond,M,7,3280572,21524
21306,Jamyson,M,7,3280579,21435
21307,Janaa,F,7,3280586,21984
21308,Janaia,F,7,3280593,21042
21309,Janaria,F,7,3280600,21837
21310,Janaye,F,7,3280607,21972
21311,Janee,F,7,3280614,21796
21312,Janetta,F,7,3280621,21937
21313,Janhvi,F,7,3280628,21777
21314,Janora,F,7,3280635,21418
21315,Janthony,M,7,3280642,21736
21316,Jaquavion,M,7,3280649,21622
21317,Jarelyn,F,7,3280656,21167
21318,Jaselynn,F,7,3280663,21854
21319,Jasi,M,7,3280670,21275
21320,Jasire,M,7,3280677,21790
21321,Jasiri,M,7,3280684,21192
21322,Jaspar,M,7,3280691,21039
21323,Jastin,M,7,3280698,21172
21324,Javaeh,F,7,3280705,21302
21325,Javani,M,7,3280712,21634
21326,Javante,M,7,3280719,21696
21327,Javed,M,7,3280726,21734
21328,Javianna,F,7,3280733,21629
21329,Javonn,M,7,3280740,21747
21330,Javonna,F,7,3280747,21387
21331,Javy,M,7,3280754,21397
21332,Javyn,M,7,3280761,21883
21333,Jawon,M,7,3280768,21427
21334,Jaxlyn,F,7,3280775,21125
21335,Jayanni,F,7,3280782,21757
21336,Jayansh,M,7,3280789,21330
21337,Jayd,F,7,3280796,21744
21338,Jaydence,M,7,3280803,21018
21339,Jayin,M,7,3280810,21840
21340,Jaylaa,F,7,3280817,21647
21341,Jayleah,F,7,3280824,21153
21342,Jaylean,F,7,3280831,21808
21343,Jaylenn,F,7,3280838,21162
21344,Jaymere,M,7,3280845,21512
21345,Jaymi,F,7,3280852,21109
21346,Jaymz,M,7,3280859,21107
21347,Jayniel,M,7,3280866,21976
21348,Jayona,F,7,3280873,21983
21349,Jaysion,M,7,3280880,21178
21350,Jayzon,M,7,3280887,21689
21351,Jazzelle,F,7,3280894,21356
21352,Jazziel,M,7,3280901,21237
21353,Jehan,M,7,3280908,21313
21354,Jeidy,F,7,3280915,21343
21355,Jemini,M,7,3280922,21490
21356,Jeniel,M,7,3280929,21282
21357,Jenise,F,7,3280936,21346
21358,Jenisha,F,7,3280943,21649
21359,Jennessy,F,7,3280950,21296
21360,Jentree,F,7,3280957,21552
21361,Jeptha,M,7,3280964,21179
21362,Jerell,M,7,3280971,21053
21363,Jermanii,F,7,3280978,21420
21364,Jermell,M,7,3280985,21549
21365,Jerrel,M,7,3280992,21570
21366,Jervon,M,7,3280999,21266
21367,Jesper,M,7,3281006,21426
21368,Jessabelle,F,7,3281013,21897
21369,Jeston,M,7,3281020,21183
21370,Jhacari,M,7,3281027,21353
21371,Jhakari,M,7,3281034,21118
21372,Jhani,F,7,3281041,21476
21373,Jhari,M,7,3281048,21443
21374,Jhoana,F,7,3281055,21674
21375,Jhonas,M,7,3281062,21703
21376,Jhostin,M,7,3281069,21827
21377,Jhovany,M,7,3281076,21802
21378,Jiho,M,7,3281083,21160
21379,Jilliana,F,7,3281090,21094
21380,Jimin,M,7,3281097,21982
21381,Jind,F,7,3281104,21951
21382,Jiovanna,F,7,3281111,21429
21383,Jiovanny,M,7,3281118,21938
21384,Jkai,M,7,3281125,21516
21385,Jla,F,7,3281132,21021
21386,Jmari,M,7,3281139,21655
21387,Jniyah,F,7,3281146,21939
21388,Jodee,F,7,3281153,21661
21389,Joden,M,7,3281160,21069
21390,Joelee,F,7,3281167,21464
21391,Joelis,F,7,3281174,21317
21392,Johnanthony,M,7,3281181,21735
21393,Johnmark,M,7,3281188,21274
21394,Jolani,F,7,3281195,21023
21395,Jolisa,F,7,3281202,21922
21396,Jonesy,M,7,3281209,21848
21397,Jonnathan,M,7,3281216,21572
21398,Jontae,M,7,3281223,21255
21399,Jontavious,M,7,3281230,21086
21400,Jorawar,M,7,3281237,21739
21401,Josecarlos,M,7,3281244,21332
21402,Josee,F,7,3281251,21994
21403,Josia,M,7,3281258,21305
21404,Josniel,M,7,3281265,21000
21405,Jossie,F,7,3281272,21111
21406,Journe,F,7,3281279,21264
21407,Journni,F,7,3281286,21259
21408,Journnie,F,7,3281293,21227
21409,Jovey,F,7,3281300,21973
21410,Jovia,F,7,3281307,21979
21411,Joyous,F,7,3281314,21723
21412,Jrae,M,7,3281321,21941
21413,Jsai,M,7,3281328,21699
21414,Jshaun,M,7,3281335,21841
21415,Jshawn,M,7,3281342,21687
21416,Juandavid,M,7,3281349,21850
21417,Judaea,F,7,3281356,21352
21418,Juli,F,7,3281363,21635
21419,Julina,F,7,3281370,21943
21420,Julyana,F,7,3281377,21342
21421,Jyair,M,7,3281384,21436
21422,Jymir,M,7,3281391,21096
21423,Jyrie,M,7,3281398,21996
21424,Kaarina,F,7,3281405,21547
21425,Kaceson,M,7,3281412,21221
21426,Kaceyon,M,7,3281419,21393
21427,Kader,M,7,3281426,21580
21428,Kadien,M,7,3281433,21085
21429,Kado,M,7,3281440,21249
21430,Kaeloni,F,7,3281447,21604
21431,Kahan,M,7,3281454,21974
21432,Kahel,M,7,3281461,21884
21433,Kahlanie,F,7,3281468,21312
21434,Kaihan,M,7,3281475,21355
21435,Kaijah,F,7,3281482,21457
21436,Kailand,M,7,3281489,21185
21437,Kailanie,F,7,3281496,21411
21438,Kailiana,F,7,3281503,21717
21439,Kailiyah,F,7,3281510,21557
21440,Kaiston,M,7,3281517,21087
21441,Kaiulani,F,7,3281524,21639
21442,Kaizleigh,F,7,3281531,21106
21443,Kaizlynn,F,7,3281538,21390
21444,Kalaina,F,7,3281545,21001
21445,Kalany,F,7,3281552,21733
21446,Kalasia,F,7,3281559,21907
21447,Kalayla,F,7,3281566,21987
21448,Kaleila,F,7,3281573,21600
21449,Kalex,M,7,3281580,21323
21450,Kallon,M,7,3281587,21906
21451,Kalonni,F,7,3281594,21204
21452,Kamaile,F,7,3281601,21365
21453,Kameel,M,7,3281608,21729
21454,Kamella,F,7,3281615,21054
21455,Kamonie,F,7,3281622,21650
21456,Kamorion,M,7,3281629,21413
21457,Kamuela,M,7,3281636,21080
21458,Kamyri,F,7,3281643,21657
21459,Kamyron,M,7,3281650,21795
21460,Kanaloa,M,7,3281657,21886
21461,Kanaya,F,7,3281664,21949
21462,Kaniyla,F,7,3281671,21136
21463,Kanyah,F,7,3281678,21103
21464,Kanye,M,7,3281685,21995
21465,Kaplan,M,7,3281692,21748
21466,Kardi,F,7,3281699,21782
21467,Karielys,F,7,3281706,21531
21468,Karine,F,7,3281713,21199
21469,Karinna,F,7,3281720,21876
21470,Karliyah,F,7,3281727,21514
21471,Karrie,F,7,3281734,21522
21472,Kartikeya,M,7,3281741,21707
21473,Karuna,F,7,3281748,21905
21474,Kasani,F,7,3281755,21211
21475,Kasch,M,7,3281762,21731
21476,Kasriel,M,7,3281769,21981
21477,Kassen,M,7,3281776,21663
21478,Kassey,F,7,3281783,21852
21479,Kassiah,F,7,3281790,21288
21480,Kastin,M,7,3281797,21361
21481,Kataliya,F,7,3281804,21061
21482,Kataryna,F,7,3281811,21391
21483,Kathir,M,7,3281818,21985
21484,Kathryne,F,7,3281825,21191
21485,Kattie,F,7,3281832,21277
21486,Kavani,M,7,3281839,21911
21487,Kavian,M,7,3281846,21962
21488,Kawan,M,7,3281853,21480
21489,Kawena,F,7,3281860,21472
21490,Kaydem,M,7,3281867,21198
21491,Kayelee,F,7,3281874,21430
21492,Kaylix,M,7,3281881,21286
21493,Kaymen,M,7,3281888,21750
21494,Kayna,F,7,3281895,21868
21495,Kaysleigh,F,7,3281902,21752
21496,Kaysten,M,7,3281909,21917
21497,Kaze,M,7,3281916,21268
21498,Kazen,M,7,3281923,21348
21499,Kazuma,M,7,3281930,21760
21500,Keab,M,7,3281937,21762
21501,Keagon,M,7,3281944,21026
21502,Kehlanni,F,7,3281951,21505
21503,Keilanie,F,7,3281958,21347
21504,Keimani,F,7,3281965,21766
21505,Keimari,M,7,3281972,21484
21506,Keiner,M,7,3281979,21445
21507,Keirah,F,7,3281986,21451
21508,Keiron,M,7,3281993,21308
21509,Keisuke,M,7,3282000,21477
21510,Kelhani,F,7,3282007,21577
21511,Kella,F,7,3282014,21708
21512,Kelsen,M,7,3282021,21648
21513,Kendo,M,7,3282028,21138
21514,Kendrea,F,7,3282035,21421
21515,Kenedy,F,7,3282042,21606
21516,Kenidee,F,7,3282049,21460
21517,Kenidi,F,7,3282056,21414
21518,Kenni,F,7,3282063,21582
21519,Kennya,F,7,3282070,21824
21520,Kenyah,F,7,3282077,21180
21521,Kerwin,M,7,3282084,21327
21522,Keshun,M,7,3282091,21337
21523,Kesia,F,7,3282098,21683
21524,Keslynn,F,7,3282105,21618
21525,Kethan,M,7,3282112,21567
21526,Keyarah,F,7,3282119,21297
21527,Keydi,F,7,3282126,21392
21528,Keymari,M,7,3282133,21716
21529,Keyonte,M,7,3282140,21545
21530,Keyston,M,7,3282147,21236
21531,Keza,F,7,3282154,21294
21532,Khadar,M,7,3282161,21217
21533,Khailee,F,7,3282168,21404
21534,Khaira,F,7,3282175,21971
21535,Khalees,F,7,3282182,21285
21536,Kham,M,7,3282189,21326
21537,Khamilla,F,7,3282196,21774
21538,Khamir,M,7,3282203,21028
21539,Khasen,M,7,3282210,21948
21540,Khiron,M,7,3282217,21853
21541,Khlani,F,7,3282224,21503
21542,Khleo,F,7,3282231,21593
21543,Khmari,M,7,3282238,21076
21544,Khya,F,7,3282245,21654
21545,Khyair,M,7,3282252,21230
21546,Khyden,M,7,3282259,21034
21547,Khyland,M,7,3282266,21610
21548,Kiante,M,7,3282273,21587
21549,Kiegan,M,7,3282280,21432
21550,Kiely,F,7,3282287,21267
21551,Kierre,M,7,3282294,21066
21552,Kijuan,M,7,3282301,21700
21553,Kimori,F,7,3282308,21181
21554,Kimoura,F,7,3282315,21528
21555,Kimyah,F,7,3282322,21784
21556,Kingstan,M,7,3282329,21235
21557,Kingzton,M,7,3282336,21818
21558,Kirana,F,7,3282343,21025
21559,Kireina,F,7,3282350,21815
21560,Kirkland,M,7,3282357,21124
21561,Kirubel,M,7,3282364,21918
21562,Kishawn,M,7,3282371,21855
21563,Kison,M,7,3282378,21776
21564,Kitty,F,7,3282385,21093
21565,Kiylah,F,7,3282392,21058
21566,Klahni,F,7,3282399,21668
21567,Kleio,F,7,3282406,21241
21568,Kmarion,M,7,3282413,21532
21569,Knoxley,M,7,3282420,21280
21570,Kohlston,M,7,3282427,21440
21571,Koleton,M,7,3282434,21845
21572,Konan,M,7,3282441,21594
21573,Konstantine,M,7,3282448,21099
21574,Korii,F,7,3282455,21726
21575,Korrina,F,7,3282462,21915
21576,Kouri,F,7,3282469,21002
21577,Kourtnee,F,7,3282476,21287
21578,Kovi,M,7,3282483,21389
21579,Kovu,M,7,3282490,21844
21580,Krishay,M,7,3282497,21686
21581,Kriva,F,7,3282504,21110
21582,Krizal,M,7,3282511,21556
21583,Krysten,F,7,3282518,21307
21584,Krystopher,M,7,3282525,21456
21585,Kudus,M,7,3282532,21345
21586,Kumar,M,7,3282539,21900
21587,Kuran,M,7,3282546,21623
21588,Kwan,M,7,3282553,21017
21589,Kweku,M,7,3282560,21278
21590,Kyelin,M,7,3282567,21803
21591,Kyelle,F,7,3282574,21804
21592,Kylaya,F,7,3282581,21738
21593,Kyliegh,F,7,3282588,21008
21594,Kylor,M,7,3282595,21202
21595,Kymeir,M,7,3282602,21469
21596,Kymorah,F,7,3282609,21504
21597,Kyndrick,M,7,3282616,21256
21598,Kynzee,F,7,3282623,21258
21599,Kyreece,M,7,3282630,21073
21600,Kyreem,M,7,3282637,21877
21601,Kyrei,M,7,3282644,21507
21602,Laakea,M,7,3282651,21273
21603,Lachelle,F,7,3282658,21770
21604,Ladonna,F,7,3282665,21586
21605,Lajuan,M,7,3282672,21491
21606,Laklynn,F,7,3282679,21081
21607,Laleh,F,7,3282686,21544
21608,Laloni,F,7,3282693,21891
21609,Lamayah,F,7,3282700,21331
21610,Lamontae,M,7,3282707,21105
21611,Lamyia,F,7,3282714,21446
21612,Lanayah,F,7,3282721,21910
21613,Landric,M,7,3282728,21793
21614,Landrick,M,7,3282735,21780
21615,Lannie,F,7,3282742,21360
21616,Lanyla,F,7,3282749,21978
21617,Lareyna,F,7,3282756,21681
21618,Larken,F,7,3282763,21184
21619,Lashawna,F,7,3282770,21658
21620,Lassana,M,7,3282777,21709
21621,Lauralynn,F,7,3282784,21775
21622,Laurin,F,7,3282791,21764
21623,Laurissa,F,7,3282798,21617
21624,Laverne,M,7,3282805,21684
21625,Layiah,F,7,3282812,21631
21626,Laykyn,F,7,3282819,21541
21627,Laylanee,F,7,3282826,21128
21628,Layney,F,7,3282833,21101
21629,Layonni,F,7,3282840,21304
21630,Leahrose,F,7,3282847,21283
21631,Leandrew,M,7,3282854,21444
21632,Leara,F,7,3282861,21834
21633,Leba,F,7,3282868,21893
21634,Leeandra,F,7,3282875,21399
21635,Leeson,M,7,3282882,21679
21636,Legen,M,7,3282889,21077
21637,Leiam,M,7,3282896,21754
21638,Leighlah,F,7,3282903,21439
21639,Leilan,M,7,3282910,21833
21640,Leilianna,F,7,3282917,21351
21641,Lenae,F,7,3282924,21114
21642,Lenaya,F,7,3282931,21510
21643,Leniya,F,7,3282938,21711
21644,Leniyah,F,7,3282945,21986
21645,Lenn,M,7,3282952,21119
21646,Leoh,M,7,3282959,21535
21647,Leonidus,M,7,3282966,21518
21648,Leonore,F,7,3282973,21632
21649,Leonte,M,7,3282980,21238
21650,Leonzo,M,7,3282987,21626
21651,Leovani,M,7,3282994,21953
21652,Lera,F,7,3283001,21475
21653,Lesieli,F,7,3283008,21090
21654,Leslye,F,7,3283015,21318
21655,Lesslie,F,7,3283022,21036
21656,Levana,F,7,3283029,21060
21657,Lexin,M,7,3283036,21139
21658,Lexon,M,7,3283043,21912
21659,Leyden,M,7,3283050,21207
21660,Liannah,F,7,3283057,21301
21661,Lida,F,7,3283064,21091
21662,Liham,M,7,3283071,21492
21663,Lilani,F,7,3283078,21188
21664,Lilas,F,7,3283085,21872
21665,Lilianah,F,7,3283092,21616
21666,Lilijana,F,7,3283099,21998
21667,Lillieann,F,7,3283106,21878
21668,Lilliona,F,7,3283113,21830
21669,Lilu,F,7,3283120,21471
21670,Lilybelle,F,7,3283127,21680
21671,Lilyonna,F,7,3283134,21082
21672,Linzy,F,7,3283141,21820
21673,Lisamarie,F,7,3283148,21887
21674,Lise,F,7,3283155,21240
21675,Liviah,F,7,3283162,21419
21676,Liyla,F,7,3283169,21244
21677,Llewelyn,M,7,3283176,21406
21678,Lochlen,M,7,3283183,21692
21679,Lochlin,M,7,3283190,21051
21680,Lockie,M,7,3283197,21640
21681,Locryn,M,7,3283204,21749
21682,Lohan,M,7,3283211,21064
21683,Loraina,F,7,3283218,21952
21684,Loreley,F,7,3283225,21765
21685,Lorne,M,7,3283232,21608
21686,Lory,F,7,3283239,21778
21687,Louay,M,7,3283246,21916
21688,Loudon,M,7,3283253,21229
21689,Louetta,F,7,3283260,21263
21690,Loula,F,7,3283267,21881
21691,Lovanna,F,7,3283274,21142
21692,Loxleigh,F,7,3283281,21653
21693,Luah,F,7,3283288,21901
21694,Lucario,M,7,3283295,21102
21695,Lucillia,F,7,3283302,21539
21696,Lucrezia,F,7,3283309,21030
21697,Lucymae,F,7,3283316,21131
21698,Lulabelle,F,7,3283323,21072
21699,Lumin,F,7,3283330,21540
21700,Lunara,F,7,3283337,21931
21701,Luqmaan,M,7,3283344,21879
21702,Lusine,F,7,3283351,21871
21703,Luxley,F,7,3283358,21894
21704,Luzia,F,7,3283365,21152
21705,Lylee,F,7,3283372,21745
21706,Lylianna,F,7,3283379,21942
21707,Lynae,F,7,3283386,21560
21708,Lynk,M,7,3283393,21261
21709,Lynken,M,7,3283400,21201
21710,Lynnae,F,7,3283407,21950
21711,Lynnie,F,7,3283414,21150
21712,Maanav,M,7,3283421,21662
21713,Macaiah,F,7,3283428,21011
21714,Macarius,M,7,3283435,21388
21715,Macgregor,M,7,3283442,21321
21716,Machiavelli,M,7,3283449,21394
21717,Maciah,M,7,3283456,21574
21718,Mackenize,F,7,3283463,21812
21719,Mackey,M,7,3283470,21908
21720,Mackie,F,7,3283477,21925
21721,Mackinnon,M,7,3283484,21970
21722,Maclain,M,7,3283491,21059
21723,Maclyn,F,7,3283498,21349
21724,Macson,M,7,3283505,21216
21725,Madinah,F,7,3283512,21933
21726,Madolyn,F,7,3283519,21763
21727,Madonna,F,7,3283526,21992
21728,Maeci,F,7,3283533,21239
21729,Maecy,F,7,3283540,21049
21730,Maelea,F,7,3283547,21822
21731,Maella,F,7,3283554,21373
21732,Maggi,F,7,3283561,21866
21733,Magizhini,F,7,3283568,21499
21734,Mahadev,M,7,3283575,21857
21735,Mahamadou,M,7,3283582,21497
21736,Mahani,F,7,3283589,21722
21737,Mahia,F,7,3283596,21688
21738,Mahitha,F,7,3283603,21605
21739,Mahiya,F,7,3283610,21234
21740,Mahlaya,F,7,3283617,21311
21741,Mailah,F,7,3283624,21899
21742,Majorie,F,7,3283631,21710
21743,Mak,M,7,3283638,21761
21744,Makael,M,7,3283645,21527
21745,Makailyn,F,7,3283652,21257
21746,Makaiyah,F,7,3283659,21016
21747,Makario,M,7,3283666,21037
21748,Makenleigh,F,7,3283673,21714
21749,Makensie,F,7,3283680,21788
21750,Makhia,F,7,3283687,21823
21751,Makinleigh,F,7,3283694,21590
21752,Makylie,F,7,3283701,21354
21753,Mal,M,7,3283708,21126
21754,Mala,F,7,3283715,21135
21755,Malaikah,F,7,3283722,21977
21756,Malarie,F,7,3283729,21675
21757,Malayjah,F,7,3283736,21638
21758,Maleaha,F,7,3283743,21070
21759,Maleeha,F,7,3283750,21913
21760,Malie,F,7,3283757,21599
21761,Malyia,F,7,3283764,21895
21762,Mane,F,7,3283771,21779
21763,Mansi,F,7,3283778,21137
21764,Mansoor,M,7,3283785,21149
21765,Manvir,M,7,3283792,21924
21766,Manzi,M,7,3283799,21940
21767,Maor,M,7,3283806,21715
21768,Maralyn,F,7,3283813,21521
21769,Marcanthony,M,7,3283820,21465
21770,Marcellis,M,7,3283827,21566
21771,Marchello,M,7,3283834,21165
21772,Marcoantonio,M,7,3283841,21783
21773,Marelin,F,7,3283848,21403
21774,Margery,F,7,3283855,21334
21775,Marialuiza,F,7,3283862,21386
21776,Mariann,F,7,3283869,21452
21777,Marieclaire,F,7,3283876,21732
21778,Marielis,F,7,3283883,21831
21779,Marilin,F,7,3283890,21800
21780,Marivel,F,7,3283897,21934
21781,Mariyana,F,7,3283904,21044
21782,Marlay,F,7,3283911,21129
21783,Marlyne,F,7,3283918,21928
21784,Marquay,M,7,3283925,21190
21785,Marsean,M,7,3283932,21027
21786,Martyna,F,7,3283939,21768
21787,Marwaan,M,7,3283946,21902
21788,Marwin,M,7,3283953,21578
21789,Marx,M,7,3283960,21083
21790,Marzell,M,7,3283967,21449
21791,Masah,F,7,3283974,21038
21792,Masir,M,7,3283981,21932
21793,Massiel,F,7,3283988,21730
21794,Matais,M,7,3283995,21794
21795,Mateusz,M,7,3284002,21728
21796,Matrim,M,7,3284009,21712
21797,Mattalyn,F,7,3284016,21991
21798,Matthews,M,7,3284023,21383
21799,Mauri,M,7,3284030,21078
21800,Maxie,F,7,3284037,21801
21801,Maxlynn,F,7,3284044,21438
21802,Maxtin,M,7,3284051,21930
21803,Maxxton,M,7,3284058,21963
21804,Maxxwell,M,7,3284065,21664
21805,Mayana,F,7,3284072,21839
21806,Mayara,F,7,3284079,21558
21807,Mayline,F,7,3284086,21377
21808,Mayme,F,7,3284093,21412
21809,Mazelee,F,7,3284100,21926
21810,Mazilynn,F,7,3284107,21526
21811,Mckade,M,7,3284114,21597
21812,Mckinnon,M,7,3284121,21644
21813,Mclean,M,7,3284128,21246
21814,Mechelle,F,7,3284135,21718
21815,Medhansh,M,7,3284142,21299
21816,Meeko,M,7,3284149,21589
21817,Meerab,F,7,3284156,21697
21818,Meerah,F,7,3284163,21333
21819,Meghana,F,7,3284170,21222
21820,Mehmed,M,7,3284177,21816
21821,Meiko,M,7,3284184,21295
21822,Meilin,F,7,3284191,21798
21823,Meily,F,7,3284198,21254
21824,Meleana,F,7,3284205,21195
21825,Meleny,F,7,3284212,21956
21826,Melinah,F,7,3284219,21646
21827,Mellanie,F,7,3284226,21613
21828,Melvina,F,7,3284233,21513
21829,Meraki,F,7,3284240,21176
21830,Meric,M,7,3284247,21200
21831,Meridith,F,7,3284254,21685
21832,Meritt,F,7,3284261,21463
21833,Mery,F,7,3284268,21846
21834,Meryam,F,7,3284275,21519
21835,Mete,M,7,3284282,21573
21836,Michail,M,7,3284289,21536
21837,Midna,F,7,3284296,21132
21838,Miella,F,7,3284303,21372
21839,Miera,F,7,3284310,21450
21840,Miette,F,7,3284317,21821
21841,Mija,F,7,3284324,21875
21842,Mikasa,F,7,3284331,21643
21843,Mikele,M,7,3284338,21156
21844,Mikhaela,F,7,3284345,21568
21845,Mikyng,M,7,3284352,21147
21846,Mileidy,F,7,3284359,21960
21847,Milen,M,7,3284366,21046
21848,Mileya,F,7,3284373,21140
21849,Mileydi,F,7,3284380,21806
21850,Miliyah,F,7,3284387,21098
21851,Miraan,M,7,3284394,21289
21852,Mireyah,F,7,3284401,21538
21853,Mishel,F,7,3284408,21212
21854,Mitzy,F,7,3284415,21341
21855,Miyla,F,7,3284422,21656
21856,Mohamedali,M,7,3284429,21633
21857,Molina,F,7,3284436,21561
21858,Montay,M,7,3284443,21422
21859,Montell,M,7,3284450,21945
21860,Montrel,M,7,3284457,21375
21861,Moria,F,7,3284464,21842
21862,Moroni,M,7,3284471,21357
21863,Moyinoluwa,F,7,3284478,21989
21864,Muhammadibrahim,M,7,3284485,21031
21865,Mujahid,M,7,3284492,21338
21866,Mumin,M,7,3284499,21786
21867,Mumina,F,7,3284506,21704
21868,Munachimso,F,7,3284513,21366
21869,Muntas,F,7,3284520,21325
21870,Muntasir,M,7,3284527,21050
21871,Murdoc,M,7,3284534,21003
21872,Murdock,M,7,3284541,21836
21873,Murphee,F,7,3284548,21428
21874,Muse,M,7,3284555,21724
21875,Myahna,F,7,3284562,21364
21876,Mychal,M,7,3284569,21040
21877,Mykie,F,7,3284576,21546
21878,Mylaya,F,7,3284583,21407
21879,Mylayah,F,7,3284590,21029
21880,Mylove,F,7,3284597,21781
21881,Mystery,F,7,3284604,21340
21882,Naaya,F,7,3284611,21143
21883,Naba,F,7,3284618,21858
21884,Nabeeha,F,7,3284625,21271
21885,Nacari,F,7,3284632,21588
21886,Naftula,M,7,3284639,21187
21887,Naheim,M,7,3284646,21248
21888,Nai,F,7,3284653,21860
21889,Naida,F,7,3284660,21999
21890,Naielle,F,7,3284667,21186
21891,Najib,M,7,3284674,21520
21892,Nakita,F,7,3284681,21690
21893,Nakoda,M,7,3284688,21701
21894,Nalaiya,F,7,3284695,21867
21895,Namaya,F,7,3284702,21260
21896,Nameer,M,7,3284709,21033
21897,Nanaakua,F,7,3284716,21571
21898,Narayah,F,7,3284723,21123
21899,Nashira,F,7,3284730,21665
21900,Nastasia,F,7,3284737,21873
21901,Nathanel,M,7,3284744,21509
21902,Nathon,M,7,3284751,21929
21903,Nathyn,M,7,3284758,21676
21904,Natia,F,7,3284765,21371
21905,Natti,F,7,3284772,21193
21906,Nausicaa,F,7,3284779,21997
21907,Naviyah,F,7,3284786,21019
21908,Nayari,F,7,3284793,21670
21909,Nayden,M,7,3284800,21228
21910,Nayella,F,7,3284807,21767
21911,Nayib,M,7,3284814,21494
21912,Naziah,F,7,3284821,21515
21913,Nazira,F,7,3284828,21043
21914,Nebula,F,7,3284835,21367
21915,Nehemia,M,7,3284842,21425
21916,Nehemie,F,7,3284849,21376
21917,Neli,F,7,3284856,21032
21918,Nephi,M,7,3284863,21270
21919,Nereida,F,7,3284870,21486
21920,Nevena,F,7,3284877,21966
21921,Neveyah,F,7,3284884,21170
21922,Nhyira,F,7,3284891,21642
21923,Nicasio,M,7,3284898,21052
21924,Nicoli,M,7,3284905,21592
21925,Nicte,F,7,3284912,21405
21926,Niema,F,7,3284919,21210
21927,Niilo,M,7,3284926,21362
21928,Nikash,M,7,3284933,21903
21929,Nikka,F,7,3284940,21459
21930,Nimo,F,7,3284947,21856
21931,Ninfa,F,7,3284954,21442
21932,Nio,M,7,3284961,21550
21933,Niobe,F,7,3284968,21395
21934,Niraj,M,7,3284975,21758
21935,Nirvair,M,7,3284982,21645
21936,Nishant,M,7,3284989,21583
21937,Nisreen,F,7,3284996,21434
21938,Nissim,M,7,3285003,21489
21939,Noahalexander,M,7,3285010,21695
21940,Noela,F,7,3285017,21004
21941,Nohealani,F,7,3285024,21291
21942,Nolynn,F,7,3285031,21880
21943,Nomar,M,7,3285038,21166
21944,Nooh,M,7,3285045,21529
21945,Noorah,F,7,3285052,21363
21946,Noree,F,7,3285059,21022
21947,Normandy,F,7,3285066,21455
21948,Norvina,F,7,3285073,21467
21949,Noureen,F,7,3285080,21787
21950,Nuna,F,7,3285087,21245
21951,Nunzio,M,7,3285094,21196
21952,Nurah,F,7,3285101,21671
21953,Nyanna,F,7,3285108,21612
21954,Nyeema,F,7,3285115,21673
21955,Nylayah,F,7,3285122,21315
21956,Nyomii,F,7,3285129,21637
21957,Nyrie,F,7,3285136,21474
21958,Nyrobi,F,7,3285143,21898
21959,Nyyear,M,7,3285150,21743
21960,Oakli,F,7,3285157,21935
21961,Obrian,M,7,3285164,21400
21962,Obrien,M,7,3285171,21620
21963,Ociel,M,7,3285178,21968
21964,Octayvia,F,7,3285185,21272
21965,Odesza,F,7,3285192,21896
21966,Ohaji,M,7,3285199,21964
21967,Olawale,M,7,3285206,21506
21968,Olesia,F,7,3285213,21224
21969,Olli,M,7,3285220,21067
21970,Oluwadabira,F,7,3285227,21627
21971,Oluwaferanmi,M,7,3285234,21565
21972,Oluwafikayomi,F,7,3285241,21423
21973,Oluwakemi,F,7,3285248,21936
21974,Oluwanifemi,M,7,3285255,21694
21975,Oluwaseun,M,7,3285262,21904
21976,Oluwatimilehin,M,7,3285269,21563
21977,Oluwatosin,M,7,3285276,21862
21978,Omera,F,7,3285283,21148
21979,Omi,M,7,3285290,21755
21980,Omina,F,7,3285297,21012
21981,Omolola,F,7,3285304,21134
21982,Onesty,F,7,3285311,21533
21983,Onir,M,7,3285318,21223
21984,Onyekachi,M,7,3285325,21359
21985,Oracle,F,7,3285332,21672
21986,Oria,F,7,3285339,21358
21987,Orie,M,7,3285346,21015
21988,Osric,M,7,3285353,21145
21989,Otillia,F,7,3285360,21619
21990,Otniel,M,7,3285367,21068
21991,Ovidio,M,7,3285374,21121
21992,Oviya,F,7,3285381,21382
21993,Owens,M,7,3285388,21607
21994,Owin,M,7,3285395,21849
21995,Oxford,M,7,3285402,21431
21996,Ozmar,M,7,3285409,21741
21997,Paarth,M,7,3285416,21737
21998,Paighten,F,7,3285423,21955
21999,Paisyn,F,7,3285430,21161
22000,Paizlynn,F,7,3285437,22752
22001,Panayiotis,M,7,3285444,22594
22002,Pape,M,7,3285451,22673
22003,Parisha,F,7,3285458,22384
22004,Parkerjames,M,7,3285465,22161
22005,Parv,M,7,3285472,22412
22006,Parx,M,7,3285479,22010
22007,Paschal,M,7,3285486,22188
22008,Paulie,M,7,3285493,22557
22009,Paxley,F,7,3285500,22622
22010,Peightyn,F,7,3285507,22448
22011,Penelopee,F,7,3285514,22628
22012,Perez,M,7,3285521,22227
22013,Pesach,M,7,3285528,22704
22014,Peytyn,F,7,3285535,22556
22015,Pharah,F,7,3285542,22940
22016,Pharoh,M,7,3285549,22488
22017,Phinley,M,7,3285556,22365
22018,Phoibe,F,7,3285563,22729
22019,Pike,M,7,3285570,22399
22020,Piotr,M,7,3285577,22978
22021,Pippin,M,7,3285584,22213
22022,Poppie,F,7,3285591,22501
22023,Praisley,F,7,3285598,22156
22024,Pravya,F,7,3285605,22336
22025,Preslyn,F,7,3285612,22919
22026,Prestin,M,7,3285619,22621
22027,Pretty,F,7,3285626,22997
22028,Prinsha,F,7,3285633,22099
22029,Prisma,F,7,3285640,22111
22030,Priyana,F,7,3285647,22302
22031,Promyce,F,7,3285654,22434
22032,Prue,F,7,3285661,22048
22033,Quadarius,M,7,3285668,22648
22034,Quamaine,M,7,3285675,22419
22035,Quamari,M,7,3285682,22219
22036,Quaniyah,F,7,3285689,22941
22037,Quinleigh,F,7,3285696,22657
22038,Quinnlynn,F,7,3285703,22041
22039,Quora,F,7,3285710,22984
22040,Raahil,M,7,3285717,22640
22041,Raahim,M,7,3285724,22769
22042,Racer,M,7,3285731,22698
22043,Radwa,F,7,3285738,22961
22044,Raeah,F,7,3285745,22899
22045,Raeli,F,7,3285752,22416
22046,Rafeal,M,7,3285759,22671
22047,Rage,M,7,3285766,22017
22048,Rahlee,F,7,3285773,22495
22049,Rahm,M,7,3285780,22242
22050,Rahul,M,7,3285787,22794
22051,Raihana,F,7,3285794,22288
22052,Raima,F,7,3285801,22244
22053,Raivyn,F,7,3285808,22208
22054,Raiza,F,7,3285815,22106
22055,Rakai,M,7,3285822,22761
22056,Ralo,M,7,3285829,22484
22057,Rameses,M,7,3285836,22960
22058,Ramiya,F,7,3285843,22772
22059,Ramsi,F,7,3285850,22165
22060,Ramsie,F,7,3285857,22966
22061,Raoul,M,7,3285864,22252
22062,Ras,M,7,3285871,22232
22063,Rasheeda,F,7,3285878,22008
22064,Rateel,F,7,3285885,22166
22065,Raunak,M,7,3285892,22299
22066,Rawson,M,7,3285899,22774
22067,Raycen,M,7,3285906,22479
22068,Raychel,F,7,3285913,22712
22069,Raydyn,M,7,3285920,22158
22070,Rayelynn,F,7,3285927,22767
22071,Rayley,F,7,3285934,22953
22072,Raylinn,F,7,3285941,22620
22073,Raylynne,F,7,3285948,22576
22074,Razia,F,7,3285955,22570
22075,Reah,F,7,3285962,22253
22076,Real,M,7,3285969,22291
22077,Realynn,F,7,3285976,22942
22078,Reddick,M,7,3285983,22135
22079,Reghan,F,7,3285990,22471
22080,Reginal,M,7,3285997,22118
22081,Relic,M,7,3286004,22402
22082,Rella,F,7,3286011,22436
22083,Remee,F,7,3286018,22194
22084,Remo,M,7,3286025,22959
22085,Renea,F,7,3286032,22548
22086,Revie,F,7,3286039,22956
22087,Rexx,M,7,3286046,22574
22088,Reyana,F,7,3286053,22784
22089,Reyla,F,7,3286060,22432
22090,Rhaelynn,F,7,3286067,22770
22091,Rhettley,M,7,3286074,22685
22092,Rhilyn,F,7,3286081,22003
22093,Rhonan,M,7,3286088,22731
22094,Rhonin,M,7,3286095,22049
22095,Rhyah,F,7,3286102,22861
22096,Rhylin,M,7,3286109,22639
22097,Rielly,F,7,3286116,22218
22098,Riham,F,7,3286123,22561
22099,Rika,F,7,3286130,22760
22100,Rileyann,F,7,3286137,22454
22101,Rilla,F,7,3286144,22815
22102,Rilynne,F,7,3286151,22196
22103,Rissa,F,7,3286158,22235
22104,Rithanya,F,7,3286165,22854
22105,Riyaq,F,7,3286172,22360
22106,Riyon,M,7,3286179,22133
22107,Riziki,F,7,3286186,22799
22108,Rmani,F,7,3286193,22606
22109,Ro,F,7,3286200,22460
22110,Roa,F,7,3286207,22663
22111,Robbyn,F,7,3286214,22190
22112,Roberth,M,7,3286221,22470
22113,Robertson,M,7,3286228,22968
22114,Robiya,F,7,3286235,22674
22115,Robson,M,7,3286242,22706
22116,Rockie,F,7,3286249,22728
22117,Roddy,M,7,3286256,22366
22118,Rody,M,7,3286263,22172
22119,Romain,M,7,3286270,22889
22120,Romey,F,7,3286277,22580
22121,Ronel,M,7,3286284,22115
22122,Roniyah,F,7,3286291,22022
22123,Ronja,F,7,3286298,22184
22124,Ronyn,M,7,3286305,22348
22125,Rorey,F,7,3286312,22123
22126,Rorick,M,7,3286319,22037
22127,Rosco,M,7,3286326,22046
22128,Rosealie,F,7,3286333,22199
22129,Roseann,F,7,3286340,22428
22130,Roseleen,F,7,3286347,22649
22131,Rosette,F,7,3286354,22490
22132,Rosilee,F,7,3286361,22573
22133,Roxann,F,7,3286368,22724
22134,Roxette,F,7,3286375,22517
22135,Royalle,F,7,3286382,22494
22136,Royston,M,7,3286389,22710
22137,Roze,F,7,3286396,22087
22138,Rozella,F,7,3286403,22067
22139,Rozelyn,F,7,3286410,22506
22140,Rudolf,M,7,3286417,22740
22141,Rueger,M,7,3286424,22669
22142,Rukaya,F,7,3286431,22558
22143,Rus,F,7,3286438,22391
22144,Rushika,F,7,3286445,22173
22145,Rushton,M,7,3286452,22002
22146,Russo,M,7,3286459,22897
22147,Rydell,M,7,3286466,22589
22148,Ryelan,M,7,3286473,22526
22149,Ryerson,M,7,3286480,22913
22150,Ryheem,M,7,3286487,22064
22151,Ryian,F,7,3286494,22024
22152,Ryin,F,7,3286501,22060
22153,Ryka,F,7,3286508,22933
22154,Ryleighann,F,7,3286515,22840
22155,Rylenn,F,7,3286522,22326
22156,Rylnn,F,7,3286529,22555
22157,Rylynne,F,7,3286536,22990
22158,Saadia,F,7,3286543,22609
22159,Saarth,M,7,3286550,22958
22160,Sabela,F,7,3286557,22952
22161,Sabriel,F,7,3286564,22662
22162,Sabrinna,F,7,3286571,22167
22163,Sacred,F,7,3286578,22754
22164,Sadaf,F,7,3286585,22277
22165,Sadiemae,F,7,3286592,22886
22166,Sadiyah,F,7,3286599,22878
22167,Saelah,F,7,3286606,22138
22168,Safeer,M,7,3286613,22251
22169,Safi,F,7,3286620,22713
22170,Safiatou,F,7,3286627,22980
22171,Safir,M,7,3286634,22262
22172,Saheim,M,7,3286641,22687
22173,Saila,F,7,3286648,22923
22174,Sajjad,M,7,3286655,22852
22175,Saketh,M,7,3286662,22707
22176,Sal,M,7,3286669,22189
22177,Salene,F,7,3286676,22652
22178,Saliah,F,7,3286683,22230
22179,Salif,M,7,3286690,22078
22180,Salmaan,M,7,3286697,22279
22181,Samaa,F,7,3286704,22948
22182,Samer,M,7,3286711,22587
22183,Samier,M,7,3286718,22781
22184,Samiksha,F,7,3286725,22636
22185,Samil,M,7,3286732,22435
22186,Samiullah,M,7,3286739,22939
22187,Samori,M,7,3286746,22816
22188,Samyia,F,7,3286753,22335
22189,Sang,M,7,3286760,22327
22190,Sanii,F,7,3286767,22836
22191,Sankalp,M,7,3286774,22733
22192,Sanna,F,7,3286781,22611
22193,Sanyla,F,7,3286788,22463
22194,Sanylah,F,7,3286795,22312
22195,Sarahjane,F,7,3286802,22077
22196,Saraih,F,7,3286809,22383
22197,Sariel,M,7,3286816,22134
22198,Sarika,F,7,3286823,22237
22199,Sarit,F,7,3286830,22091
22200,Saturn,F,7,3286837,22160
22201,Savannahrose,F,7,3286844,22267
22202,Saviah,F,7,3286851,22110
22203,Saviour,M,7,3286858,22105
22204,Savva,M,7,3286865,22226
22205,Sayana,F,7,3286872,22920
22206,Sayeed,M,7,3286879,22370
22207,Sekanii,M,7,3286886,22318
22208,Selam,F,7,3286893,22610
22209,Selen,F,7,3286900,22566
22210,Seleny,F,7,3286907,22122
22211,Selihom,F,7,3286914,22285
22212,Senai,F,7,3286921,22180
22213,Senay,M,7,3286928,22307
22214,Seras,F,7,3286935,22144
22215,Seva,F,7,3286942,22462
22216,Seynabou,F,7,3286949,22949
22217,Shaarav,M,7,3286956,22162
22218,Shady,M,7,3286963,22908
22219,Shah,M,7,3286970,22400
22220,Shailene,F,7,3286977,22169
22221,Shalayah,F,7,3286984,22254
22222,Sharanya,F,7,3286991,22786
22223,Sharla,F,7,3286998,22904
22224,Sharlette,F,7,3287005,22314
22225,Shazia,F,7,3287012,22730
22226,Shelia,F,7,3287019,22732
22227,Sherilyn,F,7,3287026,22480
22228,Shiffy,F,7,3287033,22827
22229,Shiphrah,F,7,3287040,22018
22230,Shirin,F,7,3287047,22727
22231,Shivin,M,7,3287054,22945
22232,Shoma,M,7,3287061,22472
22233,Shota,M,7,3287068,22967
22234,Shresta,F,7,3287075,22771
22235,Shterna,F,7,3287082,22592
22236,Shyam,M,7,3287089,22371
22237,Shylo,F,7,3287096,22009
22238,Sibel,F,7,3287103,22888
22239,Siddiq,M,7,3287110,22239
22240,Simrah,F,7,3287117,22340
22241,Sirat,F,7,3287124,22627
22242,Sirprince,M,7,3287131,22686
22243,Sithara,F,7,3287138,22140
22244,Sivansh,M,7,3287145,22791
22245,Siyaan,M,7,3287152,22286
22246,Siyan,M,7,3287159,22812
22247,Skilyn,F,7,3287166,22929
22248,Skilynn,F,7,3287173,22924
22249,Skip,M,7,3287180,22446
22250,Skylei,F,7,3287187,22425
22251,Smera,F,7,3287194,22811
22252,Snyder,M,7,3287201,22070
22253,Sobhan,M,7,3287208,22541
22254,Sofian,M,7,3287215,22437
22255,Sofiana,F,7,3287222,22080
22256,Sofya,F,7,3287229,22344
22257,Sohail,M,7,3287236,22068
22258,Sojourner,F,7,3287243,22120
22259,Sole,F,7,3287250,22623
22260,Soli,F,7,3287257,22881
22261,Solome,F,7,3287264,22530
22262,Solymar,F,7,3287271,22907
22263,Soma,M,7,3287278,22865
22264,Somer,F,7,3287285,22154
22265,Soniyah,F,7,3287292,22413
22266,Sophiana,F,7,3287299,22951
22267,Sophy,F,7,3287306,22186
22268,Sorcha,F,7,3287313,22053
22269,Soryn,F,7,3287320,22294
22270,Sosa,M,7,3287327,22788
22271,Spence,M,7,3287334,22062
22272,Stacia,F,7,3287341,22255
22273,Stanford,M,7,3287348,22975
22274,Stanislaw,M,7,3287355,22394
22275,Starlett,F,7,3287362,22766
22276,Steffany,F,7,3287369,22896
22277,Steffon,M,7,3287376,22328
22278,Stela,F,7,3287383,22895
22279,Stevin,M,7,3287390,22521
22280,Stevon,M,7,3287397,22475
22281,Stoni,F,7,3287404,22665
22282,Sublime,F,7,3287411,22249
22283,Sufian,M,7,3287418,22474
22284,Sufyaan,M,7,3287425,22596
22285,Suhaan,M,7,3287432,22753
22286,Suheily,F,7,3287439,22631
22287,Sukhman,F,7,3287446,22069
22288,Sulamita,F,7,3287453,22073
22289,Suly,F,7,3287460,22155
22290,Sumayo,F,7,3287467,22089
22291,Sumedha,F,7,3287474,22096
22292,Sumi,F,7,3287481,22675
22293,Summerlynn,F,7,3287488,22643
22294,Sunaina,F,7,3287495,22132
22295,Sunset,F,7,3287502,22536
22296,Sunshyne,F,7,3287509,22578
22297,Sureya,F,7,3287516,22441
22298,Suriyah,F,7,3287523,22033
22299,Susy,F,7,3287530,22651
22300,Suyog,M,7,3287537,22543
22301,Suzannah,F,7,3287544,22104
22302,Svara,F,7,3287551,22100
22303,Svojas,M,7,3287558,22969
22304,Swade,M,7,3287565,22147
22305,Sway,M,7,3287572,22503
22306,Syd,M,7,3287579,22423
22307,Sye,M,7,3287586,22650
22308,Syir,M,7,3287593,22074
22309,Syla,F,7,3287600,22268
22310,Syles,M,7,3287607,22741
22311,Symiah,F,7,3287614,22971
22312,Symphoni,F,7,3287621,22618
22313,Synnove,F,7,3287628,22745
22314,Syrai,F,7,3287635,22265
22315,Syven,F,7,3287642,22681
22316,Tadeusz,M,7,3287649,22832
22317,Tae,M,7,3287656,22962
22318,Taeden,M,7,3287663,22498
22319,Tag,M,7,3287670,22813
22320,Taige,F,7,3287677,22902
22321,Tailor,F,7,3287684,22266
22322,Taimoor,M,7,3287691,22841
22323,Taison,M,7,3287698,22625
22324,Taiven,M,7,3287705,22719
22325,Takshvi,F,7,3287712,22303
22326,Tal,M,7,3287719,22486
22327,Talea,F,7,3287726,22744
22328,Talion,M,7,3287733,22522
22329,Talita,F,7,3287740,22319
22330,Tallia,F,7,3287747,22583
22331,Tallis,M,7,3287754,22330
22332,Talus,M,7,3287761,22837
22333,Tamer,M,7,3287768,22534
22334,Tanairy,F,7,3287775,22529
22335,Taniah,F,7,3287782,22406
22336,Tannon,M,7,3287789,22211
22337,Taquan,M,7,3287796,22387
22338,Taro,M,7,3287803,22052
22339,Tasnia,F,7,3287810,22848
22340,Tavonte,M,7,3287817,22338
22341,Tawan,M,7,3287824,22478
22342,Tayanna,F,7,3287831,22977
22343,Taygan,F,7,3287838,22822
22344,Tayzlee,F,7,3287845,22863
22345,Tedrick,M,7,3287852,22197
22346,Teeghan,F,7,3287859,22717
22347,Tehillah,F,7,3287866,22851
22348,Tekla,F,7,3287873,22909
22349,Teliyah,F,7,3287880,22800
22350,Telvin,M,7,3287887,22430
22351,Temidayo,M,7,3287894,22928
22352,Tennley,F,7,3287901,22442
22353,Teofilo,M,7,3287908,22849
22354,Teonna,F,7,3287915,22932
22355,Tereza,F,7,3287922,22593
22356,Teriyah,F,7,3287929,22860
22357,Terrez,M,7,3287936,22217
22358,Terriah,F,7,3287943,22063
22359,Terrian,M,7,3287950,22626
22360,Tesa,F,7,3287957,22117
22361,Tessie,F,7,3287964,22818
22362,Tevon,M,7,3287971,22858
22363,Tevyn,M,7,3287978,22658
22364,Teyona,F,7,3287985,22759
22365,Tha,M,7,3287992,22395
22366,Thackery,M,7,3287999,22308
22367,Thailah,F,7,3288006,22176
22368,Thanh,M,7,3288013,22670
22369,Tharon,M,7,3288020,22515
22370,Tharun,M,7,3288027,22378
22371,Theda,F,7,3288034,22445
22372,Theodoro,M,7,3288041,22996
22373,Thera,F,7,3288048,22695
22374,Thyra,F,7,3288055,22995
22375,Tiannah,F,7,3288062,22833
22376,Tiarah,F,7,3288069,22931
22377,Tiarra,F,7,3288076,22107
22378,Timon,M,7,3288083,22421
22379,Tiras,M,7,3288090,22468
22380,Tison,M,7,3288097,22466
22381,Tokyo,F,7,3288104,22692
22382,Toleen,F,7,3288111,22129
22383,Toma,M,7,3288118,22835
22384,Tonantzin,F,7,3288125,22875
22385,Tonia,F,7,3288132,22525
22386,Tracie,F,7,3288139,22584
22387,Tracker,M,7,3288146,22539
22388,Traven,M,7,3288153,22925
22389,Traycen,M,7,3288160,22025
22390,Trayon,M,7,3288167,22455
22391,Treniyah,F,7,3288174,22004
22392,Trequan,M,7,3288181,22142
22393,Treva,F,7,3288188,22705
22394,Trevell,M,7,3288195,22482
22395,Trevelle,M,7,3288202,22736
22396,Triss,F,7,3288209,22755
22397,Tristain,M,7,3288216,22821
22398,Tron,M,7,3288223,22040
22399,Trygve,M,7,3288230,22577
22400,Turki,M,7,3288237,22001
22401,Tyking,M,7,3288244,22128
22402,Tymari,M,7,3288251,22153
22403,Tyme,F,7,3288258,22868
22404,Tymier,M,7,3288265,22682
22405,Tyrah,F,7,3288272,22245
22406,Tyreon,M,7,3288279,22322
22407,Tyric,M,7,3288286,22389
22408,Tyris,M,7,3288293,22891
22409,Ugochukwu,M,7,3288300,22257
22410,Uilliam,M,7,3288307,22572
22411,Umarjon,M,7,3288314,22807
22412,Umme,F,7,3288321,22438
22413,Umu,F,7,3288328,22571
22414,Utah,M,7,3288335,22885
22415,Vaayu,M,7,3288342,22510
22416,Vahan,M,7,3288349,22797
22417,Vaia,F,7,3288356,22353
22418,Vala,F,7,3288363,22524
22419,Valiant,M,7,3288370,22783
22420,Valiyah,F,7,3288377,22882
22421,Vallon,M,7,3288384,22646
22422,Varick,M,7,3288391,22447
22423,Varro,M,7,3288398,22659
22424,Vashawn,M,7,3288405,22879
22425,Vasilios,M,7,3288412,22893
22426,Vasily,M,7,3288419,22317
22427,Vasti,F,7,3288426,22072
22428,Vedan,M,7,3288433,22444
22429,Venelope,F,7,3288440,22467
22430,Verse,M,7,3288447,22615
22431,Vicenta,F,7,3288454,22677
22432,Victoire,F,7,3288461,22431
22433,Victoriano,M,7,3288468,22149
22434,Vidhur,M,7,3288475,22440
22435,Vidur,M,7,3288482,22876
22436,Vidushi,F,7,3288489,22324
22437,Vinisha,F,7,3288496,22215
22438,Viren,M,7,3288503,22465
22439,Virgilio,M,7,3288510,22957
22440,Vishruth,M,7,3288517,22405
22441,Vishwak,M,7,3288524,22934
22442,Vitalia,F,7,3288531,22407
22443,Vivin,M,7,3288538,22023
22444,Wagner,M,7,3288545,22721
22445,Wakely,F,7,3288552,22785
22446,Waverlee,F,7,3288559,22193
22447,Waverleigh,F,7,3288566,22599
22448,Wendall,M,7,3288573,22079
22449,Weylan,M,7,3288580,22974
22450,Willoh,F,7,3288587,22680
22451,Willowmae,F,7,3288594,22280
22452,Winson,M,7,3288601,22007
22453,Winterrose,F,7,3288608,22702
22454,Wirth,M,7,3288615,22305
22455,Wonder,F,7,3288622,22081
22456,Woody,M,7,3288629,22803
22457,Wrylee,F,7,3288636,22743
22458,Wylden,M,7,3288643,22507
22459,Xadiel,M,7,3288650,22892
22460,Xahlia,F,7,3288657,22751
22461,Xaidyn,M,7,3288664,22820
22462,Xaila,F,7,3288671,22898
22463,Xaniyah,F,7,3288678,22508
22464,Xaviera,F,7,3288685,22559
22465,Xavius,M,7,3288692,22097
22466,Xinyu,F,7,3288699,22450
22467,Xinyue,F,7,3288706,22373
22468,Xuan,F,7,3288713,22151
22469,Xxavier,M,7,3288720,22131
22470,Xyan,M,7,3288727,22700
22471,Xylon,M,7,3288734,22453
22472,Yacine,M,7,3288741,22900
22473,Yadelin,F,7,3288748,22238
22474,Yadielis,F,7,3288755,22668
22475,Yaeli,F,7,3288762,22694
22476,Yahvi,F,7,3288769,22667
22477,Yalexa,F,7,3288776,22030
22478,Yamely,F,7,3288783,22660
22479,Yang,M,7,3288790,22635
22480,Yaniv,M,7,3288797,22298
22481,Yaniyah,F,7,3288804,22050
22482,Yaqeen,F,7,3288811,22492
22483,Yariah,F,7,3288818,22031
22484,Yashveer,M,7,3288825,22552
22485,Yasina,F,7,3288832,22938
22486,Yeab,M,7,3288839,22225
22487,Yenifer,F,7,3288846,22361
22488,Yennifer,F,7,3288853,22575
22489,Yeremi,M,7,3288860,22936
22490,Yifan,M,7,3288867,22206
22491,Yilin,F,7,3288874,22112
22492,Yittel,F,7,3288881,22976
22493,Yordin,M,7,3288888,22311
22494,Yosselyn,F,7,3288895,22520
22495,Ysela,F,7,3288902,22417
22496,Yulani,F,7,3288909,22979
22497,Yuliza,F,7,3288916,22547
22498,Yumiko,F,7,3288923,22780
22499,Yuriah,M,7,3288930,22691
22500,Yutong,F,7,3288937,22538
22501,Yuxin,F,7,3288944,22963
22502,Zaaliyah,F,7,3288951,22763
22503,Zacariah,M,7,3288958,22459
22504,Zadiel,M,7,3288965,22894
22505,Zaeda,F,7,3288972,22514
22506,Zafreen,F,7,3288979,22185
22507,Zahair,M,7,3288986,22857
22508,Zaharia,F,7,3288993,22403
22509,Zaheem,M,7,3289000,22814
22510,Zaiyden,M,7,3289007,22716
22511,Zakarii,M,7,3289014,22798
22512,Zakira,F,7,3289021,22333
22513,Zakkai,M,7,3289028,22352
22514,Zaley,F,7,3289035,22202
22515,Zalyn,M,7,3289042,22661
22516,Zamauri,M,7,3289049,22519
22517,Zameer,M,7,3289056,22126
22518,Zamire,M,7,3289063,22619
22519,Zamylah,F,7,3289070,22805
22520,Zandria,F,7,3289077,22071
22521,Zaniyla,F,7,3289084,22725
22522,Zanobia,F,7,3289091,22114
22523,Zanova,F,7,3289098,22699
22524,Zaryia,F,7,3289105,22182
22525,Zavi,M,7,3289112,22210
22526,Zaydah,F,7,3289119,22011
22527,Zayleah,F,7,3289126,22315
22528,Zayliana,F,7,3289133,22567
22529,Zayonna,F,7,3289140,22986
22530,Zekani,M,7,3289147,22381
22531,Zekari,M,7,3289154,22061
22532,Zeki,M,7,3289161,22171
22533,Zenya,F,7,3289168,22427
22534,Zephyrus,M,7,3289175,22374
22535,Zerek,M,7,3289182,22270
22536,Zerena,F,7,3289189,22275
22537,Zeruiah,F,7,3289196,22243
22538,Zeth,M,7,3289203,22375
22539,Zeven,M,7,3289210,22035
22540,Zevi,M,7,3289217,22850
22541,Zeyden,M,7,3289224,22016
22542,Zeyneb,F,7,3289231,22098
22543,Zhakai,M,7,3289238,22551
22544,Zianne,F,7,3289245,22337
22545,Zienna,F,7,3289252,22884
22546,Zigmund,M,7,3289259,22426
22547,Zillah,F,7,3289266,22369
22548,Zinovia,F,7,3289273,22029
22549,Zionn,M,7,3289280,22439
22550,Ziora,F,7,3289287,22309
22551,Ziqi,F,7,3289294,22918
22552,Zoellie,F,7,3289301,22509
22553,Zoelys,F,7,3289308,22954
22554,Zoran,M,7,3289315,22579
22555,Zorian,M,7,3289322,22124
22556,Zuha,F,7,3289329,22086
22557,Zuleima,F,7,3289336,22346
22558,Zyaan,M,7,3289343,22777
22559,Zyad,M,7,3289350,22540
22560,Zyann,F,7,3289357,22758
22561,Zyara,F,7,3289364,22127
22562,Zyiere,M,7,3289371,22083
22563,Zyleah,F,7,3289378,22817
22564,Zyleigh,F,7,3289385,22617
22565,Zylus,M,7,3289392,22983
22566,Aaban,M,6,3289398,22828
22567,Aabriella,F,6,3289404,22306
22568,Aadhan,M,6,3289410,22113
22569,Aadrika,F,6,3289416,22943
22570,Aafiyah,F,6,3289422,22874
22571,Aaliyahrose,F,6,3289428,22331
22572,Aaliyanna,F,6,3289434,22947
22573,Aalyah,F,6,3289440,22212
22574,Aamanee,F,6,3289446,22422
22575,Aamil,M,6,3289452,22351
22576,Aamora,F,6,3289458,22429
22577,Aaqib,M,6,3289464,22605
22578,Aaqil,M,6,3289470,22597
22579,Aaral,F,6,3289476,22102
22580,Aarib,M,6,3289482,22304
22581,Aarit,M,6,3289488,22281
22582,Aarshi,F,6,3289494,22032
22583,Aarvin,M,6,3289500,22869
22584,Aaryana,F,6,3289506,22502
22585,Aashirya,F,6,3289512,22801
22586,Aashriya,F,6,3289518,22143
22587,Aavan,M,6,3289524,22994
22588,Aavani,F,6,3289530,22386
22589,Aavir,M,6,3289536,22145
22590,Abass,M,6,3289542,22204
22591,Abba,M,6,3289548,22136
22592,Abbiegail,F,6,3289554,22293
22593,Abbygayle,F,6,3289560,22829
22594,Abduljabbar,M,6,3289566,22325
22595,Abdulmajeed,M,6,3289572,22922
22596,Abdulsalam,M,6,3289578,22504
22597,Abed,M,6,3289584,22491
22598,Abisola,F,6,3289590,22550
22599,Abou,M,6,3289596,22532
22600,Abri,F,6,3289602,22528
22601,Absalom,M,6,3289608,22101
22602,Abyan,M,6,3289614,22198
22603,Abygael,F,6,3289620,22109
22604,Abygale,F,6,3289626,22684
22605,Aceion,M,6,3289632,22762
22606,Acer,M,6,3289638,22355
22607,Acetyn,M,6,3289644,22200
22608,Achille,M,6,3289650,22853
22609,Acie,M,6,3289656,22179
22610,Adaira,F,6,3289662,22634
22611,Adajames,F,6,3289668,22493
22612,Adalaine,F,6,3289674,22542
22613,Adalid,M,6,3289680,22076
22614,Adalynd,F,6,3289686,22723
22615,Adanya,F,6,3289692,22341
22616,Adarian,M,6,3289698,22398
22617,Addiah,F,6,3289704,22116
22618,Addyline,F,6,3289710,22512
22619,Adecyn,F,6,3289716,22201
22620,Adekunle,M,6,3289722,22354
22621,Adelae,F,6,3289728,22603
22622,Adelais,F,6,3289734,22088
22623,Adelay,F,6,3289740,22456
22624,Adelayde,F,6,3289746,22809
22625,Adelind,F,6,3289752,22414
22626,Adelinne,F,6,3289758,22746
22627,Adeliza,F,6,3289764,22393
22628,Adelynna,F,6,3289770,22021
22629,Aderinsola,F,6,3289776,22630
22630,Adesewa,F,6,3289782,22795
22631,Adheesh,M,6,3289788,22982
22632,Adhrith,M,6,3289794,22015
22633,Adhvaith,M,6,3289800,22856
22634,Adiba,F,6,3289806,22701
22635,Adilen,F,6,3289812,22385
22636,Adinah,F,6,3289818,22093
22637,Adithri,F,6,3289824,22739
22638,Adiyat,M,6,3289830,22518
22639,Adlyn,F,6,3289836,22676
22640,Adoraim,M,6,3289842,22066
22641,Adrielys,F,6,3289848,22873
22642,Adrienna,F,6,3289854,22047
22643,Adrija,F,6,3289860,22241
22644,Adrit,M,6,3289866,22263
22645,Adriyan,M,6,3289872,22655
22646,Advitha,F,6,3289878,22773
22647,Ady,F,6,3289884,22697
22648,Aedyn,M,6,3289890,22802
22649,Aegis,M,6,3289896,22839
22650,Aeriella,F,6,3289902,22608
22651,Aesop,M,6,3289908,22735
22652,Aevin,M,6,3289914,22028
22653,Afaf,F,6,3289920,22178
22654,Afreen,F,6,3289926,22163
22655,Afsa,F,6,3289932,22233
22656,Afsheen,F,6,3289938,22261
22657,Agamvir,M,6,3289944,22568
22658,Ahkai,M,6,3289950,22672
22659,Ahlaam,F,6,3289956,22026
22660,Ahloni,F,6,3289962,22051
22661,Ahmi,F,6,3289968,22654
22662,Ahnesti,F,6,3289974,22247
22663,Ahni,F,6,3289980,22679
22664,Ahzaria,F,6,3289986,22349
22665,Ahzariah,F,6,3289992,22339
22666,Aia,F,6,3289998,22678
22667,Aiana,F,6,3290004,22641
22668,Aidelyn,F,6,3290010,22301
22669,Ailan,M,6,3290016,22844
22670,Ailanie,F,6,3290022,22644
22671,Aileana,F,6,3290028,22420
22672,Aileny,F,6,3290034,22259
22673,Ailia,F,6,3290040,22792
22674,Aimi,F,6,3290046,22146
22675,Aimy,F,6,3290052,22006
22676,Aire,F,6,3290058,22689
22677,Aires,M,6,3290064,22718
22678,Airlie,F,6,3290070,22999
22679,Aittana,F,6,3290076,22056
22680,Aiyan,M,6,3290082,22005
22681,Ajanae,F,6,3290088,22688
22682,Ajna,F,6,3290094,22782
22683,Akachi,M,6,3290100,22191
22684,Akali,F,6,3290106,22734
22685,Akanesi,F,6,3290112,22616
22686,Akara,F,6,3290118,22864
22687,Akaria,F,6,3290124,22664
22688,Akbar,M,6,3290130,22500
22689,Akeen,M,6,3290136,22613
22690,Akeno,M,6,3290142,22912
22691,Akhai,M,6,3290148,22779
22692,Akia,F,6,3290154,22013
22693,Akicita,M,6,3290160,22937
22694,Akiem,M,6,3290166,22972
22695,Akili,F,6,3290172,22164
22696,Akmal,M,6,3290178,22415
22697,Akon,F,6,3290184,22282
22698,Akua,F,6,3290190,22981
22699,Akya,F,6,3290196,22356
22700,Akyla,F,6,3290202,22614
22701,Alaisa,F,6,3290208,22624
22702,Alaiyna,F,6,3290214,22458
22703,Alaki,M,6,3290220,22000
22704,Alam,M,6,3290226,22065
22705,Alamin,M,6,3290232,22443
22706,Alandis,M,6,3290238,22825
22707,Alannis,F,6,3290244,22108
22708,Alante,M,6,3290250,22175
22709,Alby,M,6,3290256,22987
22710,Alcide,M,6,3290262,22411
22711,Aldana,F,6,3290268,22826
22712,Aldrich,M,6,3290274,22985
22713,Alealani,F,6,3290280,22483
22714,Alegacy,F,6,3290286,22870
22715,Aleira,F,6,3290292,22845
22716,Aleja,F,6,3290298,22094
22717,Alejandrina,F,6,3290304,22843
22718,Alekxander,M,6,3290310,22362
22719,Aleli,F,6,3290316,22256
22720,Alette,F,6,3290322,22992
22721,Alexiah,F,6,3290328,22222
22722,Aleysa,F,6,3290334,22693
22723,Alhassane,M,6,3290340,22059
22724,Aliaa,F,6,3290346,22271
22725,Alicianna,F,6,3290352,22604
22726,Alifa,F,6,3290358,22409
22727,Alikai,M,6,3290364,22313
22728,Alimae,F,6,3290370,22564
22729,Alisandra,F,6,3290376,22396
22730,Alisher,M,6,3290382,22224
22731,Alishka,F,6,3290388,22633
22732,Alisi,F,6,3290394,22292
22733,Aliyahna,F,6,3290400,22906
22734,Aliyha,F,6,3290406,22451
22735,Aliyna,F,6,3290412,22823
22736,Aliyyah,F,6,3290418,22187
22737,Alizey,F,6,3290424,22993
22738,Alle,F,6,3290430,22737
22739,Alliah,F,6,3290436,22234
22740,Aloniab,M,6,3290442,22998
22741,Alonnie,F,6,3290448,22310
22742,Alori,F,6,3290454,22535
22743,Alparslan,M,6,3290460,22810
22744,Alphonsus,M,6,3290466,22585
22745,Alshon,M,6,3290472,22549
22746,Alwyn,M,6,3290478,22862
22747,Alyaa,F,6,3290484,22914
22748,Alyamamah,F,6,3290490,22629
22749,Alzahra,F,6,3290496,22563
22750,Amahri,M,6,3290502,22258
22751,Amalea,F,6,3290508,22748
22752,Amanah,F,6,3290514,22231
22753,Amanat,F,6,3290520,22901
22754,Amancio,M,6,3290526,22379
22755,Amarian,M,6,3290532,22433
22756,Amarilis,F,6,3290538,22323
22757,Amariss,F,6,3290544,22988
22758,Amarr,M,6,3290550,22295
22759,Amarria,F,6,3290556,22601
22760,Amatullah,F,6,3290562,22703
22761,Amayalynn,F,6,3290568,22380
22762,Amayarose,F,6,3290574,22321
22763,Amazyn,F,6,3290580,22476
22764,Ambellina,F,6,3290586,22019
22765,Ambreen,F,6,3290592,22075
22766,Ambri,F,6,3290598,22103
22767,Ambriella,F,6,3290604,22600
22768,Amear,M,6,3290610,22590
22769,Amileah,F,6,3290616,22747
22770,Amiliah,F,6,3290622,22796
22771,Amilliyon,M,6,3290628,22991
22772,Amiraa,F,6,3290634,22085
22773,Amiree,F,6,3290640,22757
22774,Amiris,M,6,3290646,22240
22775,Amius,M,6,3290652,22709
22776,Amiyha,F,6,3290658,22944
22777,Amontae,M,6,3290664,22499
22778,Amryn,F,6,3290670,22787
22779,Amunra,M,6,3290676,22776
22780,Amylee,F,6,3290682,22523
22781,Amyna,F,6,3290688,22560
22782,Amyria,F,6,3290694,22214
22783,Anahia,F,6,3290700,22789
22784,Anahli,F,6,3290706,22272
22785,Anaiis,F,6,3290712,22045
22786,Anaiza,F,6,3290718,22824
22787,Analilia,F,6,3290724,22485
22788,Anania,M,6,3290730,22656
22789,Anar,M,6,3290736,22334
22790,Anareli,F,6,3290742,22229
22791,Anashe,F,6,3290748,22683
22792,Anastasya,F,6,3290754,22363
22793,Anavae,F,6,3290760,22248
22794,Anaveah,F,6,3290766,22544
22795,Anayelli,F,6,3290772,22666
22796,Anaysha,F,6,3290778,22195
22797,Ane,F,6,3290784,22168
22798,Anees,M,6,3290790,22139
22799,Aneesah,F,6,3290796,22537
22800,Anelis,F,6,3290802,22038
22801,Anelys,F,6,3290808,22756
22802,Anfisa,F,6,3290814,22749
22803,Angeleah,F,6,3290820,22562
22804,Angelette,F,6,3290826,22329
22805,Angelith,F,6,3290832,22290
22806,Angelos,M,6,3290838,22012
22807,Anmay,M,6,3290844,22831
22808,Annabellee,F,6,3290850,22588
22809,Annaelle,F,6,3290856,22461
22810,Annaka,F,6,3290862,22408
22811,Annaliz,F,6,3290868,22345
22812,Annalysse,F,6,3290874,22119
22813,Annamary,F,6,3290880,22612
22814,Annamay,F,6,3290886,22207
22815,Annaston,F,6,3290892,22058
22816,Anndrea,F,6,3290898,22738
22817,Anneka,F,6,3290904,22388
22818,Annel,F,6,3290910,22715
22819,Annelies,F,6,3290916,22082
22820,Annelisa,F,6,3290922,22055
22821,Annelle,F,6,3290928,22595
22822,Anniemae,F,6,3290934,22481
22823,Anniya,F,6,3290940,22602
22824,Annlee,F,6,3290946,22708
22825,Annya,F,6,3290952,22742
22826,Anoop,F,6,3290958,22793
22827,Ansar,M,6,3290964,22347
22828,Anselm,M,6,3290970,22044
22829,Anshu,F,6,3290976,22855
22830,Antionette,F,6,3290982,22368
22831,Antjuan,M,6,3290988,22469
22832,Antwone,M,6,3290994,22477
22833,Anush,M,6,3291000,22141
22834,Anzleigh,F,6,3291006,22910
22835,Anzley,F,6,3291012,22054
22836,Aowyn,F,6,3291018,22350
22837,Apolline,F,6,3291024,22527
22838,Aracelia,F,6,3291030,22276
22839,Aracelis,F,6,3291036,22607
22840,Arai,F,6,3291042,22531
22841,Araia,F,6,3291048,22489
22842,Aralia,F,6,3291054,22871
22843,Arayla,F,6,3291060,22847
22844,Arfan,M,6,3291066,22496
22845,Ariamarie,F,6,3291072,22505
22846,Arianys,F,6,3291078,22859
22847,Ariat,F,6,3291084,22397
22848,Arib,M,6,3291090,22390
22849,Arick,M,6,3291096,22150
22850,Ariea,F,6,3291102,22377
22851,Ariee,F,6,3291108,22554
22852,Arieonna,F,6,3291114,22220
22853,Arieyah,F,6,3291120,22367
22854,Arihant,M,6,3291126,22790
22855,Arinze,M,6,3291132,22690
22856,Arisleidy,F,6,3291138,22181
22857,Aritza,F,6,3291144,22358
22858,Ariyanah,F,6,3291150,22764
22859,Arjunram,M,6,3291156,22192
22860,Arlani,F,6,3291162,22401
22861,Arlon,M,6,3291168,22970
22862,Arly,F,6,3291174,22296
22863,Armana,F,6,3291180,22125
22864,Armeena,F,6,3291186,22546
22865,Armir,M,6,3291192,22989
22866,Armiya,F,6,3291198,22830
22867,Armonee,F,6,3291204,22452
22868,Armonn,M,6,3291210,22497
22869,Arnol,M,6,3291216,22404
22870,Aroosh,F,6,3291222,22511
22871,Arrington,M,6,3291228,22269
22872,Arsham,M,6,3291234,22250
22873,Arshia,F,6,3291240,22867
22874,Arshika,F,6,3291246,22516
22875,Artorias,M,6,3291252,22915
22876,Arvella,F,6,3291258,22714
22877,Aryanah,F,6,3291264,22883
22878,Aryon,M,6,3291270,22722
22879,Aryus,M,6,3291276,22159
22880,Asayah,M,6,3291282,22137
22881,Aseda,F,6,3291288,22935
22882,Aset,F,6,3291294,22645
22883,Ashan,M,6,3291300,22170
22884,Ashara,F,6,3291306,22565
22885,Ashaud,M,6,3291312,22343
22886,Ashaun,M,6,3291318,22157
22887,Asherah,F,6,3291324,22203
22888,Ashling,F,6,3291330,22034
22889,Ashlyne,F,6,3291336,22382
22890,Ashritha,F,6,3291342,22819
22891,Ashvath,M,6,3291348,22273
22892,Ashwaq,F,6,3291354,22647
22893,Asly,F,6,3291360,22221
22894,Assa,F,6,3291366,22598
22895,Atlan,M,6,3291372,22152
22896,Attica,F,6,3291378,22838
22897,Atum,M,6,3291384,22582
22898,Aubreana,F,6,3291390,22148
22899,Aubreeana,F,6,3291396,22946
22900,Aubreyana,F,6,3291402,22473
22901,Audrick,M,6,3291408,22637
22902,Augus,M,6,3291414,22216
22903,Augusten,M,6,3291420,22278
22904,Augustino,M,6,3291426,22274
22905,Aung,M,6,3291432,22720
22906,Aunika,F,6,3291438,22775
22907,Auralia,F,6,3291444,22917
22908,Aurelian,M,6,3291450,22424
22909,Aurore,F,6,3291456,22973
22910,Avabella,F,6,3291462,22209
22911,Avagail,F,6,3291468,22842
22912,Avalin,F,6,3291474,22316
22913,Avalyse,F,6,3291480,22591
22914,Avamaria,F,6,3291486,22711
22915,Avee,F,6,3291492,22487
22916,Avelardo,M,6,3291498,22036
22917,Avella,F,6,3291504,22955
22918,Avenlee,F,6,3291510,22911
22919,Averiana,F,6,3291516,22357
22920,Averiella,F,6,3291522,22372
22921,Averlie,F,6,3291528,22092
22922,Averlyn,F,6,3291534,22223
22923,Averyanna,F,6,3291540,22965
22924,Avey,F,6,3291546,22642
22925,Avilene,F,6,3291552,22364
22926,Avrey,F,6,3291558,22359
22927,Avyonna,F,6,3291564,22039
22928,Awais,M,6,3291570,22090
22929,Axelle,F,6,3291576,22846
22930,Ayak,F,6,3291582,22392
22931,Ayasha,F,6,3291588,22880
22932,Ayceon,M,6,3291594,22750
22933,Ayen,F,6,3291600,22332
22934,Ayiden,M,6,3291606,22553
22935,Aylanie,F,6,3291612,22174
22936,Aylanna,F,6,3291618,22513
22937,Ayleah,F,6,3291624,22905
22938,Ayliana,F,6,3291630,22834
22939,Aymee,F,6,3291636,22205
22940,Aynur,F,6,3291642,22020
22941,Ayon,M,6,3291648,22533
22942,Ayren,M,6,3291654,22457
22943,Ayres,M,6,3291660,22778
22944,Ayveri,F,6,3291666,22696
22945,Azadeh,F,6,3291672,22043
22946,Azaela,F,6,3291678,22877
22947,Azaiyah,F,6,3291684,22014
22948,Azaree,F,6,3291690,22916
22949,Azariel,M,6,3291696,22808
22950,Azaylee,F,6,3291702,22027
22951,Azayliah,F,6,3291708,22264
22952,Azen,M,6,3291714,22376
22953,Azira,F,6,3291720,22569
22954,Azka,F,6,3291726,22418
22955,Azmir,M,6,3291732,22057
22956,Azori,F,6,3291738,22964
22957,Azoria,F,6,3291744,22632
22958,Azyan,M,6,3291750,22236
22959,Azyria,F,6,3291756,22930
22960,Bailen,M,6,3291762,22581
22961,Baisley,F,6,3291768,22726
22962,Balam,M,6,3291774,22921
22963,Baley,F,6,3291780,22449
22964,Balsam,F,6,3291786,22320
22965,Baraah,F,6,3291792,22545
22966,Barclay,M,6,3291798,22765
22967,Barrick,M,6,3291804,22653
22968,Basheer,M,6,3291810,22464
22969,Basir,M,6,3291816,22289
22970,Beaudry,M,6,3291822,22287
22971,Beauman,M,6,3291828,22246
22972,Beautifull,F,6,3291834,22342
22973,Behati,F,6,3291840,22410
22974,Beily,F,6,3291846,22042
22975,Belkis,F,6,3291852,22887
22976,Bemnet,F,6,3291858,22768
22977,Benek,M,6,3291864,22297
22978,Benett,M,6,3291870,22121
22979,Benz,M,6,3291876,22806
22980,Berat,M,6,3291882,22872
22981,Berish,M,6,3291888,22903
22982,Bernardino,M,6,3291894,22284
22983,Bernell,M,6,3291900,22177
22984,Bernie,M,6,3291906,22183
22985,Berry,M,6,3291912,22084
22986,Beshoy,M,6,3291918,22130
22987,Betina,F,6,3291924,22890
22988,Bexli,F,6,3291930,22283
22989,Beyza,F,6,3291936,22638
22990,Bezaleel,M,6,3291942,22926
22991,Bhakti,F,6,3291948,22228
22992,Bhavika,F,6,3291954,22260
22993,Biak,F,6,3291960,22095
22994,Bianey,F,6,3291966,22927
22995,Bilguun,M,6,3291972,22950
22996,Binti,F,6,3291978,22804
22997,Birkley,F,6,3291984,22586
22998,Bishoy,M,6,3291990,22300
22999,Bivan,M,6,3291996,22866
23000,Bj,M,6,3292002,23719
23001,Blakelie,F,6,3292008,23644
23002,Blakesley,F,6,3292014,23686
23003,Blayson,M,6,3292020,23355
23004,Blessy,F,6,3292026,23451
23005,Bohen,M,6,3292032,23217
23006,Bolin,M,6,3292038,23586
23007,Bomani,M,6,3292044,23831
23008,Bonham,M,6,3292050,23459
23009,Bowdrie,M,6,3292056,23213
23010,Bracen,M,6,3292062,23670
23011,Braelie,F,6,3292068,23747
23012,Brannen,M,6,3292074,23170
23013,Braxlee,M,6,3292080,23108
23014,Brayner,M,6,3292086,23868
23015,Brayven,M,6,3292092,23253
23016,Breeanna,F,6,3292098,23685
23017,Breeleigh,F,6,3292104,23219
23018,Breelle,F,6,3292110,23029
23019,Brendalynn,F,6,3292116,23659
23020,Breven,M,6,3292122,23287
23021,Brexon,M,6,3292128,23578
23022,Breydan,M,6,3292134,23399
23023,Brianni,F,6,3292140,23257
23024,Briant,M,6,3292146,23365
23025,Bricia,F,6,3292152,23941
23026,Briela,F,6,3292158,23023
23027,Brigitta,F,6,3292164,23924
23028,Brilliant,F,6,3292170,23887
23029,Brinda,F,6,3292176,23117
23030,Brinlei,F,6,3292182,23436
23031,Brittain,M,6,3292188,23031
23032,Brittan,F,6,3292194,23125
23033,Brizeyda,F,6,3292200,23518
23034,Brodyn,M,6,3292206,23435
23035,Brookes,M,6,3292212,23954
23036,Brooklee,F,6,3292218,23755
23037,Brookston,M,6,3292224,23226
23038,Brookyln,F,6,3292230,23538
23039,Brucha,F,6,3292236,23532
23040,Brycelynn,F,6,3292242,23292
23041,Bryla,F,6,3292248,23876
23042,Bryland,M,6,3292254,23982
23043,Brylyn,F,6,3292260,23079
23044,Brynden,M,6,3292266,23019
23045,Brynja,F,6,3292272,23487
23046,Brysun,M,6,3292278,23033
23047,Bukhari,M,6,3292284,23443
23048,Burk,M,6,3292290,23582
23049,Burkley,F,6,3292296,23473
23050,Cacey,M,6,3292302,23241
23051,Cactus,M,6,3292308,23142
23052,Cadance,F,6,3292314,23203
23053,Cadi,F,6,3292320,23278
23054,Caedan,M,6,3292326,23299
23055,Caeleb,M,6,3292332,23296
23056,Caiah,F,6,3292338,23857
23057,Cairen,M,6,3292344,23861
23058,Caiyah,F,6,3292350,23672
23059,Caled,M,6,3292356,23733
23060,Caledonia,F,6,3292362,23507
23061,Calei,F,6,3292368,23671
23062,Calev,M,6,3292374,23391
23063,Calib,M,6,3292380,23602
23064,Calii,F,6,3292386,23846
23065,Caliph,M,6,3292392,23542
23066,Calley,F,6,3292398,23381
23067,Callisto,F,6,3292404,23206
23068,Calyse,F,6,3292410,23875
23069,Camani,F,6,3292416,23103
23070,Camar,M,6,3292422,23600
23071,Camarah,F,6,3292428,23045
23072,Camaron,M,6,3292434,23050
23073,Cambridge,F,6,3292440,23167
23074,Camillo,M,6,3292446,23485
23075,Canan,M,6,3292452,23324
23076,Candido,M,6,3292458,23800
23077,Capone,M,6,3292464,23681
23078,Capriana,F,6,3292470,23923
23079,Caragh,F,6,3292476,23283
23080,Caralynn,F,6,3292482,23774
23081,Caren,F,6,3292488,23973
23082,Cariana,F,6,3292494,23053
23083,Carmelia,F,6,3292500,23554
23084,Carra,F,6,3292506,23297
23085,Carrera,F,6,3292512,23356
23086,Carri,F,6,3292518,23735
23087,Cashe,M,6,3292524,23214
23088,Casmir,M,6,3292530,23245
23089,Caspin,M,6,3292536,23503
23090,Caster,M,6,3292542,23523
23091,Castyn,M,6,3292548,23064
23092,Caya,F,6,3292554,23036
23093,Caycen,M,6,3292560,23753
23094,Caydin,M,6,3292566,23322
23095,Cayetano,M,6,3292572,23146
23096,Ceci,F,6,3292578,23544
23097,Cecylia,F,6,3292584,23417
23098,Ceili,F,6,3292590,23566
23099,Celestial,F,6,3292596,23051
23100,Cersei,F,6,3292602,23637
23101,Ceylin,F,6,3292608,23537
23102,Chadrick,M,6,3292614,23330
23103,Chani,F,6,3292620,23736
23104,Chania,F,6,3292626,23155
23105,Channce,M,6,3292632,23128
23106,Channin,M,6,3292638,23909
23107,Chanze,M,6,3292644,23855
23108,Charish,F,6,3292650,23952
23109,Charleen,F,6,3292656,23233
23110,Chavelle,F,6,3292662,23236
23111,Chaviva,F,6,3292668,23304
23112,Chayden,M,6,3292674,23227
23113,Cheick,M,6,3292680,23500
23114,Chenxi,F,6,3292686,23054
23115,Cheyanna,F,6,3292692,23676
23116,Chibueze,M,6,3292698,23202
23117,Chibuikem,M,6,3292704,23263
23118,Chikamso,M,6,3292710,23418
23119,Chimaobi,M,6,3292716,23612
23120,Chinmay,M,6,3292722,23571
23121,Chinonso,M,6,3292728,23812
23122,Chlo,F,6,3292734,23313
23123,Chrishaun,M,6,3292740,23860
23124,Christiaan,M,6,3292746,23492
23125,Chrysanthemum,F,6,3292752,23985
23126,Chukwudi,M,6,3292758,23785
23127,Chyenne,F,6,3292764,23725
23128,Chyla,F,6,3292770,23608
23129,Chyler,F,6,3292776,23145
23130,Cilas,M,6,3292782,23352
23131,Cin,M,6,3292788,23803
23132,Cinch,M,6,3292794,23639
23133,Cintia,F,6,3292800,23662
23134,Cipriana,F,6,3292806,23775
23135,Citrine,F,6,3292812,23910
23136,Claritza,F,6,3292818,23476
23137,Classic,M,6,3292824,23651
23138,Clayden,M,6,3292830,23767
23139,Cletus,M,6,3292836,23781
23140,Clove,F,6,3292842,23455
23141,Coasten,M,6,3292848,23802
23142,Coi,M,6,3292854,23408
23143,Colbee,F,6,3292860,23805
23144,Colesen,M,6,3292866,23864
23145,Colibri,F,6,3292872,23332
23146,Collynn,F,6,3292878,23273
23147,Constantin,M,6,3292884,23808
23148,Constantina,F,6,3292890,23115
23149,Coralyne,F,6,3292896,23625
23150,Cordale,M,6,3292902,23181
23151,Cordaro,M,6,3292908,23059
23152,Coriyah,F,6,3292914,23298
23153,Corleigh,F,6,3292920,23020
23154,Cormelo,M,6,3292926,23184
23155,Corran,M,6,3292932,23784
23156,Corrigan,M,6,3292938,23894
23157,Corrin,M,6,3292944,23474
23158,Corrion,M,6,3292950,23896
23159,Cortes,M,6,3292956,23502
23160,Cortlynn,F,6,3292962,23328
23161,Crayton,M,6,3292968,23760
23162,Crisanto,M,6,3292974,23827
23163,Crisbel,F,6,3292980,23814
23164,Crislynn,F,6,3292986,23028
23165,Criss,M,6,3292992,23193
23166,Cristine,F,6,3292998,23068
23167,Cristyn,F,6,3293004,23828
23168,Crystel,F,6,3293010,23525
23169,Cullan,M,6,3293016,23669
23170,Curt,M,6,3293022,23716
23171,Curtiss,M,6,3293028,23837
23172,Cydnee,F,6,3293034,23511
23173,Cylee,F,6,3293040,23256
23174,Cylen,M,6,3293046,23978
23175,Cynniah,F,6,3293052,23132
23176,Cyon,M,6,3293058,23212
23177,Cyrene,F,6,3293064,23682
23178,Dacen,M,6,3293070,23777
23179,Dacia,F,6,3293076,23741
23180,Dacion,M,6,3293082,23237
23181,Daegen,M,6,3293088,23960
23182,Daelani,F,6,3293094,23318
23183,Daia,F,6,3293100,23209
23184,Daianna,F,6,3293106,23965
23185,Daiden,M,6,3293112,23705
23186,Daionna,F,6,3293118,23797
23187,Daison,M,6,3293124,23315
23188,Daiwik,M,6,3293130,23591
23189,Dakshith,M,6,3293136,23495
23190,Dal,M,6,3293142,23048
23191,Daloni,F,6,3293148,23917
23192,Dalten,M,6,3293154,23983
23193,Dalyza,F,6,3293160,23026
23194,Damacio,M,6,3293166,23063
23195,Daman,M,6,3293172,23545
23196,Damarii,M,6,3293178,23407
23197,Damarkus,M,6,3293184,23363
23198,Damarrion,M,6,3293190,23052
23199,Damayah,F,6,3293196,23007
23200,Damilare,M,6,3293202,23484
23201,Damilola,F,6,3293208,23653
23202,Damirah,F,6,3293214,23112
23203,Damyra,F,6,3293220,23379
23204,Danahi,F,6,3293226,23179
23205,Danari,F,6,3293232,23604
23206,Danessa,F,6,3293238,23116
23207,Danijah,F,6,3293244,23141
23208,Danilah,F,6,3293250,23221
23209,Danilee,F,6,3293256,23426
23210,Dannel,M,6,3293262,23430
23211,Danniella,F,6,3293268,23089
23212,Danyella,F,6,3293274,23576
23213,Dariany,F,6,3293280,23228
23214,Dariell,M,6,3293286,23679
23215,Dariely,F,6,3293292,23737
23216,Darrielle,F,6,3293298,23856
23217,Daryah,F,6,3293304,23123
23218,Daryanna,F,6,3293310,23912
23219,Dasai,M,6,3293316,23216
23220,Dasiah,M,6,3293322,23376
23221,Daton,M,6,3293328,23066
23222,Dauson,M,6,3293334,23551
23223,Davanee,F,6,3293340,23711
23224,Davani,F,6,3293346,23491
23225,Daveigh,F,6,3293352,23223
23226,Davilucca,M,6,3293358,23570
23227,Daviyon,M,6,3293364,23194
23228,Davonna,F,6,3293370,23961
23229,Davontay,M,6,3293376,23186
23230,Dawid,M,6,3293382,23903
23231,Dayja,F,6,3293388,23078
23232,Dayo,M,6,3293394,23772
23233,Deadrian,M,6,3293400,23555
23234,Deakyn,M,6,3293406,23691
23235,Deaunte,M,6,3293412,23920
23236,Deauri,F,6,3293418,23246
23237,Deava,F,6,3293424,23530
23238,Declin,M,6,3293430,23434
23239,Deethya,F,6,3293436,23968
23240,Deia,F,6,3293442,23127
23241,Dekarri,M,6,3293448,23712
23242,Delainy,F,6,3293454,23488
23243,Delayni,F,6,3293460,23977
23244,Delaysia,F,6,3293466,23496
23245,Delcie,F,6,3293472,23729
23246,Deliana,F,6,3293478,23342
23247,Dellarose,F,6,3293484,23626
23248,Delorian,M,6,3293490,23859
23249,Delsie,F,6,3293496,23848
23250,Delwin,M,6,3293502,23234
23251,Delysia,F,6,3293508,23771
23252,Demarian,M,6,3293514,23892
23253,Demarko,M,6,3293520,23897
23254,Demarrius,M,6,3293526,23943
23255,Demelza,F,6,3293532,23325
23256,Demetruis,M,6,3293538,23406
23257,Demiah,F,6,3293544,23017
23258,Demichael,M,6,3293550,23513
23259,Demid,M,6,3293556,23201
23260,Demon,M,6,3293562,23164
23261,Demorris,M,6,3293568,23306
23262,Denahi,M,6,3293574,23559
23263,Denarius,M,6,3293580,23058
23264,Denisha,F,6,3293586,23880
23265,Denzil,M,6,3293592,23229
23266,Deriel,M,6,3293598,23951
23267,Dermot,M,6,3293604,23022
23268,Derric,M,6,3293610,23700
23269,Derron,M,6,3293616,23308
23270,Deryk,M,6,3293622,23444
23271,Deserae,F,6,3293628,23807
23272,Deshan,M,6,3293634,23096
23273,Deslynn,F,6,3293640,23083
23274,Desmin,M,6,3293646,23752
23275,Destan,M,6,3293652,23849
23276,Destany,F,6,3293658,23497
23277,Destine,F,6,3293664,23898
23278,Dextin,M,6,3293670,23371
23279,Deyana,F,6,3293676,23619
23280,Dhani,M,6,3293682,23340
23281,Dhruti,F,6,3293688,23993
23282,Dhyaan,M,6,3293694,23289
23283,Diarra,F,6,3293700,23409
23284,Dilawar,M,6,3293706,23624
23285,Dimir,M,6,3293712,23534
23286,Diquan,M,6,3293718,23475
23287,Dira,F,6,3293724,23799
23288,Divyansh,M,6,3293730,23157
23289,Diyaa,F,6,3293736,23707
23290,Diyon,M,6,3293742,23980
23291,Djuan,M,6,3293748,23552
23292,Dlayah,F,6,3293754,23966
23293,Dlilah,F,6,3293760,23701
23294,Dmarcus,M,6,3293766,23383
23295,Dnylah,F,6,3293772,23717
23296,Domanick,M,6,3293778,23387
23297,Dominiq,M,6,3293784,23294
23298,Doniel,M,6,3293790,23667
23299,Donnovan,M,6,3293796,23300
23300,Dor,F,6,3293802,23486
23301,Dori,F,6,3293808,23768
23302,Dorion,M,6,3293814,23962
23303,Doron,M,6,3293820,23350
23304,Dot,F,6,3293826,23211
23305,Douglass,M,6,3293832,23520
23306,Dracen,M,6,3293838,23248
23307,Drayah,F,6,3293844,23745
23308,Draylon,M,6,3293850,23032
23309,Drayvin,M,6,3293856,23832
23310,Dreami,F,6,3293862,23607
23311,Drelynn,F,6,3293868,23642
23312,Drexler,M,6,3293874,23858
23313,Drexton,M,6,3293880,23508
23314,Drisha,F,6,3293886,23331
23315,Drishti,F,6,3293892,23288
23316,Drusilla,F,6,3293898,23906
23317,Dsean,M,6,3293904,23821
23318,Durham,M,6,3293910,23440
23319,Dvon,M,6,3293916,23945
23320,Dwain,M,6,3293922,23235
23321,Eadric,M,6,3293928,23969
23322,Eagle,M,6,3293934,23888
23323,Ebaad,M,6,3293940,23689
23324,Ecko,F,6,3293946,23168
23325,Eddiel,M,6,3293952,23995
23326,Edee,F,6,3293958,23776
23327,Edi,M,6,3293964,23577
23328,Edmon,M,6,3293970,23025
23329,Edwar,M,6,3293976,23997
23330,Eeshaan,M,6,3293982,23575
23331,Efosa,M,6,3293988,23872
23332,Efstathios,M,6,3293994,23424
23333,Egon,M,6,3294000,23042
23334,Ehitan,M,6,3294006,23327
23335,Eileigh,F,6,3294012,23842
23336,Eileithyia,F,6,3294018,23882
23337,Eithen,M,6,3294024,23267
23338,Ekko,F,6,3294030,23975
23339,Elaiza,F,6,3294036,23874
23340,Elba,F,6,3294042,23533
23341,Eldad,M,6,3294048,23974
23342,Eldric,M,6,3294054,23581
23343,Eleah,F,6,3294060,23035
23344,Elexis,F,6,3294066,23596
23345,Eliad,M,6,3294072,23224
23346,Eliantte,M,6,3294078,23933
23347,Elidi,F,6,3294084,23734
23348,Elidia,F,6,3294090,23798
23349,Eliena,F,6,3294096,23274
23350,Eliorah,F,6,3294102,23751
23351,Elios,M,6,3294108,23932
23352,Elisandra,F,6,3294114,23873
23353,Elisavet,F,6,3294120,23094
23354,Elisea,F,6,3294126,23075
23355,Elissia,F,6,3294132,23683
23356,Elixander,M,6,3294138,23780
23357,Eliz,F,6,3294144,23677
23358,Elizabethrose,F,6,3294150,23162
23359,Elizajane,F,6,3294156,23489
23360,Elizeo,M,6,3294162,23865
23361,Elleni,F,6,3294168,23588
23362,Ellenie,F,6,3294174,23703
23363,Ellian,M,6,3294180,23786
23364,Elliani,F,6,3294186,23343
23365,Elliya,F,6,3294192,23276
23366,Elliza,F,6,3294198,23360
23367,Ellysia,F,6,3294204,23151
23368,Elmina,F,6,3294210,23149
23369,Elnatan,M,6,3294216,23702
23370,Elonnie,F,6,3294222,23311
23371,Elvy,F,6,3294228,23464
23372,Elynna,F,6,3294234,23569
23373,Elysium,M,6,3294240,23939
23374,Emarius,M,6,3294246,23102
23375,Emarosa,F,6,3294252,23259
23376,Emberlin,F,6,3294258,23579
23377,Emberrose,F,6,3294264,23178
23378,Embyr,F,6,3294270,23438
23379,Emigdio,M,6,3294276,23770
23380,Emilina,F,6,3294282,23135
23381,Emiola,F,6,3294288,23504
23382,Emiri,F,6,3294294,23176
23383,Emmajoy,F,6,3294300,23709
23384,Emmaleah,F,6,3294306,23592
23385,Emmamae,F,6,3294312,23457
23386,Emmette,M,6,3294318,23333
23387,Emorii,F,6,3294324,23841
23388,Empriss,F,6,3294330,23928
23389,Emrah,M,6,3294336,23071
23390,Emris,M,6,3294342,23098
23391,En,M,6,3294348,23454
23392,Endsley,F,6,3294354,23147
23393,Enedina,F,6,3294360,23374
23394,Enlil,M,6,3294366,23345
23395,Enma,F,6,3294372,23421
23396,Eno,M,6,3294378,23013
23397,Enock,M,6,3294384,23750
23398,Enslie,F,6,3294390,23904
23399,Enson,M,6,3294396,23782
23400,Enyla,F,6,3294402,23543
23401,Eralynn,F,6,3294408,23991
23402,Eran,M,6,3294414,23169
23403,Erisha,F,6,3294420,23948
23404,Ermiyas,M,6,3294426,23082
23405,Ernestina,F,6,3294432,23190
23406,Ero,M,6,3294438,23349
23407,Erwan,M,6,3294444,23321
23408,Eryana,F,6,3294450,23916
23409,Erys,F,6,3294456,23505
23410,Eseosa,F,6,3294462,23825
23411,Esey,M,6,3294468,23715
23412,Eshika,F,6,3294474,23695
23413,Esley,F,6,3294480,23527
23414,Esmeray,F,6,3294486,23012
23415,Esosa,F,6,3294492,23314
23416,Essam,M,6,3294498,23617
23417,Estephania,F,6,3294504,23890
23418,Esti,F,6,3294510,23442
23419,Etan,M,6,3294516,23153
23420,Ethann,M,6,3294522,23829
23421,Ethin,M,6,3294528,23402
23422,Etzio,M,6,3294534,23645
23423,Eulalio,M,6,3294540,23643
23424,Eurydice,F,6,3294546,23678
23425,Eustace,M,6,3294552,23990
23426,Evaleen,F,6,3294558,23265
23427,Evalisse,F,6,3294564,23568
23428,Evanee,F,6,3294570,23936
23429,Evelio,M,6,3294576,23377
23430,Evelisse,F,6,3294582,23783
23431,Evens,M,6,3294588,23361
23432,Evon,F,6,3294594,23335
23433,Evora,F,6,3294600,23999
23434,Evrhett,M,6,3294606,23754
23435,Evyanna,F,6,3294612,23793
23436,Ewen,M,6,3294618,23134
23437,Eyas,M,6,3294624,23148
23438,Eyuel,M,6,3294630,23616
23439,Ezechiel,M,6,3294636,23197
23440,Ezrajames,M,6,3294642,23970
23441,Ezzie,F,6,3294648,23650
23442,Faaiz,M,6,3294654,23984
23443,Fabianna,F,6,3294660,23885
23444,Fadel,M,6,3294666,23565
23445,Fahim,M,6,3294672,23610
23446,Falak,F,6,3294678,23081
23447,Fareeha,F,6,3294684,23210
23448,Farhiya,F,6,3294690,23225
23449,Fatimatou,F,6,3294696,23640
23450,Fatimazahra,F,6,3294702,23173
23451,Fatoumatta,F,6,3294708,23047
23452,Faven,F,6,3294714,23195
23453,Faviola,F,6,3294720,23583
23454,Fawkes,M,6,3294726,23389
23455,Fawzia,F,6,3294732,23061
23456,Feather,F,6,3294738,23037
23457,Feiga,F,6,3294744,23528
23458,Feliciana,F,6,3294750,23251
23459,Felisha,F,6,3294756,23987
23460,Feride,F,6,3294762,23172
23461,Fernan,M,6,3294768,23615
23462,Ferrah,F,6,3294774,23521
23463,Ferryn,F,6,3294780,23804
23464,Fey,F,6,3294786,23794
23465,Feyre,F,6,3294792,23478
23466,Fianna,F,6,3294798,23358
23467,Fidencio,M,6,3294804,23118
23468,Finnlay,M,6,3294810,23284
23469,Finnly,M,6,3294816,23320
23470,Finton,M,6,3294822,23668
23471,Fiyinfoluwa,F,6,3294828,23558
23472,Frania,F,6,3294834,23305
23473,Franklynn,F,6,3294840,23126
23474,Frasier,M,6,3294846,23373
23475,Frayda,F,6,3294852,23329
23476,Freeda,F,6,3294858,23445
23477,Froylan,M,6,3294864,23046
23478,Furious,M,6,3294870,23400
23479,Fynnlee,F,6,3294876,23183
23480,Fynnley,M,6,3294882,23584
23481,Gabrial,M,6,3294888,23422
23482,Gabrian,M,6,3294894,23895
23483,Gabrien,M,6,3294900,23881
23484,Gabryelle,F,6,3294906,23244
23485,Gaella,F,6,3294912,23156
23486,Gamble,M,6,3294918,23185
23487,Garhett,M,6,3294924,23030
23488,Garin,M,6,3294930,23101
23489,Garison,M,6,3294936,23563
23490,Garnett,M,6,3294942,23811
23491,Gatlynn,F,6,3294948,23597
23492,Gea,F,6,3294954,23801
23493,Gedalia,M,6,3294960,23979
23494,Gena,F,6,3294966,23710
23495,Genesi,F,6,3294972,23483
23496,Geniyah,F,6,3294978,23590
23497,Genna,F,6,3294984,23839
23498,Genova,F,6,3294990,23309
23499,Gethsemane,F,6,3294996,23727
23500,Ghala,F,6,3295002,23878
23501,Giaan,M,6,3295008,23844
23502,Giam,M,6,3295014,23739
23503,Gianah,F,6,3295020,23613
23504,Gianelly,F,6,3295026,23490
23505,Giann,M,6,3295032,23744
23506,Giannie,F,6,3295038,23429
23507,Gilead,M,6,3295044,23901
23508,Gin,M,6,3295050,23660
23509,Ginebra,F,6,3295056,23574
23510,Ginette,F,6,3295062,23789
23511,Giomar,M,6,3295068,23471
23512,Gionnis,M,6,3295074,23697
23513,Gita,F,6,3295080,23275
23514,Gitel,F,6,3295086,23779
23515,Glori,F,6,3295092,23140
23516,God,M,6,3295098,23404
23517,Gracelen,F,6,3295104,23093
23518,Graceon,M,6,3295110,23927
23519,Gracilynn,F,6,3295116,23433
23520,Gracynn,F,6,3295122,23661
23521,Graden,M,6,3295128,23834
23522,Graisyn,M,6,3295134,23589
23523,Grantlee,M,6,3295140,23119
23524,Grayer,M,6,3295146,23396
23525,Grayston,M,6,3295152,23104
23526,Gregoria,F,6,3295158,23694
23527,Greicy,F,6,3295164,23853
23528,Grisel,F,6,3295170,23312
23529,Guiseppe,M,6,3295176,23351
23530,Gumaro,M,6,3295182,23634
23531,Gurasees,F,6,3295188,23450
23532,Gurjaap,M,6,3295194,23272
23533,Gurjas,M,6,3295200,23546
23534,Gurkirat,M,6,3295206,23998
23535,Gurnaz,F,6,3295212,23189
23536,Gurshan,M,6,3295218,23461
23537,Gwenavere,F,6,3295224,23809
23538,Gwenneth,F,6,3295230,23477
23539,Gwynneth,F,6,3295236,23922
23540,Habeeb,M,6,3295242,23268
23541,Haben,F,6,3295248,23222
23542,Hadlei,F,6,3295254,23453
23543,Haig,M,6,3295260,23958
23544,Haigen,M,6,3295266,23326
23545,Haik,M,6,3295272,23291
23546,Haile,M,6,3295278,23641
23547,Haize,M,6,3295284,23519
23548,Hajara,F,6,3295290,23161
23549,Hamadi,M,6,3295296,23218
23550,Hamida,F,6,3295302,23833
23551,Hamir,M,6,3295308,23410
23552,Hamsini,F,6,3295314,23953
23553,Hanaan,F,6,3295320,23815
23554,Hanadi,F,6,3295326,23258
23555,Hanako,F,6,3295332,23587
23556,Hanes,M,6,3295338,23465
23557,Hanny,F,6,3295344,23633
23558,Harel,M,6,3295350,23390
23559,Harison,M,6,3295356,23060
23560,Harkirat,F,6,3295362,23154
23561,Harleyrae,F,6,3295368,23271
23562,Harloe,F,6,3295374,23357
23563,Harmoniee,F,6,3295380,23431
23564,Harriette,F,6,3295386,23769
23565,Harsh,M,6,3295392,23388
23566,Harshita,F,6,3295398,23749
23567,Harshiv,M,6,3295404,23647
23568,Hartlyn,F,6,3295410,23255
23569,Hartwell,M,6,3295416,23899
23570,Haruka,F,6,3295422,23623
23571,Haseya,F,6,3295428,23940
23572,Hasini,F,6,3295434,23930
23573,Hasson,M,6,3295440,23614
23574,Hatley,F,6,3295446,23452
23575,Hattan,M,6,3295452,23657
23576,Hatti,F,6,3295458,23069
23577,Hawra,F,6,3295464,23919
23578,Haxton,M,6,3295470,23862
23579,Hayato,M,6,3295476,23622
23580,Hayston,M,6,3295482,23177
23581,Hayward,M,6,3295488,23001
23582,Haywood,M,6,3295494,23638
23583,Hayzley,F,6,3295500,23463
23584,Hayzlie,F,6,3295506,23609
23585,Hazal,F,6,3295512,23931
23586,Hazard,M,6,3295518,23010
23587,Hazlyn,F,6,3295524,23415
23588,Heartley,F,6,3295530,23286
23589,Heartlynn,F,6,3295536,23080
23590,Heavenli,F,6,3295542,23867
23591,Heavenn,F,6,3295548,23338
23592,Hebron,M,6,3295554,23628
23593,Hedaya,F,6,3295560,23796
23594,Hennah,F,6,3295566,23062
23595,Henya,F,6,3295572,23757
23596,Henzlee,F,6,3295578,23740
23597,Herminio,M,6,3295584,23743
23598,Herve,M,6,3295590,23611
23599,Heyab,F,6,3295596,23788
23600,Heyli,F,6,3295602,23649
23601,Hibo,F,6,3295608,23339
23602,Hiilani,F,6,3295614,23816
23603,Hiilei,F,6,3295620,23728
23604,Hikaru,M,6,3295626,23996
23605,Hilinai,F,6,3295632,23139
23606,Hixon,M,6,3295638,23372
23607,Hollyann,F,6,3295644,23467
23608,Holmes,M,6,3295650,23759
23609,Honestie,F,6,3295656,23130
23610,Hossam,M,6,3295662,23137
23611,Howell,M,6,3295668,23871
23612,Hughston,M,6,3295674,23441
23613,Humaid,M,6,3295680,23411
23614,Humphrey,M,6,3295686,23693
23615,Hurley,M,6,3295692,23039
23616,Huston,M,6,3295698,23238
23617,Hykeem,M,6,3295704,23393
23618,Iban,M,6,3295710,23107
23619,Ibhaan,M,6,3295716,23944
23620,Ibsa,M,6,3295722,23449
23621,Idabelle,F,6,3295728,23004
23622,Idalis,F,6,3295734,23382
23623,Idamae,F,6,3295740,23937
23624,Idman,F,6,3295746,23319
23625,Iga,F,6,3295752,23680
23626,Ignacia,F,6,3295758,23585
23627,Ignacy,M,6,3295764,23200
23628,Iklas,F,6,3295770,23057
23629,Ikran,F,6,3295776,23889
23630,Ilai,M,6,3295782,23621
23631,Ilerioluwa,F,6,3295788,23863
23632,Ilianis,F,6,3295794,23056
23633,Ilithyia,F,6,3295800,23462
23634,Iliya,F,6,3295806,23011
23635,Iliyana,F,6,3295812,23512
23636,Illidan,M,6,3295818,23847
23637,Imanol,M,6,3295824,23114
23638,Imela,F,6,3295830,23658
23639,Imisioluwa,F,6,3295836,23526
23640,Immaculee,F,6,3295842,23884
23641,Indiah,F,6,3295848,23603
23642,Inika,F,6,3295854,23239
23643,Innocence,F,6,3295860,23122
23644,Insiyah,F,6,3295866,23261
23645,Io,F,6,3295872,23043
23646,Irais,F,6,3295878,23826
23647,Ire,M,6,3295884,23482
23648,Irem,F,6,3295890,23111
23649,Irini,F,6,3295896,23006
23650,Isaack,M,6,3295902,23646
23651,Isabellah,F,6,3295908,23414
23652,Isatu,F,6,3295914,23260
23653,Isavella,F,6,3295920,23065
23654,Ishar,M,6,3295926,23971
23655,Ishi,F,6,3295932,23553
23656,Iskra,F,6,3295938,23021
23657,Islarose,F,6,3295944,23730
23658,Ismah,F,6,3295950,23843
23659,Itachi,M,6,3295956,23557
23660,Italie,F,6,3295962,23560
23661,Itati,F,6,3295968,23988
23662,Ivani,F,6,3295974,23690
23663,Ivis,M,6,3295980,23375
23664,Ivvy,F,6,3295986,23307
23665,Ivyn,M,6,3295992,23165
23666,Iwinosa,F,6,3295998,23458
23667,Iyanah,F,6,3296004,23131
23668,Iyari,F,6,3296010,23822
23669,Izetta,F,6,3296016,23663
23670,Izma,F,6,3296022,23403
23671,Izna,F,6,3296028,23629
23672,Izsak,M,6,3296034,23310
23673,Izzabell,F,6,3296040,23113
23674,Jaala,F,6,3296046,23902
23675,Jaanai,F,6,3296052,23498
23676,Jabbar,M,6,3296058,23138
23677,Jabree,M,6,3296064,23981
23678,Jacaden,M,6,3296070,23665
23679,Jacir,M,6,3296076,23264
23680,Jaco,M,6,3296082,23900
23681,Jacobson,M,6,3296088,23572
23682,Jadaya,F,6,3296094,23664
23683,Jader,M,6,3296100,23763
23684,Jadeyn,F,6,3296106,23303
23685,Jadin,M,6,3296112,23187
23686,Jaeli,F,6,3296118,23963
23687,Jaelon,M,6,3296124,23174
23688,Jaelyne,F,6,3296130,23913
23689,Jaguar,M,6,3296136,23539
23690,Jahair,M,6,3296142,23044
23691,Jahaire,M,6,3296148,23008
23692,Jaheir,M,6,3296154,23456
23693,Jahlayah,F,6,3296160,23073
23694,Jahmani,M,6,3296166,23392
23695,Jahmiah,M,6,3296172,23003
23696,Jahmil,M,6,3296178,23447
23697,Jahmya,F,6,3296184,23368
23698,Jahsier,M,6,3296190,23869
23699,Jaiaire,M,6,3296196,23136
23700,Jaicey,F,6,3296202,23567
23701,Jaidalyn,F,6,3296208,23386
23702,Jailiana,F,6,3296214,23385
23703,Jailon,M,6,3296220,23674
23704,Jaira,F,6,3296226,23354
23705,Jaishaun,M,6,3296232,23279
23706,Jaishon,M,6,3296238,23479
23707,Jaisley,F,6,3296244,23262
23708,Jakaila,F,6,3296250,23024
23709,Jakalyn,F,6,3296256,23000
23710,Jakarie,M,6,3296262,23334
23711,Jakaya,F,6,3296268,23370
23712,Jakaylee,F,6,3296274,23698
23713,Jakhel,M,6,3296280,23302
23714,Jakk,M,6,3296286,23935
23715,Jaklynn,F,6,3296292,23836
23716,Jakylan,M,6,3296298,23344
23717,Jalahni,F,6,3296304,23250
23718,Jalaia,F,6,3296310,23820
23719,Jalan,M,6,3296316,23166
23720,Jalecia,F,6,3296322,23699
23721,Jalene,F,6,3296328,23946
23722,Jalicia,F,6,3296334,23835
23723,Jalyiah,F,6,3296340,23105
23724,Jama,M,6,3296346,23766
23725,Jamair,M,6,3296352,23240
23726,Jameis,M,6,3296358,23198
23727,Jamella,F,6,3296364,23316
23728,Jamesly,M,6,3296370,23143
23729,Jamill,M,6,3296376,23956
23730,Jamson,M,6,3296382,23854
23731,Janek,M,6,3296388,23573
23732,Jannely,F,6,3296394,23055
23733,Janxiel,M,6,3296400,23618
23734,Jaquari,M,6,3296406,23601
23735,Jaquil,M,6,3296412,23428
23736,Jaquis,M,6,3296418,23688
23737,Jara,F,6,3296424,23469
23738,Jaray,M,6,3296430,23531
23739,Jaremiah,M,6,3296436,23986
23740,Jaryan,M,6,3296442,23084
23741,Jaryn,M,6,3296448,23040
23742,Jaseem,M,6,3296454,23631
23743,Jaseer,M,6,3296460,23129
23744,Jashua,M,6,3296466,23220
23745,Jasira,F,6,3296472,23817
23746,Jasmarie,F,6,3296478,23738
23747,Jasser,M,6,3296484,23764
23748,Jaston,M,6,3296490,23547
23749,Jaswin,M,6,3296496,23724
23750,Javarius,M,6,3296502,23541
23751,Javia,F,6,3296508,23810
23752,Javiyah,F,6,3296514,23938
23753,Javonnie,M,6,3296520,23706
23754,Jaxsten,M,6,3296526,23529
23755,Jaxxyn,M,6,3296532,23823
23756,Jaxzon,M,6,3296538,23015
23757,Jayar,M,6,3296544,23790
23758,Jaydelin,F,6,3296550,23656
23759,Jaydiel,M,6,3296556,23427
23760,Jaylannie,F,6,3296562,23718
23761,Jaylex,M,6,3296568,23395
23762,Jaylynne,F,6,3296574,23420
23763,Jaymason,M,6,3296580,23282
23764,Jaymier,M,6,3296586,23818
23765,Jayni,F,6,3296592,23182
23766,Jayseon,M,6,3296598,23070
23767,Jayshon,M,6,3296604,23208
23768,Jaysten,M,6,3296610,23673
23769,Jaysun,M,6,3296616,23460
23770,Jayten,M,6,3296622,23290
23771,Jayva,F,6,3296628,23850
23772,Jayveer,M,6,3296634,23191
23773,Jayziah,M,6,3296640,23666
23774,Jazayah,F,6,3296646,23049
23775,Jazline,F,6,3296652,23713
23776,Jazyla,F,6,3296658,23840
23777,Jedrick,M,6,3296664,23742
23778,Jehoshaphat,M,6,3296670,23281
23779,Jeicob,M,6,3296676,23097
23780,Jeimmy,F,6,3296682,23269
23781,Jekalyn,F,6,3296688,23188
23782,Jelissa,F,6,3296694,23109
23783,Jemiyah,F,6,3296700,23359
23784,Jemmah,F,6,3296706,23072
23785,Jenai,F,6,3296712,23762
23786,Jenalise,F,6,3296718,23067
23787,Jenan,F,6,3296724,23870
23788,Jenavee,F,6,3296730,23976
23789,Jendriel,M,6,3296736,23795
23790,Jenell,F,6,3296742,23086
23791,Jenevy,F,6,3296748,23266
23792,Jennasis,F,6,3296754,23756
23793,Jennelle,F,6,3296760,23280
23794,Jenniah,F,6,3296766,23926
23795,Jera,F,6,3296772,23714
23796,Jeremiel,M,6,3296778,23413
23797,Jeren,M,6,3296784,23215
23798,Jerimyah,M,6,3296790,23925
23799,Jermanie,F,6,3296796,23687
23800,Jermel,M,6,3296802,23347
23801,Jermia,F,6,3296808,23247
23802,Jermir,M,6,3296814,23099
23803,Jermon,M,6,3296820,23791
23804,Jerni,F,6,3296826,23446
23805,Jeromy,M,6,3296832,23891
23806,Jerrico,M,6,3296838,23378
23807,Jerrison,M,6,3296844,23192
23808,Jerrold,M,6,3296850,23950
23809,Jersee,F,6,3296856,23242
23810,Jerzy,M,6,3296862,23746
23811,Jessee,M,6,3296868,23852
23812,Jessiel,M,6,3296874,23034
23813,Jestin,M,6,3296880,23077
23814,Jettie,F,6,3296886,23989
23815,Jeyleen,F,6,3296892,23509
23816,Jeymi,F,6,3296898,23501
23817,Jezabelle,F,6,3296904,23171
23818,Jezlyn,F,6,3296910,23598
23819,Jhaziel,M,6,3296916,23929
23820,Jhoanna,F,6,3296922,23323
23821,Jhonael,M,6,3296928,23163
23822,Jhordan,M,6,3296934,23720
23823,Jiaire,M,6,3296940,23005
23824,Jiani,F,6,3296946,23605
23825,Jibrael,M,6,3296952,23380
23826,Jibrail,M,6,3296958,23949
23827,Jihan,M,6,3296964,23506
23828,Jimi,F,6,3296970,23091
23829,Jimma,F,6,3296976,23038
23830,Jinger,F,6,3296982,23594
23831,Jiram,M,6,3296988,23041
23832,Jiro,M,6,3296994,23277
23833,Joaquina,F,6,3297000,23353
23834,Jobani,M,6,3297006,23180
23835,Jobie,M,6,3297012,23362
23836,Joby,M,6,3297018,23494
23837,Joceline,F,6,3297024,23027
23838,Joelie,F,6,3297030,23397
23839,Joelys,F,6,3297036,23648
23840,Johanan,M,6,3297042,23394
23841,Johara,F,6,3297048,23792
23842,Johnae,F,6,3297054,23092
23843,Johncharles,M,6,3297060,23175
23844,Johniel,M,6,3297066,23095
23845,Johnmatthew,M,6,3297072,23249
23846,Johnwesley,M,6,3297078,23655
23847,Johnwilliam,M,6,3297084,23535
23848,Johonna,F,6,3297090,23405
23849,Joli,F,6,3297096,23723
23850,Jolin,F,6,3297102,23992
23851,Jonessa,F,6,3297108,23510
23852,Joniyah,F,6,3297114,23726
23853,Jonni,F,6,3297120,23204
23854,Jonniel,M,6,3297126,23336
23855,Jonovan,M,6,3297132,23144
23856,Joren,M,6,3297138,23918
23857,Joriah,M,6,3297144,23341
23858,Joseth,M,6,3297150,23907
23859,Josielynn,F,6,3297156,23708
23860,Josilynn,F,6,3297162,23845
23861,Josina,F,6,3297168,23722
23862,Jossue,M,6,3297174,23480
23863,Josten,M,6,3297180,23207
23864,Jovial,F,6,3297186,23106
23865,Jovy,F,6,3297192,23883
23866,Joycelynn,F,6,3297198,23016
23867,Joylyn,F,6,3297204,23806
23868,Jozee,F,6,3297210,23133
23869,Jozi,F,6,3297216,23967
23870,Juanluis,M,6,3297222,23425
23871,Juddah,M,6,3297228,23866
23872,Judeah,F,6,3297234,23448
23873,Judie,F,6,3297240,23851
23874,Juell,M,6,3297246,23369
23875,Jule,F,6,3297252,23838
23876,Juleah,F,6,3297258,23595
23877,Julianah,F,6,3297264,23366
23878,Julianni,F,6,3297270,23158
23879,Julieanne,F,6,3297276,23654
23880,Julliette,F,6,3297282,23295
23881,Julyanna,F,6,3297288,23100
23882,Junkai,M,6,3297294,23152
23883,Jyla,F,6,3297300,23205
23884,Jyoti,F,6,3297306,23561
23885,Kaamil,M,6,3297312,23514
23886,Kaashvi,F,6,3297318,23231
23887,Kaceion,M,6,3297324,23540
23888,Kadeen,M,6,3297330,23732
23889,Kadience,F,6,3297336,23468
23890,Kaedynce,F,6,3297342,23765
23891,Kaegan,M,6,3297348,23160
23892,Kaemon,M,6,3297354,23824
23893,Kaetochukwu,M,6,3297360,23150
23894,Kahana,F,6,3297366,23364
23895,Kahlee,M,6,3297372,23778
23896,Kahlila,F,6,3297378,23199
23897,Kahne,M,6,3297384,23773
23898,Kahory,F,6,3297390,23994
23899,Kaianna,F,6,3297396,23620
23900,Kaiari,F,6,3297402,23423
23901,Kailanny,F,6,3297408,23002
23902,Kailaya,F,6,3297414,23301
23903,Kaileen,F,6,3297420,23908
23904,Kaimani,M,6,3297426,23317
23905,Kainat,F,6,3297432,23748
23906,Kaipo,M,6,3297438,23090
23907,Kaique,M,6,3297444,23439
23908,Kaithlyn,F,6,3297450,23384
23909,Kaiyana,F,6,3297456,23432
23910,Kaiza,M,6,3297462,23270
23911,Kaizyn,M,6,3297468,23293
23912,Kakashi,M,6,3297474,23087
23913,Kalaiah,F,6,3297480,23731
23914,Kalayia,F,6,3297486,23548
23915,Kaleeya,F,6,3297492,23580
23916,Kaleiyah,F,6,3297498,23437
23917,Kalet,M,6,3297504,23630
23918,Kalid,M,6,3297510,23942
23919,Kalki,F,6,3297516,23947
23920,Kalub,M,6,3297522,23636
23921,Kalvyn,M,6,3297528,23159
23922,Kaly,F,6,3297534,23721
23923,Kalyx,M,6,3297540,23704
23924,Kamahao,M,6,3297546,23959
23925,Kamali,M,6,3297552,23522
23926,Kamare,M,6,3297558,23635
23927,Kamarian,M,6,3297564,23018
23928,Kamariyah,F,6,3297570,23419
23929,Kamaro,M,6,3297576,23470
23930,Kamarri,M,6,3297582,23599
23931,Kamen,M,6,3297588,23787
23932,Kamiko,F,6,3297594,23121
23933,Kamillia,F,6,3297600,23758
23934,Kamoria,F,6,3297606,23564
23935,Kamorra,F,6,3297612,23499
23936,Kanarie,F,6,3297618,23367
23937,Kandyce,F,6,3297624,23401
23938,Kaniah,F,6,3297630,23911
23939,Kanika,F,6,3297636,23632
23940,Kannin,M,6,3297642,23493
23941,Karai,F,6,3297648,23684
23942,Kardell,M,6,3297654,23337
23943,Karee,F,6,3297660,23124
23944,Kareema,F,6,3297666,23675
23945,Karianna,F,6,3297672,23627
23946,Kariel,F,6,3297678,23957
23947,Kariya,F,6,3297684,23692
23948,Karrah,F,6,3297690,23964
23949,Karris,F,6,3297696,23076
23950,Karry,M,6,3297702,23550
23951,Karthika,F,6,3297708,23955
23952,Karyah,F,6,3297714,23830
23953,Kasan,M,6,3297720,23915
23954,Kasaun,M,6,3297726,23074
23955,Kaselynn,F,6,3297732,23562
23956,Kashe,M,6,3297738,23243
23957,Kashi,F,6,3297744,23516
23958,Kasidy,F,6,3297750,23652
23959,Kasion,M,6,3297756,23914
23960,Kasiya,F,6,3297762,23606
23961,Kastyn,M,6,3297768,23110
23962,Katelynne,F,6,3297774,23088
23963,Kateryna,F,6,3297780,23348
23964,Kathaleia,F,6,3297786,23014
23965,Kathlynn,F,6,3297792,23416
23966,Kathya,F,6,3297798,23813
23967,Katilyn,F,6,3297804,23009
23968,Kausar,F,6,3297810,23232
23969,Kavyn,M,6,3297816,23819
23970,Kaybree,F,6,3297822,23893
23971,Kaycin,M,6,3297828,23472
23972,Kaydn,M,6,3297834,23085
23973,Kaydrian,M,6,3297840,23524
23974,Kayl,M,6,3297846,23120
23975,Kaylanee,F,6,3297852,23549
23976,Kayliani,F,6,3297858,23466
23977,Kaynon,M,6,3297864,23879
23978,Kaysee,F,6,3297870,23196
23979,Kayva,F,6,3297876,23398
23980,Kazim,M,6,3297882,23877
23981,Kazir,M,6,3297888,23972
23982,Kazlynn,F,6,3297894,23886
23983,Kazmere,M,6,3297900,23412
23984,Kazz,M,6,3297906,23593
23985,Kceon,M,6,3297912,23254
23986,Kden,M,6,3297918,23536
23987,Keahilani,M,6,3297924,23285
23988,Keaira,F,6,3297930,23346
23989,Kealii,M,6,3297936,23517
23990,Keatyn,F,6,3297942,23934
23991,Kedar,M,6,3297948,23230
23992,Keefer,M,6,3297954,23515
23993,Keeghan,M,6,3297960,23556
23994,Keelani,F,6,3297966,23252
23995,Kehloni,F,6,3297972,23761
23996,Keiara,F,6,3297978,23905
23997,Keilahni,F,6,3297984,23921
23998,Keiland,M,6,3297990,23481
23999,Keilanys,F,6,3297996,23696
24000,Keiler,M,6,3298002,24470
24001,Keiley,F,6,3298008,24852
24002,Keilon,M,6,3298014,24202
24003,Keiren,M,6,3298020,24293
24004,Keishawn,M,6,3298026,24170
24005,Keiyon,M,6,3298032,24209
24006,Kelayah,F,6,3298038,24402
24007,Kelbie,F,6,3298044,24522
24008,Kelcey,F,6,3298050,24621
24009,Kelcy,F,6,3298056,24618
24010,Kelena,F,6,3298062,24901
24011,Kellon,M,6,3298068,24101
24012,Kellum,M,6,3298074,24276
24013,Kellyann,F,6,3298080,24102
24014,Kelsyn,F,6,3298086,24596
24015,Keltie,F,6,3298092,24015
24016,Kelvon,M,6,3298098,24224
24017,Kemiya,F,6,3298104,24025
24018,Kemorah,F,6,3298110,24951
24019,Kenard,M,6,3298116,24759
24020,Kendelle,F,6,3298122,24516
24021,Kendree,F,6,3298128,24966
24022,Kendryck,M,6,3298134,24350
24023,Kenichi,M,6,3298140,24000
24024,Kennedii,F,6,3298146,24504
24025,Kennet,M,6,3298152,24415
24026,Kennie,F,6,3298158,24489
24027,Kennis,F,6,3298164,24311
24028,Kenniyah,F,6,3298170,24628
24029,Kensey,F,6,3298176,24172
24030,Kenver,M,6,3298182,24472
24031,Keraun,M,6,3298188,24238
24032,Kerrick,M,6,3298194,24569
24033,Kerwens,M,6,3298200,24841
24034,Keshava,M,6,3298206,24518
24035,Ketsia,F,6,3298212,24592
24036,Keyair,M,6,3298218,24843
24037,Keyasia,F,6,3298224,24903
24038,Keylanie,F,6,3298230,24613
24039,Keyly,F,6,3298236,24648
24040,Keymani,F,6,3298242,24443
24041,Keyona,F,6,3298248,24866
24042,Keyren,M,6,3298254,24029
24043,Keyrin,F,6,3298260,24195
24044,Keyton,M,6,3298266,24653
24045,Kezlin,F,6,3298272,24894
24046,Kezlyn,F,6,3298278,24301
24047,Khaalid,M,6,3298284,24034
24048,Khade,M,6,3298290,24488
24049,Khadeeja,F,6,3298296,24143
24050,Khaila,F,6,3298302,24114
24051,Khailan,M,6,3298308,24446
24052,Khailyn,F,6,3298314,24115
24053,Khale,M,6,3298320,24107
24054,Khaleesia,F,6,3298326,24932
24055,Khalei,F,6,3298332,24236
24056,Khaleia,F,6,3298338,24409
24057,Khalifah,M,6,3298344,24201
24058,Khalin,M,6,3298350,24786
24059,Khamaya,F,6,3298356,24145
24060,Khameron,M,6,3298362,24913
24061,Khamille,F,6,3298368,24062
24062,Khamryn,F,6,3298374,24250
24063,Kharli,F,6,3298380,24392
24064,Kharmyn,F,6,3298386,24849
24065,Kharri,F,6,3298392,24048
24066,Khaya,F,6,3298398,24442
24067,Khaylee,F,6,3298404,24046
24068,Khelan,M,6,3298410,24436
24069,Khiana,F,6,3298416,24881
24070,Khilani,F,6,3298422,24092
24071,Khilynn,F,6,3298428,24324
24072,Khiro,M,6,3298434,24974
24073,Khloei,F,6,3298440,24498
24074,Khoda,M,6,3298446,24987
24075,Khoen,M,6,3298452,24996
24076,Kholee,F,6,3298458,24414
24077,Kholson,M,6,3298464,24768
24078,Khouri,F,6,3298470,24191
24079,Khyli,F,6,3298476,24306
24080,Khylynn,F,6,3298482,24827
24081,Khymir,M,6,3298488,24991
24082,Kiaansh,M,6,3298494,24249
24083,Kiai,M,6,3298500,24369
24084,Kiam,M,6,3298506,24807
24085,Kiandra,F,6,3298512,24515
24086,Kiaro,M,6,3298518,24109
24087,Kielan,M,6,3298524,24547
24088,Kienan,M,6,3298530,24713
24089,Kijani,M,6,3298536,24056
24090,Kilyn,F,6,3298542,24429
24091,Kimberlie,F,6,3298548,24416
24092,Kimble,M,6,3298554,24362
24093,Kimya,F,6,3298560,24574
24094,Kind,F,6,3298566,24934
24095,Kingjosiah,M,6,3298572,24476
24096,Kinnedy,F,6,3298578,24657
24097,Kinslea,F,6,3298584,24994
24098,Kinsli,F,6,3298590,24927
24099,Kiomi,F,6,3298596,24061
24100,Kionte,M,6,3298602,24723
24101,Kiria,F,6,3298608,24157
24102,Kirsty,F,6,3298614,24171
24103,Kiser,M,6,3298620,24989
24104,Kisha,F,6,3298626,24898
24105,Kiza,M,6,3298632,24848
24106,Kleah,F,6,3298638,24138
24107,Kline,M,6,3298644,24005
24108,Kloud,M,6,3298650,24086
24109,Knash,M,6,3298656,24093
24110,Knoll,M,6,3298662,24332
24111,Koden,M,6,3298668,24251
24112,Koltan,M,6,3298674,24763
24113,Kolyn,M,6,3298680,24111
24114,Komari,M,6,3298686,24840
24115,Korde,M,6,3298692,24227
24116,Kordel,M,6,3298698,24981
24117,Kordelia,F,6,3298704,24428
24118,Korinna,F,6,3298710,24892
24119,Korri,F,6,3298716,24877
24120,Kosem,F,6,3298722,24666
24121,Kosmas,M,6,3298728,24103
24122,Kourtnei,F,6,3298734,24543
24123,Koya,F,6,3298740,24909
24124,Kraven,M,6,3298746,24700
24125,Kreedence,M,6,3298752,24953
24126,Kreedyn,M,6,3298758,24604
24127,Kreighton,M,6,3298764,24797
24128,Kriss,M,6,3298770,24435
24129,Kristan,M,6,3298776,24266
24130,Kriston,M,6,3298782,24528
24131,Kriyansh,M,6,3298788,24594
24132,Kroi,M,6,3298794,24075
24133,Kron,M,6,3298800,24434
24134,Krosby,F,6,3298806,24525
24135,Kruize,M,6,3298812,24947
24136,Kulani,F,6,3298818,24617
24137,Kulsoom,F,6,3298824,24876
24138,Kuper,M,6,3298830,24231
24139,Kvon,M,6,3298836,24462
24140,Kwadwo,M,6,3298842,24252
24141,Kwamaine,M,6,3298848,24714
24142,Kwyn,F,6,3298854,24016
24143,Kyala,F,6,3298860,24363
24144,Kyanni,F,6,3298866,24635
24145,Kycere,M,6,3298872,24897
24146,Kyelynn,F,6,3298878,24486
24147,Kyheir,M,6,3298884,24364
24148,Kylann,M,6,3298890,24815
24149,Kylene,F,6,3298896,24944
24150,Kynzi,F,6,3298902,24150
24151,Kynzli,F,6,3298908,24289
24152,Kyreon,M,6,3298914,24028
24153,Kyrique,M,6,3298920,24190
24154,Kyrsten,F,6,3298926,24736
24155,Kyston,M,6,3298932,24456
24156,Kyton,M,6,3298938,24178
24157,Kyuss,M,6,3298944,24917
24158,Kyven,M,6,3298950,24856
24159,Kyver,M,6,3298956,24997
24160,Lachlann,M,6,3298962,24911
24161,Lah,F,6,3298968,24466
24162,Lahela,F,6,3298974,24388
24163,Laike,M,6,3298980,24823
24164,Laikin,F,6,3298986,24386
24165,Lailanni,F,6,3298992,24697
24166,Lailonie,F,6,3298998,24210
24167,Laini,F,6,3299004,24601
24168,Lainy,F,6,3299010,24378
24169,Laira,F,6,3299016,24465
24170,Lajla,F,6,3299022,24825
24171,Lakenya,F,6,3299028,24100
24172,Lakiya,F,6,3299034,24929
24173,Lakiyah,F,6,3299040,24900
24174,Lalah,F,6,3299046,24512
24175,Lalitha,F,6,3299052,24741
24176,Lamara,F,6,3299058,24422
24177,Lamere,M,6,3299064,24259
24178,Lamoni,F,6,3299070,24499
24179,Lamyra,F,6,3299076,24368
24180,Lan,M,6,3299082,24458
24181,Lanaiya,F,6,3299088,24986
24182,Lancelot,M,6,3299094,24689
24183,Lanea,F,6,3299100,24764
24184,Lang,M,6,3299106,24832
24185,Langstyn,M,6,3299112,24008
24186,Lannon,M,6,3299118,24799
24187,Lanova,F,6,3299124,24212
24188,Larah,F,6,3299130,24255
24189,Laraine,F,6,3299136,24536
24190,Larimar,F,6,3299142,24272
24191,Laryn,F,6,3299148,24753
24192,Lasean,M,6,3299154,24076
24193,Lashun,M,6,3299160,24257
24194,Latavia,F,6,3299166,24765
24195,Latonya,F,6,3299172,24440
24196,Latrice,F,6,3299178,24735
24197,Laureen,F,6,3299184,24273
24198,Laurelin,F,6,3299190,24235
24199,Lauriana,F,6,3299196,24810
24200,Lautaro,M,6,3299202,24420
24201,Lav,M,6,3299208,24954
24202,Lavera,F,6,3299214,24829
24203,Lavin,M,6,3299220,24923
24204,Laylaa,F,6,3299226,24095
24205,Laylamarie,F,6,3299232,24218
24206,Laylanni,F,6,3299238,24403
24207,Layona,F,6,3299244,24857
24208,Laythen,M,6,3299250,24258
24209,Lazario,M,6,3299256,24908
24210,Lc,M,6,3299262,24038
24211,Leahanna,F,6,3299268,24870
24212,Leahmarie,F,6,3299274,24949
24213,Leaira,F,6,3299280,24106
24214,Lealand,M,6,3299286,24096
24215,Lealani,F,6,3299292,24747
24216,Leandros,M,6,3299298,24573
24217,Leanni,F,6,3299304,24419
24218,Leany,F,6,3299310,24347
24219,Ledarius,M,6,3299316,24365
24220,Leddie,F,6,3299322,24464
24221,Ledgen,M,6,3299328,24011
24222,Leea,F,6,3299334,24706
24223,Leelou,F,6,3299340,24507
24224,Leeona,F,6,3299346,24683
24225,Leesha,F,6,3299352,24277
24226,Leeza,F,6,3299358,24317
24227,Lehua,F,6,3299364,24824
24228,Leibish,M,6,3299370,24576
24229,Leilanirose,F,6,3299376,24734
24230,Leisel,F,6,3299382,24684
24231,Lelianna,F,6,3299388,24788
24232,Lennard,M,6,3299394,24819
24233,Leno,M,6,3299400,24878
24234,Lenon,M,6,3299406,24482
24235,Leonnel,M,6,3299412,24051
24236,Leshawn,M,6,3299418,24733
24237,Lesleigh,F,6,3299424,24715
24238,Letha,F,6,3299430,24049
24239,Leveah,F,6,3299436,24130
24240,Levias,M,6,3299442,24221
24241,Levina,F,6,3299448,24868
24242,Levonte,M,6,3299454,24792
24243,Lexany,F,6,3299460,24166
24244,Lexxie,F,6,3299466,24037
24245,Leylany,F,6,3299472,24696
24246,Liamm,M,6,3299478,24605
24247,Liane,F,6,3299484,24395
24248,Lianet,F,6,3299490,24580
24249,Liban,M,6,3299496,24065
24250,Lilana,F,6,3299502,24385
24251,Lilarose,F,6,3299508,24845
24252,Lilette,F,6,3299514,24542
24253,Lilionna,F,6,3299520,24286
24254,Lilium,F,6,3299526,24136
24255,Lilliane,F,6,3299532,24396
24256,Lilliemae,F,6,3299538,24445
24257,Lillionna,F,6,3299544,24312
24258,Lillyannah,F,6,3299550,24379
24259,Lillyrose,F,6,3299556,24389
24260,Lilyauna,F,6,3299562,24579
24261,Lindsy,F,6,3299568,24520
24262,Lindyn,F,6,3299574,24204
24263,Lineth,F,6,3299580,24308
24264,Linna,F,6,3299586,24916
24265,Linwood,M,6,3299592,24180
24266,Lirael,F,6,3299598,24058
24267,Lirio,F,6,3299604,24087
24268,Lisbet,F,6,3299610,24348
24269,Liston,M,6,3299616,24682
24270,Lital,F,6,3299622,24863
24271,Litzi,F,6,3299628,24752
24272,Livier,F,6,3299634,24033
24273,Liyan,M,6,3299640,24692
24274,Liyat,F,6,3299646,24636
24275,Loden,M,6,3299652,24444
24276,Loganjames,M,6,3299658,24091
24277,Lolly,F,6,3299664,24502
24278,Loralyn,F,6,3299670,24925
24279,Loranna,F,6,3299676,24265
24280,Lorely,F,6,3299682,24938
24281,Lorian,M,6,3299688,24570
24282,Loriel,F,6,3299694,24586
24283,Lorina,F,6,3299700,24371
24284,Louanna,F,6,3299706,24544
24285,Louelle,F,6,3299712,24194
24286,Loui,M,6,3299718,24144
24287,Louisiana,F,6,3299724,24582
24288,Loukya,F,6,3299730,24263
24289,Lovelynn,F,6,3299736,24744
24290,Lucasalexander,M,6,3299742,24988
24291,Lucee,F,6,3299748,24725
24292,Lucelia,F,6,3299754,24532
24293,Lucija,F,6,3299760,24649
24294,Lucilia,F,6,3299766,24355
24295,Ludovic,M,6,3299772,24659
24296,Lukian,M,6,3299778,24527
24297,Lulani,F,6,3299784,24930
24298,Lunden,M,6,3299790,24853
24299,Lupe,M,6,3299796,24873
24300,Luseane,F,6,3299802,24006
24301,Luthien,F,6,3299808,24587
24302,Luwam,F,6,3299814,24787
24303,Lycan,M,6,3299820,24860
24304,Lyliah,F,6,3299826,24329
24305,Lyndell,M,6,3299832,24629
24306,Lyndsay,F,6,3299838,24588
24307,Lynell,M,6,3299844,24179
24308,Lynford,M,6,3299850,24156
24309,Lynix,F,6,3299856,24922
24310,Lynna,F,6,3299862,24862
24311,Lynnlea,F,6,3299868,24982
24312,Lynzie,F,6,3299874,24552
24313,Maame,F,6,3299880,24694
24314,Mackay,M,6,3299886,24942
24315,Mackensie,F,6,3299892,24529
24316,Maddoc,M,6,3299898,24449
24317,Madelinn,F,6,3299904,24835
24318,Madiana,F,6,3299910,24398
24319,Madilee,F,6,3299916,24777
24320,Madysyn,F,6,3299922,24650
24321,Madyx,F,6,3299928,24707
24322,Maeley,F,6,3299934,24168
24323,Magdaleno,M,6,3299940,24936
24324,Magdelyn,F,6,3299946,24022
24325,Magilan,M,6,3299952,24284
24326,Maheera,F,6,3299958,24760
24327,Mahek,F,6,3299964,24541
24328,Mahin,M,6,3299970,24948
24329,Mahmood,M,6,3299976,24830
24330,Mahveen,F,6,3299982,24279
24331,Maileigh,F,6,3299988,24044
24332,Maili,F,6,3299994,24647
24333,Maislee,F,6,3300000,24606
24334,Majestii,F,6,3300006,24494
24335,Majida,F,6,3300012,24781
24336,Makailah,F,6,3300018,24320
24337,Makaiya,F,6,3300024,24519
24338,Makara,F,6,3300030,24214
24339,Makaylynn,F,6,3300036,24328
24340,Makeen,M,6,3300042,24110
24341,Makeila,F,6,3300048,24566
24342,Makeo,M,6,3300054,24451
24343,Makinzi,F,6,3300060,24205
24344,Makiyla,F,6,3300066,24710
24345,Makylah,F,6,3300072,24261
24346,Makynleigh,F,6,3300078,24751
24347,Makyra,F,6,3300084,24771
24348,Malaak,F,6,3300090,24133
24349,Malaysha,F,6,3300096,24737
24350,Malee,F,6,3300102,24050
24351,Maleeka,F,6,3300108,24281
24352,Maleik,M,6,3300114,24632
24353,Maleka,F,6,3300120,24798
24354,Malian,F,6,3300126,24663
24355,Malini,F,6,3300132,24731
24356,Malk,F,6,3300138,24644
24357,Malkia,F,6,3300144,24998
24358,Mallori,F,6,3300150,24623
24359,Malyki,M,6,3300156,24314
24360,Malyn,F,6,3300162,24292
24361,Manasa,F,6,3300168,24517
24362,Mannan,M,6,3300174,24146
24363,Manogna,F,6,3300180,24699
24364,Manroop,F,6,3300186,24941
24365,Mansur,M,6,3300192,24505
24366,Manvik,M,6,3300198,24578
24367,Manvith,M,6,3300204,24766
24368,Marai,F,6,3300210,24854
24369,Marcellina,F,6,3300216,24600
24370,Marchesa,F,6,3300222,24129
24371,Marcianna,F,6,3300228,24377
24372,Marea,F,6,3300234,24790
24373,Mariaalice,F,6,3300240,24041
24374,Mariaisabella,F,6,3300246,24693
24375,Marianela,F,6,3300252,24248
24376,Mariapaz,F,6,3300258,24838
24377,Maribell,F,6,3300264,24847
24378,Marika,F,6,3300270,24779
24379,Mariyanna,F,6,3300276,24993
24380,Markavion,M,6,3300282,24585
24381,Markeise,M,6,3300288,24803
24382,Marken,M,6,3300294,24513
24383,Markham,M,6,3300300,24124
24384,Markhi,M,6,3300306,24330
24385,Marlana,F,6,3300312,24559
24386,Marliyah,F,6,3300318,24685
24387,Marque,M,6,3300324,24793
24388,Marquice,M,6,3300330,24162
24389,Martavion,M,6,3300336,24755
24390,Maru,M,6,3300342,24963
24391,Maruska,F,6,3300348,24219
24392,Maryclare,F,6,3300354,24071
24393,Maryela,F,6,3300360,24639
24394,Maryhelen,F,6,3300366,24874
24395,Marykatherine,F,6,3300372,24939
24396,Marykathryn,F,6,3300378,24577
24397,Marylouise,F,6,3300384,24584
24398,Marylu,F,6,3300390,24910
24399,Maryori,F,6,3300396,24646
24400,Masey,F,6,3300402,24808
24401,Masih,M,6,3300408,24417
24402,Maston,M,6,3300414,24746
24403,Mataeo,M,6,3300420,24423
24404,Mate,M,6,3300426,24640
24405,Mathyus,M,6,3300432,24066
24406,Mati,M,6,3300438,24899
24407,Matrix,M,6,3300444,24652
24408,Matua,M,6,3300450,24278
24409,Matvei,M,6,3300456,24222
24410,Matyas,M,6,3300462,24568
24411,Mave,F,6,3300468,24175
24412,Maxden,M,6,3300474,24937
24413,Maxene,F,6,3300480,24319
24414,Maximilano,M,6,3300486,24654
24415,Mayim,F,6,3300492,24211
24416,Maysam,F,6,3300498,24021
24417,Maysin,M,6,3300504,24709
24418,Mazlyn,F,6,3300510,24199
24419,Mazlynn,F,6,3300516,24550
24420,Mazon,M,6,3300522,24850
24421,Mckena,F,6,3300528,24242
24422,Mckenzlee,F,6,3300534,24495
24423,Mckynlie,F,6,3300540,24995
24424,Mclane,M,6,3300546,24521
24425,Meabh,F,6,3300552,24956
24426,Medley,F,6,3300558,24450
24427,Meek,M,6,3300564,24382
24428,Mehtaab,M,6,3300570,24302
24429,Melaher,F,6,3300576,24869
24430,Melaya,F,6,3300582,24887
24431,Meleni,F,6,3300588,24960
24432,Melenie,F,6,3300594,24965
24433,Meli,F,6,3300600,24481
24434,Melika,F,6,3300606,24366
24435,Meliya,F,6,3300612,24984
24436,Mercades,F,6,3300618,24337
24437,Merissa,F,6,3300624,24013
24438,Merly,F,6,3300630,24357
24439,Meron,M,6,3300636,24851
24440,Mesias,M,6,3300642,24716
24441,Messai,M,6,3300648,24890
24442,Messias,M,6,3300654,24359
24443,Meta,F,6,3300660,24926
24444,Metin,M,6,3300666,24321
24445,Meva,F,6,3300672,24912
24446,Meylani,F,6,3300678,24010
24447,Meztli,F,6,3300684,24581
24448,Miaisabella,F,6,3300690,24975
24449,Mian,M,6,3300696,24767
24450,Miani,F,6,3300702,24294
24451,Miaya,F,6,3300708,24471
24452,Mical,F,6,3300714,24634
24453,Michaelanthony,M,6,3300720,24457
24454,Michaeljames,M,6,3300726,24730
24455,Michiko,F,6,3300732,24128
24456,Micky,M,6,3300738,24200
24457,Mieka,F,6,3300744,24346
24458,Mieke,F,6,3300750,24461
24459,Mijoi,F,6,3300756,24370
24460,Mikaal,M,6,3300762,24020
24461,Mikala,F,6,3300768,24068
24462,Mikeila,F,6,3300774,24680
24463,Mikiya,F,6,3300780,24300
24464,Mikiyah,F,6,3300786,24295
24465,Mikki,F,6,3300792,24619
24466,Milagrace,F,6,3300798,24959
24467,Milarae,F,6,3300804,24467
24468,Milaysia,F,6,3300810,24282
24469,Milenna,F,6,3300816,24401
24470,Mileva,F,6,3300822,24637
24471,Milian,F,6,3300828,24575
24472,Milianna,F,6,3300834,24268
24473,Millena,F,6,3300840,24665
24474,Milon,M,6,3300846,24728
24475,Milove,F,6,3300852,24159
24476,Milyn,F,6,3300858,24052
24477,Mima,F,6,3300864,24971
24478,Minah,F,6,3300870,24313
24479,Minsa,F,6,3300876,24184
24480,Mionna,F,6,3300882,24383
24481,Mirae,F,6,3300888,24968
24482,Mirelle,F,6,3300894,24283
24483,Miroslav,M,6,3300900,24614
24484,Mishaun,M,6,3300906,24315
24485,Mishawn,M,6,3300912,24424
24486,Mishti,F,6,3300918,24814
24487,Missael,M,6,3300924,24340
24488,Missouri,F,6,3300930,24342
24489,Miu,F,6,3300936,24394
24490,Mixon,M,6,3300942,24084
24491,Miyu,F,6,3300948,24530
24492,Mkenzie,F,6,3300954,24433
24493,Moaz,M,6,3300960,24834
24494,Mohamadali,M,6,3300966,24119
24495,Mohanad,M,6,3300972,24183
24496,Mohani,F,6,3300978,24055
24497,Momoka,F,6,3300984,24487
24498,Monel,M,6,3300990,24131
24499,Moni,F,6,3300996,24480
24500,Moniece,F,6,3301002,24555
24501,Montanna,F,6,3301008,24285
24502,Montee,M,6,3301014,24811
24503,Montrez,M,6,3301020,24223
24504,Montzerrat,F,6,3301026,24973
24505,Morah,F,6,3301032,24079
24506,Mordcha,M,6,3301038,24501
24507,Mordy,M,6,3301044,24123
24508,Morena,F,6,3301050,24098
24509,Morireoluwa,F,6,3301056,24331
24510,Mory,M,6,3301062,24043
24511,Mosie,M,6,3301068,24468
24512,Mosley,F,6,3301074,24478
24513,Motaz,M,6,3301080,24888
24514,Moyosore,F,6,3301086,24740
24515,Muaaz,M,6,3301092,24239
24516,Muawiyah,M,6,3301098,24399
24517,Muiz,M,6,3301104,24339
24518,Munirah,F,6,3301110,24241
24519,Munisa,F,6,3301116,24540
24520,Muntaz,F,6,3301122,24483
24521,Murren,F,6,3301128,24681
24522,Musaab,M,6,3301134,24169
24523,Musfirah,F,6,3301140,24430
24524,Musiq,M,6,3301146,24565
24525,Mustafe,M,6,3301152,24672
24526,Mutaz,M,6,3301158,24262
24527,Myalee,F,6,3301164,24820
24528,Myan,F,6,3301170,24545
24529,Myarose,F,6,3301176,24090
24530,Myella,F,6,3301182,24453
24531,Myion,M,6,3301188,24026
24532,Mykhail,M,6,3301194,24067
24533,Mykolas,M,6,3301200,24081
24534,Myley,F,6,3301206,24950
24535,Myliah,F,6,3301212,24361
24536,Mylin,F,6,3301218,24907
24537,Mylina,F,6,3301224,24670
24538,Mylz,M,6,3301230,24142
24539,Myranda,F,6,3301236,24264
24540,Myrick,M,6,3301242,24638
24541,Myshaun,M,6,3301248,24612
24542,Naason,M,6,3301254,24656
24543,Nadezhda,F,6,3301260,24977
24544,Nadirah,F,6,3301266,24658
24545,Naetochukwu,M,6,3301272,24304
24546,Nafis,M,6,3301278,24373
24547,Nahome,M,6,3301284,24548
24548,Nahuel,M,6,3301290,24603
24549,Nahun,M,6,3301296,24531
24550,Nahya,F,6,3301302,24538
24551,Naiim,M,6,3301308,24139
24552,Naijah,F,6,3301314,24032
24553,Nakeem,M,6,3301320,24561
24554,Nakhari,M,6,3301326,24009
24555,Nalahni,F,6,3301332,24120
24556,Nalaiyah,F,6,3301338,24687
24557,Nalany,F,6,3301344,24002
24558,Nalina,F,6,3301350,24413
24559,Nalla,F,6,3301356,24676
24560,Nanaama,F,6,3301362,24872
24561,Nanayaa,F,6,3301368,24226
24562,Narayan,M,6,3301374,24334
24563,Naren,M,6,3301380,24970
24564,Narissa,F,6,3301386,24229
24565,Nashaly,F,6,3301392,24817
24566,Nashaun,M,6,3301398,24804
24567,Nasi,M,6,3301404,24088
24568,Nasirah,F,6,3301410,24889
24569,Nasteho,F,6,3301416,24893
24570,Natahlia,F,6,3301422,24918
24571,Natividad,F,6,3301428,24633
24572,Navada,F,6,3301434,24116
24573,Navari,M,6,3301440,24477
24574,Navarro,M,6,3301446,24057
24575,Navaya,F,6,3301452,24064
24576,Naviana,F,6,3301458,24298
24577,Navier,M,6,3301464,24316
24578,Navika,F,6,3301470,24411
24579,Naviya,F,6,3301476,24187
24580,Nayelle,F,6,3301482,24243
24581,Nazneen,F,6,3301488,24957
24582,Necalli,M,6,3301494,24946
24583,Nedal,M,6,3301500,24805
24584,Neeti,F,6,3301506,24230
24585,Neevan,M,6,3301512,24958
24586,Nefi,M,6,3301518,24296
24587,Nehara,F,6,3301524,24490
24588,Nehir,F,6,3301530,24074
24589,Neilah,F,6,3301536,24742
24590,Neima,F,6,3301542,24983
24591,Nektarios,M,6,3301548,24077
24592,Nelda,F,6,3301554,24879
24593,Nelina,F,6,3301560,24720
24594,Neomiah,M,6,3301566,24247
24595,Nereyda,F,6,3301572,24484
24596,Nethan,M,6,3301578,24591
24597,Nethaniel,M,6,3301584,24523
24598,Netta,F,6,3301590,24393
24599,Nevah,F,6,3301596,24826
24600,Newman,M,6,3301602,24431
24601,Neya,F,6,3301608,24112
24602,Nguyen,M,6,3301614,24089
24603,Nhan,M,6,3301620,24192
24604,Nhyla,F,6,3301626,24964
24605,Niamyah,F,6,3301632,24748
24606,Niarah,F,6,3301638,24758
24607,Nickayla,F,6,3301644,24240
24608,Nicki,F,6,3301650,24837
24609,Nicolae,M,6,3301656,24174
24610,Nielsen,M,6,3301662,24943
24611,Niemah,F,6,3301668,24452
24612,Nihaan,M,6,3301674,24783
24613,Nihar,M,6,3301680,24940
24614,Nike,M,6,3301686,24164
24615,Nikia,F,6,3301692,24962
24616,Nikkita,F,6,3301698,24609
24617,Nikoa,M,6,3301704,24915
24618,Nikoletta,F,6,3301710,24662
24619,Nimco,F,6,3301716,24526
24620,Nirav,M,6,3301722,24906
24621,Nishav,M,6,3301728,24270
24622,Nishi,F,6,3301734,24882
24623,Nissa,F,6,3301740,24664
24624,Nitiksha,F,6,3301746,24836
24625,Niven,M,6,3301752,24003
24626,Niyara,F,6,3301758,24432
24627,Niyelli,F,6,3301764,24438
24628,Niyyah,F,6,3301770,24260
24629,Nohelia,F,6,3301776,24549
24630,Noralyn,F,6,3301782,24626
24631,Nore,M,6,3301788,24718
24632,Noriella,F,6,3301794,24165
24633,Normajean,F,6,3301800,24625
24634,Norra,F,6,3301806,24108
24635,Novagrace,F,6,3301812,24318
24636,Novaya,F,6,3301818,24307
24637,Nussen,M,6,3301824,24669
24638,Nyalah,F,6,3301830,24698
24639,Nyaomi,F,6,3301836,24593
24640,Nydia,F,6,3301842,24479
24641,Nyel,M,6,3301848,24784
24642,Nygel,M,6,3301854,24287
24643,Nyheim,M,6,3301860,24738
24644,Nyia,F,6,3301866,24380
24645,Nylarose,F,6,3301872,24556
24646,Nyllah,F,6,3301878,24017
24647,Nylo,M,6,3301884,24806
24648,Nyna,F,6,3301890,24126
24649,Nyori,F,6,3301896,24624
24650,Nyson,M,6,3301902,24134
24651,Nyzair,M,6,3301908,24510
24652,Nzinga,F,6,3301914,24503
24653,Oaklynd,F,6,3301920,24207
24654,Obai,M,6,3301926,24246
24655,Obianuju,F,6,3301932,24104
24656,Obryan,M,6,3301938,24567
24657,Ocie,M,6,3301944,24448
24658,Octaviah,F,6,3301950,24770
24659,Odeya,F,6,3301956,24406
24660,Odhran,M,6,3301962,24070
24661,Oleksandr,M,6,3301968,24463
24662,Olumide,M,6,3301974,24883
24663,Oluwafunmilayo,F,6,3301980,24514
24664,Oluwatomisin,F,6,3301986,24215
24665,Omario,M,6,3301992,24155
24666,Onel,M,6,3301998,24496
24667,Onesimo,M,6,3302004,24198
24668,Oniyah,F,6,3302010,24627
24669,Onyinyechi,F,6,3302016,24865
24670,Oonagh,F,6,3302022,24085
24671,Orabella,F,6,3302028,24208
24672,Orianthi,F,6,3302034,24497
24673,Orik,M,6,3302040,24125
24674,Oriya,F,6,3302046,24072
24675,Orlo,M,6,3302052,24791
24676,Oshin,F,6,3302058,24895
24677,Osmany,M,6,3302064,24161
24678,Osmara,F,6,3302070,24712
24679,Osmel,M,6,3302076,24785
24680,Oso,M,6,3302082,24412
24681,Ossian,M,6,3302088,24405
24682,Ottis,M,6,3302094,24880
24683,Ovi,F,6,3302100,24181
24684,Owain,M,6,3302106,24631
24685,Owenn,M,6,3302112,24967
24686,Padma,F,6,3302118,24105
24687,Paiden,M,6,3302124,24280
24688,Pailynn,F,6,3302130,24454
24689,Paislea,F,6,3302136,24035
24690,Palwasha,F,6,3302142,24297
24691,Panayiota,F,6,3302148,24167
24692,Pauly,M,6,3302154,24795
24693,Pavly,M,6,3302160,24117
24694,Paxtin,M,6,3302166,24800
24695,Paylin,F,6,3302172,24754
24696,Paysley,F,6,3302178,24705
24697,Paytyn,F,6,3302184,24213
24698,Pemberley,F,6,3302190,24054
24699,Pendleton,M,6,3302196,24749
24700,Penley,F,6,3302202,24437
24701,Peony,F,6,3302208,24844
24702,Pera,F,6,3302214,24875
24703,Persis,F,6,3302220,24460
24704,Pfeiffer,F,6,3302226,24309
24705,Phelan,M,6,3302232,24349
24706,Phillipa,F,6,3302238,24980
24707,Philopateer,M,6,3302244,24354
24708,Phyllip,M,6,3302250,24269
24709,Piers,M,6,3302256,24990
24710,Pieter,M,6,3302262,24796
24711,Pinches,M,6,3302268,24234
24712,Pio,M,6,3302274,24427
24713,Poe,F,6,3302280,24099
24714,Poem,F,6,3302286,24152
24715,Polaris,F,6,3302292,24360
24716,Polette,F,6,3302298,24206
24717,Poyraz,M,6,3302304,24189
24718,Prabh,M,6,3302310,24063
24719,Pradyumna,M,6,3302316,24828
24720,Pragnya,F,6,3302322,24153
24721,Premier,M,6,3302328,24177
24722,Presten,M,6,3302334,24772
24723,Primus,M,6,3302340,24137
24724,Princecharles,M,6,3302346,24674
24725,Prinston,M,6,3302352,24228
24726,Prish,M,6,3302358,24036
24727,Priyan,M,6,3302364,24979
24728,Purvi,F,6,3302370,24163
24729,Qaadir,M,6,3302376,24254
24730,Qiana,F,6,3302382,24562
24731,Quang,M,6,3302388,24842
24732,Quasim,M,6,3302394,24616
24733,Que,M,6,3302400,24333
24734,Quinne,F,6,3302406,24732
24735,Quinzel,F,6,3302412,24661
24736,Raaina,F,6,3302418,24341
24737,Raaya,F,6,3302424,24053
24738,Rachid,M,6,3302430,24267
24739,Radford,M,6,3302436,24598
24740,Radin,M,6,3302442,24511
24741,Radlee,M,6,3302448,24590
24742,Raely,F,6,3302454,24073
24743,Rafiq,M,6,3302460,24688
24744,Ragen,F,6,3302466,24387
24745,Raha,F,6,3302472,24719
24746,Rahmeir,M,6,3302478,24702
24747,Rahni,F,6,3302484,24459
24748,Raidon,M,6,3302490,24551
24749,Raiyna,F,6,3302496,24374
24750,Rajab,M,6,3302502,24816
24751,Rajvi,F,6,3302508,24859
24752,Rakel,F,6,3302514,24233
24753,Raliyah,F,6,3302520,24256
24754,Ralphael,M,6,3302526,24660
24755,Ralphie,M,6,3302532,24743
24756,Ramadan,M,6,3302538,24611
24757,Ramal,M,6,3302544,24607
24758,Ramaya,F,6,3302550,24275
24759,Ramere,M,6,3302556,24985
24760,Ramyiah,F,6,3302562,24216
24761,Ranferi,M,6,3302568,24323
24762,Ranson,M,6,3302574,24367
24763,Rashan,M,6,3302580,24902
24764,Rashelle,F,6,3302586,24608
24765,Rawling,M,6,3302592,24220
24766,Rayder,M,6,3302598,24642
24767,Raylah,F,6,3302604,24708
24768,Raylani,F,6,3302610,24673
24769,Raylei,F,6,3302616,24447
24770,Raynav,M,6,3302622,24571
24771,Rayshun,M,6,3302628,24914
24772,Rebelle,F,6,3302634,24813
24773,Recker,M,6,3302640,24027
24774,Reddington,M,6,3302646,24969
24775,Redwan,M,6,3302652,24352
24776,Ree,F,6,3302658,24553
24777,Reeyansh,M,6,3302664,24485
24778,Reiko,F,6,3302670,24197
24779,Reinhardt,M,6,3302676,24148
24780,Reinna,F,6,3302682,24921
24781,Remilynn,F,6,3302688,24001
24782,Remiyah,F,6,3302694,24023
24783,Rendon,M,6,3302700,24506
24784,Renezmee,F,6,3302706,24397
24785,Renick,M,6,3302712,24031
24786,Renji,M,6,3302718,24691
24787,Renli,F,6,3302724,24019
24788,Renlie,F,6,3302730,24690
24789,Renny,M,6,3302736,24356
24790,Reshard,M,6,3302742,24271
24791,Reshawn,M,6,3302748,24455
24792,Rett,M,6,3302754,24831
24793,Revyn,M,6,3302760,24018
24794,Reygan,F,6,3302766,24173
24795,Reylan,M,6,3302772,24237
24796,Rhaelyn,F,6,3302778,24858
24797,Rhaya,F,6,3302784,24493
24798,Rhyden,M,6,3302790,24127
24799,Rhye,M,6,3302796,24839
24800,Rhyis,M,6,3302802,24671
24801,Rhyli,F,6,3302808,24861
24802,Rhyon,F,6,3302814,24554
24803,Rhysand,M,6,3302820,24327
24804,Ridgely,F,6,3302826,24303
24805,Ridger,M,6,3302832,24563
24806,Ridha,M,6,3302838,24643
24807,Ridwaan,M,6,3302844,24244
24808,Riella,F,6,3302850,24391
24809,Rifky,F,6,3302856,24232
24810,Riki,F,6,3302862,24867
24811,Rikiyah,F,6,3302868,24500
24812,Riko,M,6,3302874,24400
24813,Rikuto,M,6,3302880,24952
24814,Rilah,F,6,3302886,24121
24815,Riser,M,6,3302892,24595
24816,Rithvika,F,6,3302898,24007
24817,Ritvik,M,6,3302904,24410
24818,Rivki,F,6,3302910,24564
24819,Rixton,M,6,3302916,24069
24820,Riyaz,M,6,3302922,24924
24821,Riylee,F,6,3302928,24667
24822,Roderic,M,6,3302934,24004
24823,Roey,M,6,3302940,24326
24824,Rohini,F,6,3302946,24024
24825,Rohnan,M,6,3302952,24992
24826,Rojan,F,6,3302958,24739
24827,Rollie,M,6,3302964,24778
24828,Romar,M,6,3302970,24094
24829,Romare,M,6,3302976,24762
24830,Ronak,M,6,3302982,24151
24831,Rone,M,6,3302988,24338
24832,Ronia,F,6,3302994,24871
24833,Ronith,M,6,3303000,24353
24834,Roop,F,6,3303006,24083
24835,Rosalene,F,6,3303012,24132
24836,Rosalita,F,6,3303018,24045
24837,Rosalva,F,6,3303024,24668
24838,Roseleigh,F,6,3303030,24722
24839,Rosenda,F,6,3303036,24404
24840,Roshna,F,6,3303042,24418
24841,Rosse,F,6,3303048,24794
24842,Rowdey,M,6,3303054,24042
24843,Rowenna,F,6,3303060,24012
24844,Roxane,F,6,3303066,24534
24845,Roxen,M,6,3303072,24147
24846,Royaltii,F,6,3303078,24508
24847,Rron,M,6,3303084,24846
24848,Rubens,M,6,3303090,24343
24849,Rudraksh,M,6,3303096,24833
24850,Ruhika,F,6,3303102,24935
24851,Rumaan,F,6,3303108,24583
24852,Ruqaiyah,F,6,3303114,24645
24853,Ruthanna,F,6,3303120,24602
24854,Ruthi,F,6,3303126,24245
24855,Ruthy,F,6,3303132,24113
24856,Ruwaida,F,6,3303138,24572
24857,Ruya,F,6,3303144,24203
24858,Ruzgar,M,6,3303150,24376
24859,Ry,M,6,3303156,24344
24860,Rykeem,M,6,3303162,24599
24861,Saada,F,6,3303168,24622
24862,Saanjh,F,6,3303174,24931
24863,Saanvireddy,F,6,3303180,24149
24864,Saarah,F,6,3303186,24539
24865,Saaya,F,6,3303192,24557
24866,Sabal,M,6,3303198,24717
24867,Sabali,F,6,3303204,24439
24868,Sabel,F,6,3303210,24769
24869,Sabryna,F,6,3303216,24884
24870,Sadhana,F,6,3303222,24274
24871,Sadiel,M,6,3303228,24711
24872,Sadielynn,F,6,3303234,24030
24873,Sadierose,F,6,3303240,24822
24874,Sadler,M,6,3303246,24325
24875,Sadra,F,6,3303252,24886
24876,Sadye,F,6,3303258,24118
24877,Saeid,M,6,3303264,24186
24878,Safal,M,6,3303270,24141
24879,Saffiyah,F,6,3303276,24678
24880,Sahalie,F,6,3303282,24158
24881,Saije,F,6,3303288,24473
24882,Saily,F,6,3303294,24776
24883,Sairah,F,6,3303300,24630
24884,Saiyan,M,6,3303306,24188
24885,Sakiya,F,6,3303312,24757
24886,Salia,F,6,3303318,24677
24887,Samaad,M,6,3303324,24686
24888,Samai,M,6,3303330,24789
24889,Samanvita,F,6,3303336,24491
24890,Samariah,F,6,3303342,24196
24891,Samarra,F,6,3303348,24999
24892,Samatar,M,6,3303354,24801
24893,Sameeha,F,6,3303360,24679
24894,Sameh,M,6,3303366,24154
24895,Sameya,F,6,3303372,24891
24896,Samin,M,6,3303378,24358
24897,Samiuela,M,6,3303384,24812
24898,Samoni,F,6,3303390,24537
24899,Samra,F,6,3303396,24904
24900,Samrath,M,6,3303402,24727
24901,Samridhi,F,6,3303408,24655
24902,Samsam,F,6,3303414,24919
24903,Samuela,F,6,3303420,24176
24904,Samueljames,M,6,3303426,24122
24905,Samyar,M,6,3303432,24961
24906,Samyr,M,6,3303438,24372
24907,Sanika,F,6,3303444,24726
24908,Saniyyah,F,6,3303450,24864
24909,Sanvitha,F,6,3303456,24641
24910,Saphyra,F,6,3303462,24336
24911,Saran,F,6,3303468,24059
24912,Sare,F,6,3303474,24193
24913,Sarfaraz,M,6,3303480,24305
24914,Sarisha,F,6,3303486,24928
24915,Sarp,M,6,3303492,24809
24916,Sarvin,M,6,3303498,24675
24917,Sarya,F,6,3303504,24978
24918,Saurav,M,6,3303510,24097
24919,Savreen,F,6,3303516,24185
24920,Sawdah,F,6,3303522,24060
24921,Sayani,F,6,3303528,24217
24922,Sayda,F,6,3303534,24885
24923,Sayumi,F,6,3303540,24014
24924,Sayvon,M,6,3303546,24589
24925,Schneider,M,6,3303552,24080
24926,Schneur,M,6,3303558,24082
24927,Scot,M,6,3303564,24290
24928,Secilia,F,6,3303570,24524
24929,Sedric,M,6,3303576,24375
24930,Sehajpreet,F,6,3303582,24426
24931,Seina,F,6,3303588,24408
24932,Seleen,F,6,3303594,24721
24933,Selman,M,6,3303600,24933
24934,Sema,F,6,3303606,24620
24935,Semajay,M,6,3303612,24905
24936,Semiah,F,6,3303618,24299
24937,Semisi,M,6,3303624,24492
24938,Senovia,F,6,3303630,24421
24939,Sentell,M,6,3303636,24535
24940,Serai,F,6,3303642,24701
24941,Seraphim,F,6,3303648,24140
24942,Seriah,F,6,3303654,24039
24943,Serjio,M,6,3303660,24955
24944,Sesasi,F,6,3303666,24425
24945,Sevda,F,6,3303672,24802
24946,Severino,M,6,3303678,24182
24947,Sevilla,F,6,3303684,24972
24948,Seyon,M,6,3303690,24610
24949,Shahem,M,6,3303696,24047
24950,Shahida,F,6,3303702,24291
24951,Shahwaiz,M,6,3303708,24745
24952,Shakeel,M,6,3303714,24441
24953,Shalia,F,6,3303720,24407
24954,Shamia,F,6,3303726,24945
24955,Shanon,M,6,3303732,24322
24956,Sharifa,F,6,3303738,24310
24957,Sharleen,F,6,3303744,24390
24958,Sharol,F,6,3303750,24253
24959,Shayley,F,6,3303756,24597
24960,Shaylie,F,6,3303762,24533
24961,Shedrick,M,6,3303768,24782
24962,Shehryar,M,6,3303774,24078
24963,Sheina,F,6,3303780,24160
24964,Shenandoah,F,6,3303786,24509
24965,Sherif,M,6,3303792,24704
24966,Sheriff,M,6,3303798,24546
24967,Sherlin,F,6,3303804,24761
24968,Sherlock,M,6,3303810,24135
24969,Sherwood,M,6,3303816,24288
24970,Shiann,F,6,3303822,24780
24971,Shikha,F,6,3303828,24855
24972,Shila,F,6,3303834,24651
24973,Shilynn,F,6,3303840,24775
24974,Shiran,F,6,3303846,24920
24975,Shivank,M,6,3303852,24474
24976,Shlomie,M,6,3303858,24384
24977,Shooter,M,6,3303864,24335
24978,Shreeja,F,6,3303870,24976
24979,Shreena,F,6,3303876,24729
24980,Shristi,F,6,3303882,24560
24981,Shubham,M,6,3303888,24615
24982,Shula,F,6,3303894,24558
24983,Siaosi,M,6,3303900,24351
24984,Siarah,F,6,3303906,24896
24985,Sibella,F,6,3303912,24724
24986,Siddalee,F,6,3303918,24695
24987,Siddh,M,6,3303924,24381
24988,Sidiki,M,6,3303930,24756
24989,Siella,F,6,3303936,24469
24990,Siersha,F,6,3303942,24345
24991,Sifan,F,6,3303948,24750
24992,Simara,F,6,3303954,24821
24993,Simra,F,6,3303960,24773
24994,Sims,M,6,3303966,24040
24995,Simy,F,6,3303972,24225
24996,Sinsere,M,6,3303978,24774
24997,Sirah,F,6,3303984,24818
24998,Sirayah,F,6,3303990,24475
24999,Siren,F,6,3303996,24703
25000,Sirenity,F,6,3304002,25066
25001,Sirinity,F,6,3304008,25885
25002,Sirrenity,F,6,3304014,25459
25003,Sirroyal,M,6,3304020,25680
25004,Sirwilliam,M,6,3304026,25803
25005,Sivana,F,6,3304032,25335
25006,Sixto,M,6,3304038,25181
25007,Siyu,F,6,3304044,25658
25008,Skie,F,6,3304050,25403
25009,Skylarrose,F,6,3304056,25099
25010,Skylene,F,6,3304062,25624
25011,Slayter,M,6,3304068,25482
25012,Smaran,M,6,3304074,25826
25013,Smyth,M,6,3304080,25654
25014,Sneijder,M,6,3304086,25317
25015,Solis,M,6,3304092,25721
25016,Solo,M,6,3304098,25966
25017,Soluna,F,6,3304104,25090
25018,Solveigh,F,6,3304110,25854
25019,Solyana,F,6,3304116,25792
25020,Somi,F,6,3304122,25588
25021,Sondos,F,6,3304128,25848
25022,Sonni,F,6,3304134,25013
25023,Sophira,F,6,3304140,25603
25024,Soumaya,F,6,3304146,25742
25025,Spade,M,6,3304152,25485
25026,Spenser,M,6,3304158,25101
25027,Spike,M,6,3304164,25278
25028,Srijan,M,6,3304170,25377
25029,Stanislav,M,6,3304176,25734
25030,Starlie,F,6,3304182,25280
25031,Statler,M,6,3304188,25150
25032,Stellaluna,F,6,3304194,25331
25033,Stellamarie,F,6,3304200,25724
25034,Stephani,F,6,3304206,25640
25035,Stihl,M,6,3304212,25154
25036,Stoic,M,6,3304218,25436
25037,Storey,F,6,3304224,25560
25038,Su,F,6,3304230,25468
25039,Sue,F,6,3304236,25873
25040,Sueann,F,6,3304242,25130
25041,Suhaas,M,6,3304248,25276
25042,Sukayna,F,6,3304254,25772
25043,Sulekha,F,6,3304260,25578
25044,Sultana,F,6,3304266,25321
25045,Sumiya,F,6,3304272,25716
25046,Suni,F,6,3304278,25204
25047,Sunil,M,6,3304284,25821
25048,Sunnah,F,6,3304290,25484
25049,Sunniva,F,6,3304296,25925
25050,Survi,F,6,3304302,25189
25051,Sutten,F,6,3304308,25608
25052,Suvan,M,6,3304314,25239
25053,Swarnim,M,6,3304320,25382
25054,Syeed,M,6,3304326,25129
25055,Sylver,F,6,3304332,25238
25056,Symeon,M,6,3304338,25043
25057,Symphani,F,6,3304344,25769
25058,Synclaire,F,6,3304350,25561
25059,Syria,F,6,3304356,25026
25060,Syx,M,6,3304362,25175
25061,Tabari,M,6,3304368,25634
25062,Tadashi,M,6,3304374,25965
25063,Tadgh,M,6,3304380,25841
25064,Taeshawn,M,6,3304386,25699
25065,Taeveon,M,6,3304392,25987
25066,Tahmeed,M,6,3304398,25262
25067,Tahsin,M,6,3304404,25886
25068,Taiana,F,6,3304410,25455
25069,Taiba,F,6,3304416,25566
25070,Taila,F,6,3304422,25678
25071,Taimane,F,6,3304428,25170
25072,Taio,M,6,3304434,25288
25073,Taisia,F,6,3304440,25707
25074,Taiwan,M,6,3304446,25174
25075,Taiwo,F,6,3304452,25715
25076,Takayla,F,6,3304458,25983
25077,Takiya,F,6,3304464,25515
25078,Takuma,M,6,3304470,25726
25079,Takylah,F,6,3304476,25785
25080,Taleigh,F,6,3304482,25030
25081,Taleya,F,6,3304488,25752
25082,Taline,F,6,3304494,25991
25083,Tamaj,M,6,3304500,25195
25084,Tamiah,F,6,3304506,25215
25085,Tamryn,F,6,3304512,25887
25086,Tanea,F,6,3304518,25076
25087,Taneya,F,6,3304524,25756
25088,Tani,F,6,3304530,25125
25089,Taniylah,F,6,3304536,25368
25090,Tank,M,6,3304542,25449
25091,Tanna,F,6,3304548,25593
25092,Tapanga,F,6,3304554,25028
25093,Taraf,F,6,3304560,25138
25094,Taralynn,F,6,3304566,25226
25095,Tarell,M,6,3304572,25594
25096,Tarron,M,6,3304578,25622
25097,Tashaun,M,6,3304584,25647
25098,Tatumn,F,6,3304590,25913
25099,Tauri,F,6,3304596,25193
25100,Tavarious,M,6,3304602,25500
25101,Tavarius,M,6,3304608,25615
25102,Tavayah,F,6,3304614,25600
25103,Tavita,M,6,3304620,25540
25104,Tavoris,M,6,3304626,25221
25105,Tavyn,M,6,3304632,25134
25106,Tayiba,F,6,3304638,25144
25107,Taylorrose,F,6,3304644,25194
25108,Taylour,F,6,3304650,25409
25109,Taymir,M,6,3304656,25906
25110,Tayonna,F,6,3304662,25889
25111,Taysean,M,6,3304668,25499
25112,Taysia,F,6,3304674,25346
25113,Tayyab,M,6,3304680,25895
25114,Tayyib,M,6,3304686,25783
25115,Taziyah,F,6,3304692,25530
25116,Teaira,F,6,3304698,25941
25117,Teairra,F,6,3304704,25692
25118,Tedi,F,6,3304710,25216
25119,Teeda,F,6,3304716,25127
25120,Tehlani,F,6,3304722,25454
25121,Teion,M,6,3304728,25552
25122,Temitayo,M,6,3304734,25596
25123,Teoman,M,6,3304740,25287
25124,Terez,M,6,3304746,25947
25125,Terrel,M,6,3304752,25684
25126,Tessley,F,6,3304758,25315
25127,Tevan,M,6,3304764,25891
25128,Teylie,F,6,3304770,25305
25129,Teyton,M,6,3304776,25477
25130,Thadius,M,6,3304782,25158
25131,Thales,M,6,3304788,25502
25132,Theeran,M,6,3304794,25392
25133,Thian,M,6,3304800,25171
25134,Thiara,F,6,3304806,25595
25135,Thomasina,F,6,3304812,25240
25136,Thoran,M,6,3304818,25063
25137,Thorben,M,6,3304824,25843
25138,Thorton,M,6,3304830,25018
25139,Thyme,M,6,3304836,25404
25140,Tijan,M,6,3304842,25364
25141,Till,M,6,3304848,25430
25142,Tiyana,F,6,3304854,25352
25143,Tjay,M,6,3304860,25960
25144,Tolson,M,6,3304866,25424
25145,Tomasi,M,6,3304872,25601
25146,Tonny,M,6,3304878,25153
25147,Tramel,M,6,3304884,25056
25148,Tramell,M,6,3304890,25380
25149,Travontae,M,6,3304896,25920
25150,Traxton,M,6,3304902,25383
25151,Traylon,M,6,3304908,25667
25152,Trea,M,6,3304914,25002
25153,Tremain,M,6,3304920,25957
25154,Tremere,M,6,3304926,25669
25155,Treshon,M,6,3304932,25350
25156,Treson,M,6,3304938,25184
25157,Tressie,F,6,3304944,25908
25158,Treya,F,6,3304950,25166
25159,Treycen,M,6,3304956,25980
25160,Treylin,M,6,3304962,25290
25161,Trig,M,6,3304968,25757
25162,Trippton,M,6,3304974,25186
25163,Tripton,M,6,3304980,25312
25164,Truli,F,6,3304986,25214
25165,Tryson,M,6,3304992,25903
25166,Trystyn,M,6,3304998,25458
25167,Tui,M,6,3305004,25718
25168,Tupac,M,6,3305010,25075
25169,Tuvia,M,6,3305016,25930
25170,Tyhir,M,6,3305022,25260
25171,Tyli,F,6,3305028,25094
25172,Tymberlee,F,6,3305034,25505
25173,Tymberlynn,F,6,3305040,25031
25174,Tymoteusz,M,6,3305046,25856
25175,Tyndall,F,6,3305052,25567
25176,Tynsleigh,F,6,3305058,25277
25177,Tyrael,M,6,3305064,25256
25178,Tyrease,M,6,3305070,25539
25179,Tyrrell,M,6,3305076,25438
25180,Tytiana,F,6,3305082,25017
25181,Tywan,M,6,3305088,25628
25182,Tyzer,M,6,3305094,25881
25183,Uchenna,M,6,3305100,25940
25184,Uday,M,6,3305106,25470
25185,Ugonna,M,6,3305112,25519
25186,Ukiah,M,6,3305118,25387
25187,Ula,F,6,3305124,25235
25188,Ulyana,F,6,3305130,25446
25189,Umrah,F,6,3305136,25325
25190,Unnamed,F,6,3305142,25681
25191,Urbano,M,6,3305148,25791
25192,Urenna,F,6,3305154,25479
25193,Vaiden,M,6,3305160,25016
25194,Vaidik,M,6,3305166,25635
25195,Valhalla,F,6,3305172,25580
25196,Vandan,M,6,3305178,25251
25197,Vanelope,F,6,3305184,25036
25198,Vannah,F,6,3305190,25531
25199,Vannia,F,6,3305196,25306
25200,Vasilije,M,6,3305202,25958
25201,Vayoleth,F,6,3305208,25627
25202,Venita,F,6,3305214,25795
25203,Venture,M,6,3305220,25023
25204,Veralyn,F,6,3305226,25660
25205,Veralynn,F,6,3305232,25408
25206,Vesta,F,6,3305238,25460
25207,Victorio,M,6,3305244,25049
25208,Vinay,M,6,3305250,25427
25209,Vinayak,M,6,3305256,25613
25210,Vionna,F,6,3305262,25009
25211,Vishan,M,6,3305268,25583
25212,Vismaya,F,6,3305274,25546
25213,Vitor,M,6,3305280,25818
25214,Viviene,F,6,3305286,25000
25215,Vivyan,F,6,3305292,25393
25216,Volvy,M,6,3305298,25717
25217,Vraj,M,6,3305304,25532
25218,Vyan,M,6,3305310,25591
25219,Vylett,F,6,3305316,25687
25220,Waelyn,M,6,3305322,25300
25221,Wahaj,M,6,3305328,25083
25222,Wailyn,M,6,3305334,25354
25223,Wallis,F,6,3305340,25054
25224,Wanya,M,6,3305346,25513
25225,Wardell,M,6,3305352,25587
25226,Warden,M,6,3305358,25307
25227,Weatherly,F,6,3305364,25080
25228,Wendel,M,6,3305370,25069
25229,Wendi,F,6,3305376,25649
25230,Westan,M,6,3305382,25095
25231,Weylen,M,6,3305388,25719
25232,Whelan,M,6,3305394,25478
25233,Willah,F,6,3305400,25401
25234,Willowdean,F,6,3305406,25675
25235,Wilmar,M,6,3305412,25796
25236,Wimberly,F,6,3305418,25164
25237,Win,M,6,3305424,25511
25238,Winsten,M,6,3305430,25929
25239,Winterlynn,F,6,3305436,25946
25240,Wryder,M,6,3305442,25605
25241,Wylan,M,6,3305448,25117
25242,Xachary,M,6,3305454,25497
25243,Xaia,F,6,3305460,25793
25244,Xaire,M,6,3305466,25975
25245,Xamir,M,6,3305472,25751
25246,Xamora,F,6,3305478,25160
25247,Xandra,F,6,3305484,25700
25248,Xanti,M,6,3305490,25024
25249,Xaven,M,6,3305496,25954
25250,Xeno,M,6,3305502,25151
25251,Xiamora,F,6,3305508,25832
25252,Xienna,F,6,3305514,25849
25253,Xiomar,M,6,3305520,25870
25254,Xzaiver,M,6,3305526,25977
25255,Yaara,F,6,3305532,25289
25256,Yadhira,F,6,3305538,25435
25257,Yadvi,F,6,3305544,25871
25258,Yafa,F,6,3305550,25551
25259,Yahzir,M,6,3305556,25118
25260,Yailyn,F,6,3305562,25148
25261,Yaleni,F,6,3305568,25711
25262,Yalini,F,6,3305574,25133
25263,Yama,M,6,3305580,25736
25264,Yameen,M,6,3305586,25558
25265,Yamelin,F,6,3305592,25938
25266,Yamile,F,6,3305598,25504
25267,Yancy,F,6,3305604,25073
25268,Yanessa,F,6,3305610,25155
25269,Yardley,F,6,3305616,25474
25270,Yariela,F,6,3305622,25840
25271,Yarisbeth,F,6,3305628,25862
25272,Yarrow,F,6,3305634,25995
25273,Yasemin,F,6,3305640,25702
25274,Yashwin,M,6,3305646,25372
25275,Yaya,M,6,3305652,25953
25276,Yazleen,F,6,3305658,25019
25277,Yazlynn,F,6,3305664,25657
25278,Yefri,M,6,3305670,25340
25279,Yehonatan,M,6,3305676,25807
25280,Yeniel,M,6,3305682,25217
25281,Yeshia,F,6,3305688,25222
25282,Yigit,M,6,3305694,25823
25283,Yilia,F,6,3305700,25452
25284,Yireh,F,6,3305706,25415
25285,Yiseth,F,6,3305712,25407
25286,Yissel,F,6,3305718,25457
25287,Yixin,F,6,3305724,25610
25288,Yog,M,6,3305730,25810
25289,Yohanan,M,6,3305736,25746
25290,Yonael,M,6,3305742,25959
25291,Yoniel,M,6,3305748,25747
25292,Yordany,M,6,3305754,25068
25293,Yosiel,M,6,3305760,25761
25294,Yosohn,M,6,3305766,25473
25295,Yossef,M,6,3305772,25778
25296,Youcef,M,6,3305778,25753
25297,Yovanna,F,6,3305784,25324
25298,Yoyo,F,6,3305790,25813
25299,Yue,F,6,3305796,25817
25300,Yuhao,M,6,3305802,25490
25301,Yukari,F,6,3305808,25788
25302,Yukta,F,6,3305814,25274
25303,Yul,M,6,3305820,25819
25304,Yulianny,F,6,3305826,25201
25305,Yulitza,F,6,3305832,25644
25306,Yunay,M,6,3305838,25816
25307,Yuniel,M,6,3305844,25652
25308,Yura,F,6,3305850,25524
25309,Yurany,F,6,3305856,25357
25310,Yuritza,F,6,3305862,25014
25311,Yuyan,F,6,3305868,25927
25312,Yva,F,6,3305874,25838
25313,Zaada,F,6,3305880,25003
25314,Zabir,M,6,3305886,25444
25315,Zae,M,6,3305892,25599
25316,Zahia,F,6,3305898,25656
25317,Zahyir,M,6,3305904,25263
25318,Zaiel,M,6,3305910,25177
25319,Zakar,M,6,3305916,25072
25320,Zakaree,M,6,3305922,25472
25321,Zakkary,M,6,3305928,25202
25322,Zakyra,F,6,3305934,25208
25323,Zalaiyah,F,6,3305940,25510
25324,Zalan,M,6,3305946,25451
25325,Zalina,F,6,3305952,25537
25326,Zamaira,F,6,3305958,25522
25327,Zamariah,F,6,3305964,25328
25328,Zamarian,M,6,3305970,25247
25329,Zamariyah,F,6,3305976,25053
25330,Zameir,M,6,3305982,25365
25331,Zamian,M,6,3305988,25520
25332,Zamiere,M,6,3305994,25725
25333,Zamoni,F,6,3306000,25834
25334,Zanetta,F,6,3306006,25060
25335,Zaniel,M,6,3306012,25996
25336,Zaniylah,F,6,3306018,25481
25337,Zar,M,6,3306024,25111
25338,Zareena,F,6,3306030,25462
25339,Zarish,F,6,3306036,25139
25340,Zaviyah,F,6,3306042,25296
25341,Zaydrien,M,6,3306048,25784
25342,Zayir,M,6,3306054,25972
25343,Zaylor,M,6,3306060,25543
25344,Zedd,M,6,3306066,25298
25345,Zedric,M,6,3306072,25330
25346,Zeila,F,6,3306078,25211
25347,Zeily,F,6,3306084,25376
25348,Zendeya,F,6,3306090,25087
25349,Zeona,F,6,3306096,25353
25350,Zeppelyn,F,6,3306102,25250
25351,Zeremiah,M,6,3306108,25320
25352,Zerina,F,6,3306114,25839
25353,Zeva,F,6,3306120,25391
25354,Zevin,M,6,3306126,25008
25355,Zevyn,M,6,3306132,25666
25356,Zhanna,F,6,3306138,25951
25357,Zhayden,M,6,3306144,25731
25358,Zhia,F,6,3306150,25142
25359,Zhori,F,6,3306156,25847
25360,Zier,M,6,3306162,25052
25361,Zihan,M,6,3306168,25347
25362,Zilas,M,6,3306174,25919
25363,Zimere,M,6,3306180,25877
25364,Zimora,F,6,3306186,25506
25365,Zionah,F,6,3306192,25269
25366,Ziven,M,6,3306198,25545
25367,Zixin,F,6,3306204,25729
25368,Zixuan,M,6,3306210,25553
25369,Ziyu,M,6,3306216,25447
25370,Zniyah,F,6,3306222,25356
25371,Zoeigh,F,6,3306228,25923
25372,Zoeii,F,6,3306234,25373
25373,Zoejane,F,6,3306240,25626
25374,Zofie,F,6,3306246,25159
25375,Zohal,F,6,3306252,25326
25376,Zohara,F,6,3306258,25147
25377,Zolani,F,6,3306264,25173
25378,Zorielle,F,6,3306270,25064
25379,Zorya,F,6,3306276,25850
25380,Zubin,M,6,3306282,25246
25381,Zuley,F,6,3306288,25323
25382,Zully,F,6,3306294,25508
25383,Zuree,F,6,3306300,25492
25384,Zuriya,F,6,3306306,25933
25385,Zyel,M,6,3306312,25367
25386,Zyliah,F,6,3306318,25617
25387,Zymarion,M,6,3306324,25359
25388,Zyren,M,6,3306330,25623
25389,Aabha,F,5,3306335,25308
25390,Aadav,M,5,3306340,25131
25391,Aaditri,F,5,3306345,25295
25392,Aadiya,F,5,3306350,25405
25393,Aaila,F,5,3306355,25517
25394,Aailyah,F,5,3306360,25395
25395,Aalin,F,5,3306365,25220
25396,Aamaya,F,5,3306370,25152
25397,Aamiya,F,5,3306375,25461
25398,Aamoni,F,5,3306380,25665
25399,Aana,F,5,3306385,25550
25400,Aanay,M,5,3306390,25968
25401,Aarabella,F,5,3306395,25706
25402,Aaranya,F,5,3306400,25845
25403,Aarilyn,F,5,3306405,25686
25404,Aarini,F,5,3306410,25283
25405,Aasher,M,5,3306415,25563
25406,Aashrita,F,5,3306420,25503
25407,Aathira,F,5,3306425,25180
25408,Aatikah,F,5,3306430,25790
25409,Aavah,F,5,3306435,25760
25410,Aayaan,M,5,3306440,25234
25411,Aayah,F,5,3306445,25641
25412,Aayana,F,5,3306450,25878
25413,Abanoub,M,5,3306455,25034
25414,Abdelaziz,M,5,3306460,25564
25415,Abdelkareem,M,5,3306465,25978
25416,Abdiaziz,M,5,3306470,25900
25417,Abdikarim,M,5,3306475,25440
25418,Abdulelah,M,5,3306480,25911
25419,Abdulhameed,M,5,3306485,25733
25420,Abhik,M,5,3306490,25828
25421,Abia,F,5,3306495,25047
25422,Abiah,F,5,3306500,25081
25423,Abigal,F,5,3306505,25426
25424,Abisha,F,5,3306510,25846
25425,Abraam,M,5,3306515,25582
25426,Abriela,F,5,3306520,25285
25427,Abrina,F,5,3306525,25207
25428,Abryanna,F,5,3306530,25336
25429,Abubaker,M,5,3306535,25421
25430,Abuk,F,5,3306540,25487
25431,Abyssinia,F,5,3306545,25787
25432,Acai,M,5,3306550,25355
25433,Acari,F,5,3306555,25909
25434,Acea,M,5,3306560,25410
25435,Acel,M,5,3306565,25406
25436,Acire,M,5,3306570,25191
25437,Adae,F,5,3306575,25135
25438,Adaiya,F,5,3306580,25773
25439,Adal,M,5,3306585,25809
25440,Adaliene,F,5,3306590,25264
25441,Adallyn,F,5,3306595,25443
25442,Adalyse,F,5,3306600,25327
25443,Adana,F,5,3306605,25431
25444,Adante,M,5,3306610,25896
25445,Adassa,F,5,3306615,25986
25446,Adau,F,5,3306620,25694
25447,Addam,M,5,3306625,25827
25448,Addax,M,5,3306630,25825
25449,Addisin,F,5,3306635,25931
25450,Addylyn,F,5,3306640,25748
25451,Addysin,F,5,3306645,25993
25452,Adedamola,M,5,3306650,25309
25453,Adeeba,F,5,3306655,25437
25454,Adelaina,F,5,3306660,25279
25455,Adelani,F,5,3306665,25703
25456,Adelaya,F,5,3306670,25122
25457,Adelheide,F,5,3306675,25604
25458,Adeliah,F,5,3306680,25541
25459,Adelilah,F,5,3306685,25314
25460,Adelis,F,5,3306690,25310
25461,Adelya,F,5,3306695,25637
25462,Adenike,F,5,3306700,25949
25463,Adeniyi,M,5,3306705,25358
25464,Adesire,F,5,3306710,25172
25465,Adewale,M,5,3306715,25212
25466,Adhitya,M,5,3306720,25318
25467,Adiella,F,5,3306725,25985
25468,Adielle,F,5,3306730,25631
25469,Adileni,F,5,3306735,25229
25470,Adilson,M,5,3306740,25205
25471,Adis,M,5,3306745,25643
25472,Adisa,F,5,3306750,25685
25473,Adlin,F,5,3306755,25275
25474,Adly,M,5,3306760,25119
25475,Adnaan,M,5,3306765,25625
25476,Adolph,M,5,3306770,25883
25477,Adona,F,5,3306775,25224
25478,Adra,F,5,3306780,25471
25479,Adriell,M,5,3306785,25565
25480,Adris,M,5,3306790,25572
25481,Adrith,M,5,3306795,25869
25482,Adriyel,M,5,3306800,25442
25483,Adron,M,5,3306805,25648
25484,Advaithreddy,M,5,3306810,25802
25485,Advikreddy,M,5,3306815,25650
25486,Adwin,M,5,3306820,25143
25487,Adyen,M,5,3306825,25536
25488,Adylen,F,5,3306830,25007
25489,Aedin,M,5,3306835,25230
25490,Aegon,M,5,3306840,25100
25491,Aemelia,F,5,3306845,25381
25492,Aera,F,5,3306850,25893
25493,Aermias,M,5,3306855,25932
25494,Aethan,M,5,3306860,25206
25495,Aether,M,5,3306865,25120
25496,Aevah,F,5,3306870,25371
25497,Afeni,F,5,3306875,25187
25498,Affinity,F,5,3306880,25062
25499,Afonso,M,5,3306885,25749
25500,Agamjot,M,5,3306890,25714
25501,Agampreet,M,5,3306895,25705
25502,Aglaia,F,5,3306900,25571
25503,Agnessa,F,5,3306905,25815
25504,Ahdia,F,5,3306910,25450
25505,Ahinara,F,5,3306915,25695
25506,Ahlaiyah,F,5,3306920,25495
25507,Ahlanni,F,5,3306925,25402
25508,Ahlaysia,F,5,3306930,25348
25509,Ahlina,F,5,3306935,25149
25510,Ahlivia,F,5,3306940,25799
25511,Ahmeen,M,5,3306945,25988
25512,Ahmier,M,5,3306950,25767
25513,Ahmirah,F,5,3306955,25569
25514,Ahmoni,F,5,3306960,25775
25515,Ahnylah,F,5,3306965,25868
25516,Ahraya,F,5,3306970,25837
25517,Ahriana,F,5,3306975,25672
25518,Ahryah,F,5,3306980,25103
25519,Ahsad,M,5,3306985,25663
25520,Ahsir,M,5,3306990,25674
25521,Ahyaan,M,5,3306995,25598
25522,Ahyoka,F,5,3307000,25286
25523,Ahzaab,M,5,3307005,25343
25524,Aianna,F,5,3307010,25528
25525,Aibhlinn,F,5,3307015,25693
25526,Aidalyn,F,5,3307020,25360
25527,Aijah,F,5,3307025,25512
25528,Ailbe,M,5,3307030,25241
25529,Aileigh,F,5,3307035,25671
25530,Ailiana,F,5,3307040,25636
25531,Ailidh,F,5,3307045,25967
25532,Ailina,F,5,3307050,25720
25533,Aimara,F,5,3307055,25573
25534,Ainzley,F,5,3307060,25682
25535,Airiella,F,5,3307065,25271
25536,Airon,M,5,3307070,25804
25537,Aishat,F,5,3307075,25786
25538,Aisleen,F,5,3307080,25192
25539,Aissa,F,5,3307085,25794
25540,Aivan,M,5,3307090,25414
25541,Ajan,M,5,3307095,25058
25542,Ajaye,F,5,3307100,25584
25543,Ajournee,F,5,3307105,25156
25544,Ajournei,F,5,3307110,25664
25545,Ajourney,F,5,3307115,25679
25546,Akanksha,F,5,3307120,25167
25547,Akelah,F,5,3307125,25611
25548,Aker,M,5,3307130,25096
25549,Akiah,F,5,3307135,25464
25550,Akiel,M,5,3307140,25210
25551,Akiko,F,5,3307145,25337
25552,Akilles,M,5,3307150,25912
25553,Akire,F,5,3307155,25690
25554,Akorede,M,5,3307160,25489
25555,Akoya,F,5,3307165,25892
25556,Akshat,M,5,3307170,25199
25557,Akylie,F,5,3307175,25261
25558,Alai,F,5,3307180,25723
25559,Alaja,F,5,3307185,25311
25560,Alando,M,5,3307190,25897
25561,Alanood,F,5,3307195,25480
25562,Alathea,F,5,3307200,25070
25563,Alay,M,5,3307205,25646
25564,Alayaa,F,5,3307210,25198
25565,Alayja,F,5,3307215,25112
25566,Alazar,M,5,3307220,25033
25567,Alazay,F,5,3307225,25744
25568,Alber,M,5,3307230,25969
25569,Albertina,F,5,3307235,25835
25570,Aleali,F,5,3307240,25616
25571,Alecsander,M,5,3307245,25836
25572,Aleda,F,5,3307250,25399
25573,Aleemah,F,5,3307255,25027
25574,Aleighna,F,5,3307260,25265
25575,Alekai,M,5,3307265,25242
25576,Aleksej,M,5,3307270,25771
25577,Alelia,F,5,3307275,25253
25578,Aleria,F,5,3307280,25304
25579,Alexah,F,5,3307285,25086
25580,Alexandar,M,5,3307290,25673
25581,Alexanderjames,M,5,3307295,25722
25582,Alexandrya,F,5,3307300,25844
25583,Alexsa,F,5,3307305,25476
25584,Alexxander,M,5,3307310,25776
25585,Alexxis,F,5,3307315,25750
25586,Alexy,F,5,3307320,25698
25587,Alexzandra,F,5,3307325,25091
25588,Alford,M,5,3307330,25950
25589,Alian,M,5,3307335,25777
25590,Aliera,F,5,3307340,25059
25591,Aliia,F,5,3307345,25388
25592,Alilet,F,5,3307350,25378
25593,Alireza,M,5,3307355,25973
25594,Alisse,F,5,3307360,25366
25595,Alistaire,M,5,3307365,25121
25596,Alithia,F,5,3307370,25782
25597,Aliyar,M,5,3307375,25976
25598,Alizia,F,5,3307380,25755
25599,Aljawhara,F,5,3307385,25514
25600,Allaura,F,5,3307390,25963
25601,Allisen,F,5,3307395,25465
25602,Allona,F,5,3307400,25937
25603,Allysia,F,5,3307405,25453
25604,Almalik,M,5,3307410,25676
25605,Aloe,F,5,3307415,25638
25606,Alondyn,F,5,3307420,25254
25607,Alonie,F,5,3307425,25493
25608,Aluel,F,5,3307430,25302
25609,Alula,M,5,3307435,25630
25610,Alveena,F,5,3307440,25882
25611,Alvyn,M,5,3307445,25555
25612,Alwaleed,M,5,3307450,25037
25613,Alwin,M,5,3307455,25282
25614,Alyani,F,5,3307460,25890
25615,Alyda,F,5,3307465,25074
25616,Alyeska,F,5,3307470,25820
25617,Alyne,F,5,3307475,25434
25618,Alyssamarie,F,5,3307480,25126
25619,Alyxandra,F,5,3307485,25467
25620,Alyzabeth,F,5,3307490,25763
25621,Alyzza,F,5,3307495,25448
25622,Amaara,F,5,3307500,25051
25623,Amahd,M,5,3307505,25044
25624,Amahj,M,5,3307510,25653
25625,Amahle,F,5,3307515,25200
25626,Amaranta,F,5,3307520,25936
25627,Amarirose,F,5,3307525,25861
25628,Amartya,M,5,3307530,25284
25629,Amaurie,M,5,3307535,25964
25630,Amberlie,F,5,3307540,25542
25631,Ambla,F,5,3307545,25078
25632,Ambrie,F,5,3307550,25606
25633,Ambry,F,5,3307555,25812
25634,Ame,F,5,3307560,25857
25635,Amea,F,5,3307565,25708
25636,Amed,M,5,3307570,25029
25637,Amedeo,M,5,3307575,25419
25638,Ameeya,F,5,3307580,25361
25639,Ameiah,F,5,3307585,25956
25640,Amelle,F,5,3307590,25169
25641,Amerika,F,5,3307595,25203
25642,Amerius,M,5,3307600,25922
25643,Amiere,M,5,3307605,25038
25644,Amileo,M,5,3307610,25268
25645,Amiliya,F,5,3307615,25621
25646,Amillian,M,5,3307620,25867
25647,Amilliano,M,5,3307625,25422
25648,Amima,F,5,3307630,25822
25649,Aminatou,F,5,3307635,25249
25650,Amiriah,F,5,3307640,25413
25651,Amiyas,M,5,3307645,25852
25652,Amiyus,M,5,3307650,25252
25653,Amjed,M,5,3307655,25397
25654,Ammelia,F,5,3307660,25661
25655,Amnah,F,5,3307665,25738
25656,Amoriah,F,5,3307670,25428
25657,Amourah,F,5,3307675,25618
25658,Amoure,F,5,3307680,25370
25659,Amro,M,5,3307685,25924
25660,Amron,M,5,3307690,25765
25661,Amyre,M,5,3307695,25998
25662,Amyri,F,5,3307700,25990
25663,Amzi,M,5,3307705,25218
25664,Anaam,F,5,3307710,25576
25665,Anahii,F,5,3307715,25281
25666,Anahis,F,5,3307720,25004
25667,Anaile,F,5,3307725,25740
25668,Anaili,F,5,3307730,25236
25669,Anaizah,F,5,3307735,25549
25670,Anaka,F,5,3307740,25244
25671,Analese,F,5,3307745,25065
25672,Analisia,F,5,3307750,25589
25673,Analu,F,5,3307755,25982
25674,Analyce,F,5,3307760,25046
25675,Analyiah,F,5,3307765,25710
25676,Analyssa,F,5,3307770,25255
25677,Anamta,F,5,3307775,25713
25678,Anan,M,5,3307780,25754
25679,Anandi,F,5,3307785,25012
25680,Ananiya,M,5,3307790,25575
25681,Anarah,F,5,3307795,25385
25682,Anarely,F,5,3307800,25344
25683,Anavey,F,5,3307805,25374
25684,Anavia,F,5,3307810,25137
25685,Anayat,F,5,3307815,25888
25686,Anberlyn,F,5,3307820,25915
25687,Andjela,F,5,3307825,25266
25688,Andr,M,5,3307830,25579
25689,Andreah,F,5,3307835,25525
25690,Andreia,F,5,3307840,25526
25691,Andri,M,5,3307845,25945
25692,Andyn,M,5,3307850,25614
25693,Aneek,M,5,3307855,25140
25694,Aneisha,F,5,3307860,25163
25695,Anesia,F,5,3307865,25270
25696,Aneth,F,5,3307870,25577
25697,Anfa,F,5,3307875,25157
25698,Ange,M,5,3307880,25830
25699,Angelus,M,5,3307885,25179
25700,Angelyna,F,5,3307890,25146
25701,Anifer,F,5,3307895,25853
25702,Aniken,M,5,3307900,25332
25703,Aniv,M,5,3307905,25498
25704,Anivea,F,5,3307910,25943
25705,Aniyahlee,F,5,3307915,25926
25706,Anjani,F,5,3307920,25015
25707,Anjela,F,5,3307925,25441
25708,Anjelina,F,5,3307930,25077
25709,Anjolie,F,5,3307935,25294
25710,Ankita,F,5,3307940,25141
25711,Anmar,M,5,3307945,25645
25712,Annakay,F,5,3307950,25632
25713,Annalis,F,5,3307955,25651
25714,Annalys,F,5,3307960,25554
25715,Annalyssa,F,5,3307965,25916
25716,Annastacia,F,5,3307970,25944
25717,Anndee,F,5,3307975,25185
25718,Annelys,F,5,3307980,25209
25719,Annica,F,5,3307985,25758
25720,Annilee,F,5,3307990,25297
25721,Annisa,F,5,3307995,25824
25722,Annissa,F,5,3308000,25739
25723,Annleigh,F,5,3308005,25979
25724,Annley,F,5,3308010,25273
25725,Anona,F,5,3308015,25106
25726,Anri,M,5,3308020,25798
25727,Anslie,F,5,3308025,25466
25728,Ansony,M,5,3308030,25659
25729,Antigone,F,5,3308035,25544
25730,Antonin,M,5,3308040,25299
25731,Antonis,M,5,3308045,25876
25732,Antwaun,M,5,3308050,25981
25733,Anuoluwapo,F,5,3308055,25556
25734,Anuska,F,5,3308060,25811
25735,Anwen,F,5,3308065,25213
25736,Anyel,M,5,3308070,25425
25737,Anyelo,M,5,3308075,25039
25738,Anyra,F,5,3308080,25109
25739,Anyrah,F,5,3308085,25022
25740,Anze,M,5,3308090,25351
25741,Aoki,F,5,3308095,25597
25742,Aparna,F,5,3308100,25709
25743,Aprilia,F,5,3308105,25417
25744,Aqua,F,5,3308110,25055
25745,Aquarius,M,5,3308115,25107
25746,Aquil,M,5,3308120,25939
25747,Arabel,F,5,3308125,25108
25748,Araeyah,F,5,3308130,25042
25749,Aramay,F,5,3308135,25136
25750,Aravind,M,5,3308140,25735
25751,Arcadian,M,5,3308145,25620
25752,Archangel,M,5,3308150,25759
25753,Archy,M,5,3308155,25292
25754,Areia,F,5,3308160,25021
25755,Arelie,F,5,3308165,25538
25756,Aremi,F,5,3308170,25989
25757,Areni,F,5,3308175,25349
25758,Aretzi,F,5,3308180,25535
25759,Ariaha,F,5,3308185,25548
25760,Arialynn,F,5,3308190,25098
25761,Ariamae,F,5,3308195,25432
25762,Ariba,F,5,3308200,25345
25763,Aricela,F,5,3308205,25394
25764,Aricella,F,5,3308210,25688
25765,Aridai,F,5,3308215,25089
25766,Ariday,F,5,3308220,25114
25767,Arienne,F,5,3308225,25041
25768,Arieon,M,5,3308230,25898
25769,Arieya,F,5,3308235,25764
25770,Ariia,F,5,3308240,25113
25771,Arija,F,5,3308245,25894
25772,Arinzechukwu,M,5,3308250,25445
25773,Aristotelis,M,5,3308255,25233
25774,Aritzel,F,5,3308260,25962
25775,Ariyahna,F,5,3308265,25557
25776,Ariyona,F,5,3308270,25123
25777,Arlando,M,5,3308275,25071
25778,Arline,F,5,3308280,25420
25779,Armanie,F,5,3308285,25935
25780,Armany,M,5,3308290,25518
25781,Armel,M,5,3308295,25116
25782,Armondo,M,5,3308300,25050
25783,Armyah,F,5,3308305,25689
25784,Arorah,F,5,3308310,25124
25785,Aros,M,5,3308315,25379
25786,Aroura,F,5,3308320,25592
25787,Arra,F,5,3308325,25779
25788,Arraya,F,5,3308330,25496
25789,Arrius,M,5,3308335,25696
25790,Arryn,M,5,3308340,25301
25791,Arseny,M,5,3308345,25025
25792,Arshak,M,5,3308350,25267
25793,Arshawn,M,5,3308355,25001
25794,Arshith,M,5,3308360,25842
25795,Artiana,F,5,3308365,25574
25796,Arusha,F,5,3308370,25728
25797,Arvi,M,5,3308375,25801
25798,Arvind,M,5,3308380,25258
25799,Arwaa,F,5,3308385,25910
25800,Aryani,F,5,3308390,25851
25801,Arzoyi,F,5,3308395,25629
25802,Asadbek,M,5,3308400,25914
25803,Asami,F,5,3308405,25774
25804,Asan,M,5,3308410,25259
25805,Asana,F,5,3308415,25011
25806,Asanii,F,5,3308420,25313
25807,Asanti,F,5,3308425,25590
25808,Ashani,F,5,3308430,25529
25809,Ashkan,M,5,3308435,25093
25810,Ashleyn,F,5,3308440,25067
25811,Ashlinn,F,5,3308445,25048
25812,Asiana,F,5,3308450,25416
25813,Asrith,M,5,3308455,25570
25814,Assia,F,5,3308460,25880
25815,Assiah,M,5,3308465,25948
25816,Astyn,F,5,3308470,25547
25817,Atalaya,F,5,3308475,25523
25818,Ataly,F,5,3308480,25079
25819,Athenamarie,F,5,3308485,25488
25820,Athenia,F,5,3308490,25362
25821,Athenna,F,5,3308495,25905
25822,Athziry,F,5,3308500,25766
25823,Atika,F,5,3308505,25040
25824,Atiq,M,5,3308510,25727
25825,Atiyah,F,5,3308515,25874
25826,Atlanta,F,5,3308520,25272
25827,Atlys,F,5,3308525,25586
25828,Atreaus,M,5,3308530,25145
25829,Atrisa,F,5,3308535,25375
25830,Attila,M,5,3308540,25165
25831,Attlee,F,5,3308545,25411
25832,Atwood,M,5,3308550,25182
25833,Aubery,F,5,3308555,25341
25834,Aubrea,F,5,3308560,25102
25835,Aubreelynn,F,5,3308565,25104
25836,Aubren,F,5,3308570,25780
25837,Aubreyrose,F,5,3308575,25168
25838,Aubrynn,F,5,3308580,25800
25839,Audel,M,5,3308585,25486
25840,Audianna,F,5,3308590,25797
25841,Audiel,M,5,3308595,25176
25842,Audreanna,F,5,3308600,25781
25843,Audrik,M,5,3308605,25110
25844,Audrinna,F,5,3308610,25568
25845,Audun,M,5,3308615,25762
25846,Audy,M,5,3308620,25338
25847,Augustas,M,5,3308625,25633
25848,Aukai,M,5,3308630,25463
25849,Aulay,M,5,3308635,25942
25850,Auley,M,5,3308640,25865
25851,Aulii,F,5,3308645,25902
25852,Aunalee,F,5,3308650,25243
25853,Aunisty,F,5,3308655,25994
25854,Auree,F,5,3308660,25248
25855,Aurelien,M,5,3308665,25516
25856,Auriya,F,5,3308670,25971
25857,Aurorarose,F,5,3308675,25677
25858,Autry,M,5,3308680,25670
25859,Autumnn,F,5,3308685,25439
25860,Autym,F,5,3308690,25961
25861,Avaan,M,5,3308695,25132
25862,Avabelle,F,5,3308700,25768
25863,Avajean,F,5,3308705,25858
25864,Avajoy,F,5,3308710,25412
25865,Avalena,F,5,3308715,25863
25866,Avalie,F,5,3308720,25020
25867,Avalyna,F,5,3308725,25085
25868,Avander,M,5,3308730,25418
25869,Avantae,M,5,3308735,25899
25870,Avanti,F,5,3308740,25197
25871,Avareigh,F,5,3308745,25918
25872,Avarey,F,5,3308750,25952
25873,Avellina,F,5,3308755,25602
25874,Avenly,F,5,3308760,25668
25875,Aviannie,F,5,3308765,25928
25876,Avid,M,5,3308770,25712
25877,Aviela,F,5,3308775,25730
25878,Avighna,F,5,3308780,25398
25879,Avilynn,F,5,3308785,25999
25880,Avish,M,5,3308790,25612
25881,Aviyan,M,5,3308795,25866
25882,Avryn,M,5,3308800,25683
25883,Avyaansh,M,5,3308805,25162
25884,Awn,M,5,3308810,25082
25885,Axavier,M,5,3308815,25831
25886,Axen,M,5,3308820,25642
25887,Ayaaz,M,5,3308825,25045
25888,Ayako,F,5,3308830,25789
25889,Ayalguu,F,5,3308835,25507
25890,Ayara,F,5,3308840,25469
25891,Aydelin,F,5,3308845,25907
25892,Aydn,M,5,3308850,25400
25893,Ayin,M,5,3308855,25319
25894,Aylon,M,5,3308860,25875
25895,Aymar,F,5,3308865,25806
25896,Aymeric,M,5,3308870,25501
25897,Ayona,F,5,3308875,25097
25898,Ayoni,F,5,3308880,25227
25899,Ayonni,F,5,3308885,25429
25900,Ayriel,F,5,3308890,25805
25901,Ayrin,F,5,3308895,25917
25902,Ayten,F,5,3308900,25035
25903,Ayverie,F,5,3308905,25534
25904,Azair,M,5,3308910,25581
25905,Azaleya,F,5,3308915,25161
25906,Azania,F,5,3308920,25293
25907,Azariella,F,5,3308925,25329
25908,Azayden,M,5,3308930,25006
25909,Azealia,F,5,3308935,25257
25910,Azeemah,F,5,3308940,25369
25911,Azeeza,F,5,3308945,25921
25912,Azelea,F,5,3308950,25005
25913,Azelya,F,5,3308955,25955
25914,Azelynn,F,5,3308960,25178
25915,Azina,F,5,3308965,25389
25916,Azius,M,5,3308970,25662
25917,Aziylah,F,5,3308975,25533
25918,Azizbek,M,5,3308980,25901
25919,Azon,M,5,3308985,25291
25920,Azoriah,F,5,3308990,25390
25921,Azriah,M,5,3308995,25697
25922,Azuriah,M,5,3309000,25057
25923,Azylah,F,5,3309005,25997
25924,Azyra,F,5,3309010,25984
25925,Baba,M,5,3309015,25609
25926,Bach,M,5,3309020,25339
25927,Baelee,F,5,3309025,25521
25928,Baiden,M,5,3309030,25303
25929,Bair,M,5,3309035,25322
25930,Balen,M,5,3309040,25183
25931,Bannon,M,5,3309045,25228
25932,Bar,M,5,3309050,25904
25933,Baris,M,5,3309055,25970
25934,Barkon,M,5,3309060,25704
25935,Barlow,M,5,3309065,25245
25936,Barney,M,5,3309070,25743
25937,Bart,M,5,3309075,25363
25938,Bashar,M,5,3309080,25084
25939,Bassem,M,5,3309085,25509
25940,Bates,M,5,3309090,25741
25941,Bathsheba,F,5,3309095,25562
25942,Batoul,F,5,3309100,25808
25943,Baustin,M,5,3309105,25833
25944,Bayden,M,5,3309110,25237
25945,Bayoleth,F,5,3309115,25829
25946,Beacon,M,5,3309120,25423
25947,Bearen,M,5,3309125,25396
25948,Beatris,F,5,3309130,25061
25949,Beauen,M,5,3309135,25732
25950,Becks,M,5,3309140,25934
25951,Bekim,M,5,3309145,25491
25952,Belina,F,5,3309150,25386
25953,Bellaluna,F,5,3309155,25092
25954,Bellomy,M,5,3309160,25585
25955,Belma,F,5,3309165,25639
25956,Beltran,M,5,3309170,25607
25957,Benedicta,F,5,3309175,25219
25958,Benigno,M,5,3309180,25872
25959,Benjimen,M,5,3309185,25475
25960,Benjin,M,5,3309190,25225
25961,Benjy,M,5,3309195,25879
25962,Bentlie,M,5,3309200,25456
25963,Berend,M,5,3309205,25105
25964,Berklie,F,5,3309210,25032
25965,Bertin,M,5,3309215,25088
25966,Bess,F,5,3309220,25231
25967,Bessy,F,5,3309225,25384
25968,Betiel,F,5,3309230,25494
25969,Beto,M,5,3309235,25619
25970,Bette,F,5,3309240,25128
25971,Bettina,F,5,3309245,25859
25972,Betzabe,F,5,3309250,25433
25973,Bevin,F,5,3309255,25974
25974,Bhavik,M,5,3309260,25334
25975,Bhumika,F,5,3309265,25737
25976,Bisrat,M,5,3309270,25115
25977,Bivaan,M,5,3309275,25691
25978,Biviana,F,5,3309280,25884
25979,Blaiklee,F,5,3309285,25770
25980,Blaikley,F,5,3309290,25745
25981,Blakeney,F,5,3309295,25864
25982,Blaykleigh,F,5,3309300,25196
25983,Blesson,M,5,3309305,25814
25984,Blesyn,F,5,3309310,25992
25985,Blimie,F,5,3309315,25855
25986,Blitz,M,5,3309320,25483
25987,Boen,M,5,3309325,25232
25988,Bohdee,M,5,3309330,25010
25989,Boniface,M,5,3309335,25333
25990,Bonnibel,F,5,3309340,25188
25991,Bonny,F,5,3309345,25527
25992,Bowin,M,5,3309350,25860
25993,Bradee,F,5,3309355,25190
25994,Braesyn,M,5,3309360,25342
25995,Braiyah,F,5,3309365,25559
25996,Brandom,M,5,3309370,25701
25997,Branwen,F,5,3309375,25316
25998,Brany,F,5,3309380,25655
25999,Brayln,M,5,3309385,25223
26000,Braylynne,F,5,3309390,26829
26001,Breaker,M,5,3309395,26436
26002,Brealyn,F,5,3309400,26374
26003,Breckynn,F,5,3309405,26845
26004,Breez,M,5,3309410,26361
26005,Breigh,F,5,3309415,26826
26006,Breighlynn,F,5,3309420,26375
26007,Brekyn,M,5,3309425,26999
26008,Brenae,F,5,3309430,26632
26009,Brendy,F,5,3309435,26537
26010,Brennah,F,5,3309440,26355
26011,Brennyn,F,5,3309445,26274
26012,Brenson,M,5,3309450,26498
26013,Brentin,M,5,3309455,26443
26014,Brentyn,M,5,3309460,26232
26015,Breona,F,5,3309465,26750
26016,Breslynn,F,5,3309470,26699
26017,Breton,M,5,3309475,26366
26018,Brexli,F,5,3309480,26583
26019,Brextin,M,5,3309485,26251
26020,Breyanna,F,5,3309490,26409
26021,Breyonna,F,5,3309495,26846
26022,Brezlynn,F,5,3309500,26476
26023,Briceyda,F,5,3309505,26948
26024,Bricyn,M,5,3309510,26257
26025,Brieanna,F,5,3309515,26281
26026,Brielyn,F,5,3309520,26559
26027,Brig,M,5,3309525,26544
26028,Brigg,M,5,3309530,26844
26029,Brin,F,5,3309535,26610
26030,Brindley,F,5,3309540,26395
26031,Brink,M,5,3309545,26552
26032,Brinlea,F,5,3309550,26782
26033,Brinlyn,F,5,3309555,26741
26034,Brinnlee,F,5,3309560,26526
26035,Brio,M,5,3309565,26733
26036,Brisan,M,5,3309570,26642
26037,Briseidy,F,5,3309575,26238
26038,Britley,F,5,3309580,26572
26039,Britny,F,5,3309585,26172
26040,Brittanie,F,5,3309590,26468
26041,Brittin,F,5,3309595,26630
26042,Brittley,F,5,3309600,26178
26043,Brittlyn,F,5,3309605,26485
26044,Brityn,F,5,3309610,26751
26045,Brixxton,M,5,3309615,26339
26046,Briyan,M,5,3309620,26873
26047,Briyelle,F,5,3309625,26392
26048,Briyon,M,5,3309630,26130
26049,Brodin,M,5,3309635,26354
26050,Brodix,M,5,3309640,26622
26051,Bronc,M,5,3309645,26340
26052,Bronny,M,5,3309650,26686
26053,Bronsen,M,5,3309655,26678
26054,Brookley,F,5,3309660,26452
26055,Brox,M,5,3309665,26670
26056,Brycin,M,5,3309670,26181
26057,Brycyn,M,5,3309675,26740
26058,Bryndal,F,5,3309680,26593
26059,Brynlyn,F,5,3309685,26654
26060,Bryshon,M,5,3309690,26159
26061,Brysten,M,5,3309695,26970
26062,Bryten,M,5,3309700,26523
26063,Butch,M,5,3309705,26218
26064,Byran,M,5,3309710,26777
26065,Cadan,M,5,3309715,26587
26066,Caeleigh,F,5,3309720,26481
26067,Caelin,F,5,3309725,26071
26068,Cahari,M,5,3309730,26319
26069,Caidan,M,5,3309735,26518
26070,Caide,M,5,3309740,26806
26071,Caileb,M,5,3309745,26464
26072,Cailen,M,5,3309750,26993
26073,Caily,F,5,3309755,26212
26074,Cainin,M,5,3309760,26934
26075,Calandra,F,5,3309765,26121
26076,Calena,F,5,3309770,26390
26077,Calese,F,5,3309775,26695
26078,Caliel,M,5,3309780,26711
26079,Callaia,F,5,3309785,26915
26080,Calliana,F,5,3309790,26044
26081,Caloni,F,5,3309795,26098
26082,Calvert,M,5,3309800,26111
26083,Calvyn,M,5,3309805,26904
26084,Caly,F,5,3309810,26815
26085,Cambrey,F,5,3309815,26814
26086,Camdan,M,5,3309820,26651
26087,Cameria,F,5,3309825,26447
26088,Camira,F,5,3309830,26706
26089,Camorah,F,5,3309835,26432
26090,Camylah,F,5,3309840,26627
26091,Candis,F,5,3309845,26715
26092,Candler,M,5,3309850,26383
26093,Candor,M,5,3309855,26490
26094,Cannen,M,5,3309860,26004
26095,Cannyn,M,5,3309865,26283
26096,Canyla,F,5,3309870,26391
26097,Caralee,F,5,3309875,26791
26098,Cardale,M,5,3309880,26280
26099,Cardier,M,5,3309885,26869
26100,Careli,F,5,3309890,26620
26101,Cariyah,F,5,3309895,26794
26102,Carles,M,5,3309900,26613
26103,Carlita,F,5,3309905,26491
26104,Carmelle,F,5,3309910,26834
26105,Carmichael,M,5,3309915,26163
26106,Carmon,F,5,3309920,26307
26107,Carolay,F,5,3309925,26923
26108,Cartrell,M,5,3309930,26264
26109,Cartyr,M,5,3309935,26831
26110,Caruso,M,5,3309940,26265
26111,Caryn,F,5,3309945,26683
26112,Cashis,M,5,3309950,26353
26113,Cashten,M,5,3309955,26705
26114,Cassen,M,5,3309960,26305
26115,Cassiana,F,5,3309965,26142
26116,Cassy,F,5,3309970,26484
26117,Cataleah,F,5,3309975,26442
26118,Cataliya,F,5,3309980,26061
26119,Cathaleya,F,5,3309985,26575
26120,Catheryn,F,5,3309990,26384
26121,Cathrine,F,5,3309995,26039
26122,Cavalli,M,5,3310000,26250
26123,Caydien,M,5,3310005,26287
26124,Caylyn,F,5,3310010,26734
26125,Cayo,M,5,3310015,26096
26126,Ceana,F,5,3310020,26328
26127,Ceaser,M,5,3310025,26910
26128,Celaya,F,5,3310030,26618
26129,Celenia,F,5,3310035,26781
26130,Celise,F,5,3310040,26015
26131,Cella,F,5,3310045,26646
26132,Cely,F,5,3310050,26671
26133,Cera,F,5,3310055,26598
26134,Ceraphina,F,5,3310060,26141
26135,Cereniti,F,5,3310065,26460
26136,Cerulean,M,5,3310070,26563
26137,Cesare,M,5,3310075,26398
26138,Chaarvi,F,5,3310080,26658
26139,Chaden,M,5,3310085,26022
26140,Chadwin,M,5,3310090,26883
26141,Chaison,M,5,3310095,26506
26142,Chaitanya,M,5,3310100,26653
26143,Chaiya,F,5,3310105,26607
26144,Chalil,M,5,3310110,26875
26145,Chances,F,5,3310115,26109
26146,Chandon,M,5,3310120,26690
26147,Chanice,F,5,3310125,26046
26148,Chanler,M,5,3310130,26094
26149,Channah,F,5,3310135,26724
26150,Chanson,M,5,3310140,26867
26151,Chanston,M,5,3310145,26150
26152,Chari,F,5,3310150,26294
26153,Charizma,F,5,3310155,26746
26154,Charla,F,5,3310160,26808
26155,Charleson,M,5,3310165,26827
26156,Charlett,F,5,3310170,26240
26157,Charliann,F,5,3310175,26272
26158,Charlieann,F,5,3310180,26134
26159,Charlielynn,F,5,3310185,26679
26160,Chastyn,M,5,3310190,26259
26161,Chasyn,M,5,3310195,26672
26162,Cheikhahmadou,M,5,3310200,26278
26163,Cheney,M,5,3310205,26027
26164,Cherif,M,5,3310210,26946
26165,Cherise,F,5,3310215,26021
26166,Chesleigh,F,5,3310220,26624
26167,Chesni,F,5,3310225,26007
26168,Chessa,F,5,3310230,26687
26169,Chetan,M,5,3310235,26461
26170,Cheylee,F,5,3310240,26812
26171,Chez,M,5,3310245,26902
26172,Chicago,M,5,3310250,26054
26173,Chico,M,5,3310255,26836
26174,Chidimma,F,5,3310260,26691
26175,Chidozie,M,5,3310265,26541
26176,Chigozie,M,5,3310270,26969
26177,Chika,F,5,3310275,26980
26178,Chilton,M,5,3310280,26937
26179,Chimaobim,M,5,3310285,26342
26180,Chimbusomma,F,5,3310290,26947
26181,Chimebuka,M,5,3310295,26403
26182,Chinyere,F,5,3310300,26890
26183,Chistopher,M,5,3310305,26369
26184,Chiya,F,5,3310310,26852
26185,Chiyah,F,5,3310315,26209
26186,Chiyo,F,5,3310320,26101
26187,Chleo,F,5,3310325,26764
26188,Chloemarie,F,5,3310330,26049
26189,Chol,M,5,3310335,26297
26190,Chriss,M,5,3310340,26952
26191,Christionna,F,5,3310345,26731
26192,Christoper,M,5,3310350,26997
26193,Chrystina,F,5,3310355,26594
26194,Chukwuebuka,M,5,3310360,26199
26195,Churchill,M,5,3310365,26988
26196,Ciarra,F,5,3310370,26921
26197,Cici,F,5,3310375,26325
26198,Cicily,F,5,3310380,26341
26199,Ciella,F,5,3310385,26712
26200,Cinco,M,5,3310390,26115
26201,Cirel,F,5,3310395,26090
26202,Cjay,M,5,3310400,26308
26203,Clairissa,F,5,3310405,26929
26204,Claramae,F,5,3310410,26225
26205,Clarie,F,5,3310415,26146
26206,Clariza,F,5,3310420,26122
26207,Claudius,M,5,3310425,26235
26208,Cleon,M,5,3310430,26922
26209,Clever,M,5,3310435,26840
26210,Cliffton,M,5,3310440,26188
26211,Cloee,F,5,3310445,26589
26212,Coah,M,5,3310450,26737
26213,Cochise,M,5,3310455,26926
26214,Codee,F,5,3310460,26273
26215,Colesyn,M,5,3310465,26254
26216,Collis,M,5,3310470,26917
26217,Concepcion,F,5,3310475,26870
26218,Concetta,F,5,3310480,26066
26219,Conlyn,M,5,3310485,26567
26220,Connolly,F,5,3310490,26338
26221,Contessa,F,5,3310495,26285
26222,Cooke,M,5,3310500,26617
26223,Copelin,M,5,3310505,26716
26224,Coralai,F,5,3310510,26761
26225,Corbet,M,5,3310515,26865
26226,Cordai,M,5,3310520,26440
26227,Corde,M,5,3310525,26531
26228,Cordel,M,5,3310530,26562
26229,Cordellia,F,5,3310535,26895
26230,Corian,M,5,3310540,26324
26231,Cormick,M,5,3310545,26525
26232,Corrinne,F,5,3310550,26762
26233,Cresencio,M,5,3310555,26928
26234,Cristoval,M,5,3310560,26154
26235,Crown,M,5,3310565,26550
26236,Cruiz,M,5,3310570,26918
26237,Crystella,F,5,3310575,26892
26238,Cuban,M,5,3310580,26144
26239,Cyaire,M,5,3310585,26127
26240,Cybil,F,5,3310590,26399
26241,Cye,M,5,3310595,26769
26242,Cynia,F,5,3310600,26006
26243,Cyrah,F,5,3310605,26158
26244,Cyrena,F,5,3310610,26758
26245,Cyson,M,5,3310615,26689
26246,Daania,F,5,3310620,26723
26247,Daario,M,5,3310625,26300
26248,Dabney,F,5,3310630,26958
26249,Dacorey,M,5,3310635,26008
26250,Daedric,M,5,3310640,26114
26251,Daejah,F,5,3310645,26242
26252,Daeson,M,5,3310650,26760
26253,Daeton,M,5,3310655,26001
26254,Dagan,M,5,3310660,26657
26255,Dagmar,F,5,3310665,26077
26256,Dahmir,M,5,3310670,26396
26257,Daimian,M,5,3310675,26666
26258,Daine,M,5,3310680,26500
26259,Dair,M,5,3310685,26483
26260,Dairy,F,5,3310690,26655
26261,Daisi,F,5,3310695,26475
26262,Dajohn,M,5,3310700,26726
26263,Dakarion,M,5,3310705,26329
26264,Dakhi,M,5,3310710,26430
26265,Dakobe,M,5,3310715,26780
26266,Dalaiyah,F,5,3310720,26551
26267,Dalasia,F,5,3310725,26187
26268,Dalea,F,5,3310730,26938
26269,Daleen,F,5,3310735,26847
26270,Daleia,F,5,3310740,26311
26271,Dalessandro,M,5,3310745,26401
26272,Dalissa,F,5,3310750,26770
26273,Dallace,M,5,3310755,26529
26274,Dallana,F,5,3310760,26446
26275,Dallys,F,5,3310765,26851
26276,Daly,F,5,3310770,26675
26277,Damarco,M,5,3310775,26909
26278,Damarea,M,5,3310780,26603
26279,Damarri,M,5,3310785,26258
26280,Damauni,M,5,3310790,26302
26281,Damein,M,5,3310795,26581
26282,Dameion,M,5,3310800,26036
26283,Damiere,M,5,3310805,26696
26284,Damira,F,5,3310810,26388
26285,Damire,M,5,3310815,26217
26286,Damontay,M,5,3310820,26843
26287,Damyiah,F,5,3310825,26486
26288,Danaly,F,5,3310830,26894
26289,Danek,M,5,3310835,26995
26290,Daneli,F,5,3310840,26451
26291,Danell,M,5,3310845,26721
26292,Danelle,F,5,3310850,26880
26293,Danico,M,5,3310855,26105
26294,Danil,M,5,3310860,26986
26295,Danilyn,F,5,3310865,26062
26296,Danira,F,5,3310870,26838
26297,Danisa,F,5,3310875,26069
26298,Danity,F,5,3310880,26016
26299,Dannaly,F,5,3310885,26162
26300,Danneth,F,5,3310890,26032
26301,Dannica,F,5,3310895,26548
26302,Danzell,M,5,3310900,26813
26303,Danzig,M,5,3310905,26081
26304,Daouda,M,5,3310910,26270
26305,Daraly,F,5,3310915,26489
26306,Darelle,M,5,3310920,26197
26307,Dareon,M,5,3310925,26962
26308,Darie,F,5,3310930,26637
26309,Darionna,F,5,3310935,26825
26310,Dariyon,M,5,3310940,26000
26311,Darlen,F,5,3310945,26863
26312,Darlenne,F,5,3310950,26714
26313,Darriel,M,5,3310955,26592
26314,Darshini,F,5,3310960,26161
26315,Darwing,M,5,3310965,26752
26316,Daryna,F,5,3310970,26381
26317,Dashawna,F,5,3310975,26410
26318,Dashay,F,5,3310980,26365
26319,Daudi,M,5,3310985,26897
26320,Daury,M,5,3310990,26362
26321,Daveion,M,5,3310995,26059
26322,Daveyah,F,5,3311000,26148
26323,Davieon,M,5,3311005,26031
26324,Davies,M,5,3311010,26602
26325,Davika,F,5,3311015,26135
26326,Davinna,F,5,3311020,26748
26327,Daviona,F,5,3311025,26708
26328,Davonn,M,5,3311030,26560
26329,Dawon,M,5,3311035,26051
26330,Daxyn,M,5,3311040,26987
26331,Dayanni,F,5,3311045,26256
26332,Daylyn,M,5,3311050,26585
26333,Dayten,M,5,3311055,26694
26334,Dayven,M,5,3311060,26835
26335,Dcari,M,5,3311065,26083
26336,Deaja,F,5,3311070,26976
26337,Deajah,F,5,3311075,26455
26338,Deandrew,M,5,3311080,26882
26339,Deani,F,5,3311085,26739
26340,Deann,F,5,3311090,26487
26341,Dearrius,M,5,3311095,26153
26342,Decimus,M,5,3311100,26377
26343,Declen,M,5,3311105,26709
26344,Deekan,M,5,3311110,26415
26345,Deian,M,5,3311115,26047
26346,Deigo,M,5,3311120,26564
26347,Deily,F,5,3311125,26404
26348,Deimos,M,5,3311130,26967
26349,Dejay,M,5,3311135,26055
26350,Deka,F,5,3311140,26913
26351,Dekayla,F,5,3311145,26668
26352,Dekendrick,M,5,3311150,26612
26353,Delaiah,F,5,3311155,26727
26354,Delailah,F,5,3311160,26590
26355,Delali,F,5,3311165,26940
26356,Delaya,F,5,3311170,26874
26357,Delian,M,5,3311175,26535
26358,Delisa,F,5,3311180,26501
26359,Delisha,F,5,3311185,26488
26360,Delmi,F,5,3311190,26582
26361,Delphi,F,5,3311195,26749
26362,Delrico,M,5,3311200,26584
26363,Dema,F,5,3311205,26718
26364,Demanuel,M,5,3311210,26577
26365,Demarii,M,5,3311215,26793
26366,Demarri,M,5,3311220,26348
26367,Demeigh,F,5,3311225,26116
26368,Demetrie,M,5,3311230,26644
26369,Demontre,M,5,3311235,26833
26370,Demyri,F,5,3311240,26253
26371,Deniel,M,5,3311245,26474
26372,Denison,M,5,3311250,26759
26373,Denita,F,5,3311255,26684
26374,Denley,M,5,3311260,26785
26375,Denni,F,5,3311265,26676
26376,Dennys,M,5,3311270,26173
26377,Deondrae,M,5,3311275,26104
26378,Deondray,M,5,3311280,26433
26379,Derby,F,5,3311285,26753
26380,Derell,M,5,3311290,26626
26381,Derreck,M,5,3311295,26086
26382,Desaray,F,5,3311300,26586
26383,Destined,M,5,3311305,26042
26384,Destinie,F,5,3311310,26957
26385,Destinii,F,5,3311315,26898
26386,Deveraux,M,5,3311320,26040
26387,Devian,M,5,3311325,26400
26388,Devlynn,F,5,3311330,26184
26389,Devondre,M,5,3311335,26963
26390,Devonne,M,5,3311340,26241
26391,Devraj,M,5,3311345,26167
26392,Dewa,F,5,3311350,26222
26393,Dewaun,M,5,3311355,26805
26394,Dextyn,M,5,3311360,26692
26395,Deyan,M,5,3311365,26860
26396,Deyna,F,5,3311370,26634
26397,Deyvid,M,5,3311375,26857
26398,Dezariyah,F,5,3311380,26720
26399,Dezion,M,5,3311385,26648
26400,Deziray,F,5,3311390,26321
26401,Deziya,F,5,3311395,26722
26402,Dezlyn,F,5,3311400,26591
26403,Dezmin,M,5,3311405,26204
26404,Dezmyn,M,5,3311410,26565
26405,Dhanvin,M,5,3311415,26542
26406,Dharvi,F,5,3311420,26673
26407,Dhea,F,5,3311425,26463
26408,Dheeksha,F,5,3311430,26128
26409,Dhevan,M,5,3311435,26091
26410,Dhruvah,M,5,3311440,26509
26411,Dhvani,F,5,3311445,26605
26412,Dhwani,F,5,3311450,26428
26413,Dhylan,M,5,3311455,26965
26414,Dillen,M,5,3311460,26405
26415,Dillin,M,5,3311465,26182
26416,Dillynn,F,5,3311470,26516
26417,Dimarco,M,5,3311475,26171
26418,Dimari,M,5,3311480,26566
26419,Dionel,M,5,3311485,26456
26420,Dionis,M,5,3311490,26407
26421,Dionni,F,5,3311495,26702
26422,Dionysia,F,5,3311500,26060
26423,Diovanni,M,5,3311505,26930
26424,Dishan,M,5,3311510,26978
26425,Djenabou,F,5,3311515,26151
26426,Djoser,M,5,3311520,26899
26427,Dkota,M,5,3311525,26107
26428,Dlila,F,5,3311530,26728
26429,Dmani,M,5,3311535,26557
26430,Dmario,M,5,3311540,26073
26431,Dmauri,M,5,3311545,26580
26432,Dmichael,M,5,3311550,26951
26433,Dmiyah,F,5,3311555,26652
26434,Dniyah,F,5,3311560,26082
26435,Doaa,F,5,3311565,26246
26436,Dolce,F,5,3311570,26984
26437,Dominyk,M,5,3311575,26688
26438,Domnick,M,5,3311580,26402
26439,Donaldo,M,5,3311585,26520
26440,Dontavia,F,5,3311590,26364
26441,Dontaye,M,5,3311595,26667
26442,Dontray,M,5,3311600,26412
26443,Dontre,M,5,3311605,26336
26444,Donzell,M,5,3311610,26911
26445,Dorianna,F,5,3311615,26878
26446,Dorlan,M,5,3311620,26496
26447,Dougal,M,5,3311625,26207
26448,Dracarys,M,5,3311630,26828
26449,Drace,M,5,3311635,26431
26450,Draeson,M,5,3311640,26858
26451,Draison,M,5,3311645,26320
26452,Drayko,M,5,3311650,26853
26453,Draylin,M,5,3311655,26050
26454,Dreamy,F,5,3311660,26543
26455,Dreanna,F,5,3311665,26295
26456,Drennon,M,5,3311670,26682
26457,Dreon,M,5,3311675,26226
26458,Dreyah,F,5,3311680,26136
26459,Dria,F,5,3311685,26885
26460,Dries,M,5,3311690,26236
26461,Drina,F,5,3311695,26730
26462,Driti,F,5,3311700,26631
26463,Driver,M,5,3311705,26765
26464,Druv,M,5,3311710,26615
26465,Dryden,M,5,3311715,26413
26466,Duan,M,5,3311720,26931
26467,Duece,M,5,3311725,26382
26468,Durdona,F,5,3311730,26408
26469,Dustie,F,5,3311735,26817
26470,Dvorah,F,5,3311740,26665
26471,Dycen,M,5,3311745,26100
26472,Dylilah,F,5,3311750,26380
26473,Dylin,M,5,3311755,26437
26474,East,F,5,3311760,26949
26475,Eastlyn,F,5,3311765,26434
26476,Eaton,M,5,3311770,26043
26477,Ebin,M,5,3311775,26337
26478,Ebon,M,5,3311780,26982
26479,Ebubechukwu,M,5,3311785,26906
26480,Edengrace,F,5,3311790,26570
26481,Edina,F,5,3311795,26662
26482,Edoardo,M,5,3311800,26288
26483,Edonis,M,5,3311805,26810
26484,Edrei,M,5,3311810,26889
26485,Edrielle,F,5,3311815,26208
26486,Edsel,M,5,3311820,26977
26487,Eduarda,F,5,3311825,26787
26488,Ehani,F,5,3311830,26467
26489,Ehlani,F,5,3311835,26117
26490,Ehren,M,5,3311840,26472
26491,Eile,F,5,3311845,26656
26492,Einer,M,5,3311850,26966
26493,Eirini,F,5,3311855,26803
26494,Eisla,F,5,3311860,26568
26495,Eislee,F,5,3311865,26271
26496,Eislyn,F,5,3311870,26663
26497,Eizan,M,5,3311875,26080
26498,Ekansh,M,5,3311880,26202
26499,Eker,M,5,3311885,26854
26500,Ekin,M,5,3311890,26223
26501,Elahi,F,5,3311895,26417
26502,Elaiah,F,5,3311900,26868
26503,Elanah,F,5,3311905,26322
26504,Elanii,F,5,3311910,26024
26505,Elanni,F,5,3311915,26704
26506,Elannie,F,5,3311920,26301
26507,Elanny,F,5,3311925,26298
26508,Elanore,F,5,3311930,26088
26509,Elanur,F,5,3311935,26244
26510,Elaph,F,5,3311940,26357
26511,Elauna,F,5,3311945,26189
26512,Elayjah,F,5,3311950,26367
26513,Elbin,M,5,3311955,26205
26514,Eldan,M,5,3311960,26783
26515,Elenny,F,5,3311965,26092
26516,Elenoa,F,5,3311970,26571
26517,Elexander,M,5,3311975,26629
26518,Eleya,F,5,3311980,26540
26519,Eliann,M,5,3311985,26394
26520,Elianni,F,5,3311990,26373
26521,Eliciana,F,5,3311995,26511
26522,Elicio,M,5,3312000,26215
26523,Elijan,M,5,3312005,26315
26524,Elilta,F,5,3312010,26313
26525,Elinda,F,5,3312015,26821
26526,Eliodoro,M,5,3312020,26991
26527,Eliuth,M,5,3312025,26725
26528,Elizabel,F,5,3312030,26169
26529,Elizandra,F,5,3312035,26861
26530,Elizbeth,F,5,3312040,26140
26531,Elizebeth,F,5,3312045,26424
26532,Elky,F,5,3312050,26979
26533,Ellaann,F,5,3312055,26019
26534,Ellay,F,5,3312060,26131
26535,Elleen,F,5,3312065,26943
26536,Elleyna,F,5,3312070,26604
26537,Ellice,F,5,3312075,26596
26538,Ellicia,F,5,3312080,26901
26539,Ellieann,F,5,3312085,26183
26540,Elliejo,F,5,3312090,26418
26541,Ellieonna,F,5,3312095,26608
26542,Ellin,F,5,3312100,26636
26543,Ellisen,F,5,3312105,26942
26544,Ellivia,F,5,3312110,26974
26545,Elliyanah,F,5,3312115,26784
26546,Ellys,F,5,3312120,26599
26547,Ellyssa,F,5,3312125,26778
26548,Elmyra,F,5,3312130,26536
26549,Eloa,F,5,3312135,26545
26550,Elom,M,5,3312140,26309
26551,Elorie,F,5,3312145,26099
26552,Elouisa,F,5,3312150,26482
26553,Elpidio,M,5,3312155,26527
26554,Else,F,5,3312160,26839
26555,Elsee,F,5,3312165,26303
26556,Elta,F,5,3312170,26123
26557,Elyce,F,5,3312175,26093
26558,Elye,M,5,3312180,26125
26559,Elysha,F,5,3312185,26643
26560,Elyzah,F,5,3312190,26996
26561,Emaria,F,5,3312195,26809
26562,Emauri,M,5,3312200,26206
26563,Emaza,F,5,3312205,26841
26564,Emberlea,F,5,3312210,26729
26565,Embrii,F,5,3312215,26955
26566,Emelda,F,5,3312220,26334
26567,Emerii,F,5,3312225,26255
26568,Emeris,M,5,3312230,26886
26569,Emiliarose,F,5,3312235,26953
26570,Emilo,M,5,3312240,26343
26571,Emine,F,5,3312245,26229
26572,Emiree,F,5,3312250,26994
26573,Emmaclaire,F,5,3312255,26335
26574,Emmalyse,F,5,3312260,26772
26575,Emmaree,F,5,3312265,26299
26576,Emmeri,F,5,3312270,26237
26577,Emmerly,F,5,3312275,26912
26578,Emmilyne,F,5,3312280,26422
26579,Emmori,F,5,3312285,26175
26580,Emogene,F,5,3312290,26157
26581,Emonei,F,5,3312295,26293
26582,Emora,F,5,3312300,26349
26583,Emrynn,F,5,3312305,26771
26584,Emryss,F,5,3312310,26200
26585,Emsleigh,F,5,3312315,26677
26586,Emya,F,5,3312320,26038
26587,Emyla,F,5,3312325,26316
26588,Endrick,M,5,3312330,26638
26589,Eneri,F,5,3312335,26756
26590,Enes,M,5,3312340,26513
26591,Eniel,M,5,3312345,26070
26592,Enio,M,5,3312350,26347
26593,Enis,M,5,3312355,26522
26594,Enki,M,5,3312360,26085
26595,Ennis,M,5,3312365,26848
26596,Enok,M,5,3312370,26133
26597,Enylah,F,5,3312375,26261
26598,Epifanio,M,5,3312380,26459
26599,Eponine,F,5,3312385,26755
26600,Erfan,M,5,3312390,26465
26601,Erie,F,5,3312395,26799
26602,Eriifeoluwa,F,5,3312400,26304
26603,Eriyan,F,5,3312405,26954
26604,Erkhes,M,5,3312410,26649
26605,Ernestine,F,5,3312415,26203
26606,Errion,M,5,3312420,26499
26607,Erum,F,5,3312425,26925
26608,Eryck,M,5,3312430,26538
26609,Eryss,F,5,3312435,26621
26610,Esaie,M,5,3312440,26891
26611,Esaul,M,5,3312445,26113
26612,Esbeidy,F,5,3312450,26448
26613,Esco,M,5,3312455,26260
26614,Eshawn,M,5,3312460,26556
26615,Eslie,F,5,3312465,26534
26616,Esmira,F,5,3312470,26453
26617,Esmond,M,5,3312475,26744
26618,Esrael,M,5,3312480,26876
26619,Essi,F,5,3312485,26067
26620,Estephan,M,5,3312490,26674
26621,Estin,M,5,3312495,26429
26622,Estiven,M,5,3312500,26640
26623,Eswin,M,5,3312505,26479
26624,Ethereal,F,5,3312510,26087
26625,Ethiel,M,5,3312515,26713
26626,Ethon,M,5,3312520,26037
26627,Ettore,M,5,3312525,26776
26628,Euri,F,5,3312530,26439
26629,Evabella,F,5,3312535,26871
26630,Evabelle,F,5,3312540,26641
26631,Evalani,F,5,3312545,26314
26632,Evaley,F,5,3312550,26372
26633,Evalie,F,5,3312555,26445
26634,Evalyna,F,5,3312560,26595
26635,Evalyne,F,5,3312565,26239
26636,Evalyse,F,5,3312570,26213
26637,Evanelle,F,5,3312575,26623
26638,Evangelene,F,5,3312580,26332
26639,Evangelin,F,5,3312585,26186
26640,Evangelyne,F,5,3312590,26170
26641,Evanny,F,5,3312595,26035
26642,Evanshi,F,5,3312600,26547
26643,Evelinn,F,5,3312605,26421
26644,Evelyngrace,F,5,3312610,26903
26645,Eveny,F,5,3312615,26379
26646,Everlygrace,F,5,3312620,26792
26647,Evertt,M,5,3312625,26323
26648,Eviee,F,5,3312630,26493
26649,Evielynn,F,5,3312635,26097
26650,Evolett,F,5,3312640,26824
26651,Evva,F,5,3312645,26139
26652,Evyenia,F,5,3312650,26074
26653,Exander,M,5,3312655,26470
26654,Eylul,F,5,3312660,26927
26655,Ezai,M,5,3312665,26406
26656,Ezaiah,M,5,3312670,26619
26657,Ezell,M,5,3312675,26371
26658,Eziyah,M,5,3312680,26423
26659,Ezmi,F,5,3312685,26738
26660,Faatima,F,5,3312690,26145
26661,Fabiel,M,5,3312695,26579
26662,Fabiha,F,5,3312700,26192
26663,Faelan,M,5,3312705,26095
26664,Fairy,F,5,3312710,26855
26665,Faithful,F,5,3312715,26798
26666,Faizon,M,5,3312720,26020
26667,Fajar,F,5,3312725,26609
26668,Falicity,F,5,3312730,26306
26669,Fallou,M,5,3312735,26932
26670,Faolan,M,5,3312740,26478
26671,Faraj,M,5,3312745,26788
26672,Farhana,F,5,3312750,26179
26673,Farheen,F,5,3312755,26660
26674,Farishta,F,5,3312760,26998
26675,Farrell,M,5,3312765,26458
26676,Farzona,F,5,3312770,26504
26677,Fathima,F,5,3312775,26837
26678,Fatouma,F,5,3312780,26276
26679,Fayez,M,5,3312785,26180
26680,Fe,F,5,3312790,26573
26681,Fedra,F,5,3312795,26196
26682,Felicitas,F,5,3312800,26466
26683,Femi,F,5,3312805,26842
26684,Fenna,F,5,3312810,26956
26685,Fenway,M,5,3312815,26819
26686,Fenyx,M,5,3312820,26639
26687,Fergie,F,5,3312825,26950
26688,Filiberto,M,5,3312830,26058
26689,Finbarr,M,5,3312835,26680
26690,Fincher,M,5,3312840,26625
26691,Fineas,M,5,3312845,26387
26692,Finnic,M,5,3312850,26164
26693,Fira,F,5,3312855,26026
26694,Fitzroy,M,5,3312860,26732
26695,Flash,M,5,3312865,26515
26696,Florin,M,5,3312870,26645
26697,Forbes,M,5,3312875,26893
26698,Fotima,F,5,3312880,26045
26699,Franca,F,5,3312885,26546
26700,Francie,F,5,3312890,26345
26701,Frandy,M,5,3312895,26795
26702,Frankly,M,5,3312900,26939
26703,Freddrick,M,5,3312905,26719
26704,Frederica,F,5,3312910,26330
26705,Frederico,M,5,3312915,26985
26706,Freidy,F,5,3312920,26138
26707,Froilan,M,5,3312925,26975
26708,Fuller,M,5,3312930,26296
26709,Gabrielly,F,5,3312935,26378
26710,Gabryela,F,5,3312940,26252
26711,Gad,M,5,3312945,26152
26712,Gagan,M,5,3312950,26973
26713,Galaxie,F,5,3312955,26717
26714,Gallagher,M,5,3312960,26588
26715,Gamila,F,5,3312965,26076
26716,Gannicus,M,5,3312970,26416
26717,Gariel,M,5,3312975,26981
26718,Garv,M,5,3312980,26628
26719,Garvey,M,5,3312985,26419
26720,Garyn,M,5,3312990,26275
26721,Gayle,F,5,3312995,26120
26722,Gedaliah,M,5,3313000,26508
26723,Gedeon,M,5,3313005,26014
26724,Gelena,F,5,3313010,26441
26725,Genavie,F,5,3313015,26231
26726,Genessy,F,5,3313020,26435
26727,Genie,F,5,3313025,26964
26728,Genisys,F,5,3313030,26971
26729,Genuine,M,5,3313035,26519
26730,Geordan,M,5,3313040,26444
26731,Georgiamae,F,5,3313045,26221
26732,Geovannie,M,5,3313050,26820
26733,Gershom,M,5,3313055,26333
26734,Gertie,F,5,3313060,26992
26735,Geselle,F,5,3313065,26961
26736,Gethsemani,F,5,3313070,26009
26737,Ghadeer,F,5,3313075,26102
26738,Ghael,M,5,3313080,26555
26739,Ghislaine,F,5,3313085,26386
26740,Gianelli,F,5,3313090,26359
26741,Gianina,F,5,3313095,26358
26742,Giannina,F,5,3313100,26351
26743,Gianno,M,5,3313105,26517
26744,Giannys,F,5,3313110,26945
26745,Gibbs,M,5,3313115,26600
26746,Gifti,F,5,3313120,26616
26747,Gildardo,M,5,3313125,26959
26748,Giovonnie,M,5,3313130,26578
26749,Giuliani,M,5,3313135,26786
26750,Givanna,F,5,3313140,26286
26751,Glorie,F,5,3313145,26165
26752,Goodness,F,5,3313150,26137
26753,Gorden,M,5,3313155,26773
26754,Gowtham,M,5,3313160,26766
26755,Gracieann,F,5,3313165,26224
26756,Gracielynn,F,5,3313170,26576
26757,Graysun,M,5,3313175,26510
26758,Greatness,M,5,3313180,26356
26759,Greggory,M,5,3313185,26905
26760,Greison,M,5,3313190,26754
26761,Greyer,M,5,3313195,26914
26762,Greyleigh,F,5,3313200,26850
26763,Greylin,F,5,3313205,26177
26764,Greylyn,M,5,3313210,26149
26765,Grigor,M,5,3313215,26856
26766,Grisham,M,5,3313220,26554
26767,Guido,M,5,3313225,26866
26768,Guliana,F,5,3313230,26075
26769,Guransh,M,5,3313235,26972
26770,Gurnaaz,F,5,3313240,26661
26771,Gursahib,M,5,3313245,26360
26772,Gursimran,F,5,3313250,26064
26773,Haadia,F,5,3313255,26420
26774,Haaheo,M,5,3313260,26079
26775,Hadalynn,F,5,3313265,26211
26776,Haddy,F,5,3313270,26659
26777,Hadilynn,F,5,3313275,26269
26778,Hadlyn,F,5,3313280,26700
26779,Haezel,F,5,3313285,26112
26780,Haggard,M,5,3313290,26346
26781,Haidee,F,5,3313295,26018
26782,Haidon,M,5,3313300,26063
26783,Haikeem,M,5,3313305,26025
26784,Haines,M,5,3313310,26350
26785,Haizlie,F,5,3313315,26126
26786,Hajoon,M,5,3313320,26742
26787,Halaya,F,5,3313325,26747
26788,Haleemah,F,5,3313330,26017
26789,Halid,M,5,3313335,26193
26790,Halil,M,5,3313340,26389
26791,Halimatou,F,5,3313345,26707
26792,Hameed,M,5,3313350,26056
26793,Hamidah,F,5,3313355,26574
26794,Hamnah,F,5,3313360,26601
26795,Hamzeh,M,5,3313365,26129
26796,Hanae,F,5,3313370,26664
26797,Hanay,F,5,3313375,26757
26798,Hannahrose,F,5,3313380,26185
26799,Hannalee,F,5,3313385,26681
26800,Harbin,M,5,3313390,26879
26801,Hareer,F,5,3313395,26864
26802,Harika,F,5,3313400,26243
26803,Harker,M,5,3313405,26888
26804,Harlene,F,5,3313410,26132
26805,Harleyrose,F,5,3313415,26908
26806,Harly,F,5,3313420,26227
26807,Harout,M,5,3313425,26944
26808,Harvie,F,5,3313430,26438
26809,Hasana,F,5,3313435,26220
26810,Hasen,M,5,3313440,26884
26811,Hasenat,F,5,3313445,26282
26812,Hassani,M,5,3313450,26106
26813,Hathaway,F,5,3313455,26872
26814,Hatteras,F,5,3313460,26450
26815,Hattiemae,F,5,3313465,26210
26816,Hau,F,5,3313470,26736
26817,Haukea,F,5,3313475,26633
26818,Havynn,F,5,3313480,26933
26819,Hawah,F,5,3313485,26312
26820,Hayaa,F,5,3313490,26370
26821,Haydar,M,5,3313495,26767
26822,Hayle,F,5,3313500,26800
26823,Haysel,F,5,3313505,26376
26824,Hayyan,M,5,3313510,26028
26825,Hazellynn,F,5,3313515,26317
26826,Hazlie,F,5,3313520,26267
26827,Heavenlyjoy,F,5,3313525,26775
26828,Heera,F,5,3313530,26052
26829,Heiden,M,5,3313535,26248
26830,Heiley,F,5,3313540,26768
26831,Hein,M,5,3313545,26005
26832,Heir,M,5,3313550,26053
26833,Helal,M,5,3313555,26176
26834,Helder,M,5,3313560,26606
26835,Helio,M,5,3313565,26147
26836,Hemingway,M,5,3313570,26029
26837,Henessy,F,5,3313575,26495
26838,Henli,F,5,3313580,26920
26839,Henon,M,5,3313585,26801
26840,Henric,M,5,3313590,26503
26841,Herberth,M,5,3313595,26789
26842,Heri,M,5,3313600,26228
26843,Hermajesty,F,5,3313605,26816
26844,Hermelinda,F,5,3313610,26693
26845,Hernando,M,5,3313615,26426
26846,Hesham,M,5,3313620,26669
26847,Hestia,F,5,3313625,26289
26848,Hetansh,M,5,3313630,26119
26849,Hettie,F,5,3313635,26710
26850,Hetvik,M,5,3313640,26310
26851,Hezeki,M,5,3313645,26881
26852,Hezikiah,M,5,3313650,26528
26853,Hibaq,F,5,3313655,26900
26854,Hiero,M,5,3313660,26084
26855,Hilah,F,5,3313665,26284
26856,Hilani,F,5,3313670,26427
26857,Hilo,M,5,3313675,26034
26858,Hinckley,F,5,3313680,26823
26859,Hollan,M,5,3313685,26896
26860,Hollee,F,5,3313690,26230
26861,Hosna,F,5,3313695,26290
26862,Hossein,M,5,3313700,26862
26863,Hrach,M,5,3313705,26796
26864,Hud,M,5,3313710,26990
26865,Hudhayfah,M,5,3313715,26469
26866,Hue,M,5,3313720,26078
26867,Humna,F,5,3313725,26041
26868,Hurain,F,5,3313730,26103
26869,Husnain,M,5,3313735,26811
26870,Hussien,M,5,3313740,26507
26871,Hyab,F,5,3313745,26743
26872,Hylee,F,5,3313750,26887
26873,Iah,F,5,3313755,26216
26874,Ianis,M,5,3313760,26462
26875,Ibby,F,5,3313765,26263
26876,Ibeth,F,5,3313770,26003
26877,Ibtihaj,F,5,3313775,26352
26878,Icaro,M,5,3313780,26647
26879,Idalee,F,5,3313785,26530
26880,Idella,F,5,3313790,26701
26881,Idhant,M,5,3313795,26411
26882,Iesha,F,5,3313800,26924
26883,Ifeoma,F,5,3313805,26859
26884,Ifra,F,5,3313810,26279
26885,Ihsaan,M,5,3313815,26168
26886,Ikeem,M,5,3313820,26156
26887,Ikora,F,5,3313825,26514
26888,Ilaisaane,F,5,3313830,26033
26889,Ilaya,F,5,3313835,26494
26890,Ilda,F,5,3313840,26011
26891,Ileigh,F,5,3313845,26072
26892,Iliah,F,5,3313850,26685
26893,Ilie,M,5,3313855,26245
26894,Ilinca,F,5,3313860,26023
26895,Ilyane,M,5,3313865,26195
26896,Ilyn,F,5,3313870,26502
26897,Imagine,F,5,3313875,26449
26898,Imanii,F,5,3313880,26266
26899,Imarion,M,5,3313885,26292
26900,Imer,M,5,3313890,26214
26901,Indianna,F,5,3313895,26344
26902,Indio,M,5,3313900,26198
26903,Infant,M,5,3313905,26611
26904,Ingram,M,5,3313910,26569
26905,Inman,M,5,3313915,26936
26906,Innocent,M,5,3313920,26326
26907,Inshirah,F,5,3313925,26393
26908,Ioan,M,5,3313930,26291
26909,Iola,F,5,3313935,26118
26910,Iori,M,5,3313940,26553
26911,Irah,M,5,3313945,26779
26912,Irany,F,5,3313950,26558
26913,Iranzi,M,5,3313955,26907
26914,Iretomiwa,M,5,3313960,26477
26915,Irianna,F,5,3313965,26174
26916,Iron,M,5,3313970,26849
26917,Irya,F,5,3313975,26521
26918,Iryss,F,5,3313980,26983
26919,Isabellagrace,F,5,3313985,26457
26920,Isahi,M,5,3313990,26614
26921,Isaiha,M,5,3313995,26268
26922,Isair,M,5,3314000,26549
26923,Isam,M,5,3314005,26697
26924,Isauro,M,5,3314010,26201
26925,Isbel,F,5,3314015,26089
26926,Isbella,F,5,3314020,26108
26927,Ishir,M,5,3314025,26941
26928,Ishitha,F,5,3314030,26247
26929,Ishrat,F,5,3314035,26057
26930,Isidra,F,5,3314040,26473
26931,Isioma,F,5,3314045,26234
26932,Islamae,F,5,3314050,26763
26933,Islie,F,5,3314055,26935
26934,Islom,M,5,3314060,26539
26935,Isma,F,5,3314065,26318
26936,Issela,F,5,3314070,26968
26937,Itiya,F,5,3314075,26960
26938,Itsuki,M,5,3314080,26797
26939,Itzuri,F,5,3314085,26277
26940,Ivaniel,M,5,3314090,26385
26941,Ivansh,M,5,3314095,26262
26942,Ivanshika,F,5,3314100,26807
26943,Ives,M,5,3314105,26989
26944,Ivionna,F,5,3314110,26512
26945,Ivree,F,5,3314115,26327
26946,Ivri,M,5,3314120,26818
26947,Ivymae,F,5,3314125,26166
26948,Iwalani,F,5,3314130,26916
26949,Iyahna,F,5,3314135,26480
26950,Iyani,F,5,3314140,26397
26951,Iyanni,F,5,3314145,26425
26952,Izaiha,M,5,3314150,26030
26953,Izalia,F,5,3314155,26524
26954,Izarra,F,5,3314160,26160
26955,Izaura,F,5,3314165,26650
26956,Izek,M,5,3314170,26233
26957,Izela,F,5,3314175,26561
26958,Izla,F,5,3314180,26190
26959,Izra,F,5,3314185,26698
26960,Izzak,M,5,3314190,26745
26961,Izzi,F,5,3314195,26822
26962,Jaad,M,5,3314200,26877
26963,Jaana,F,5,3314205,26010
26964,Jaaron,M,5,3314210,26703
26965,Jabarri,M,5,3314215,26143
26966,Jabel,M,5,3314220,26219
26967,Jabori,M,5,3314225,26065
26968,Jabrayah,F,5,3314230,26635
26969,Jabraylon,M,5,3314235,26249
26970,Jabrea,F,5,3314240,26363
26971,Jabreel,M,5,3314245,26533
26972,Jacayla,F,5,3314250,26013
26973,Jaceson,M,5,3314255,26331
26974,Jacier,M,5,3314260,26110
26975,Jacinth,M,5,3314265,26124
26976,Jackman,M,5,3314270,26790
26977,Jadagrace,F,5,3314275,26454
26978,Jadalise,F,5,3314280,26194
26979,Jadarian,M,5,3314285,26368
26980,Jadarose,F,5,3314290,26830
26981,Jaderose,F,5,3314295,26068
26982,Jadonis,M,5,3314300,26735
26983,Jador,M,5,3314305,26155
26984,Jady,F,5,3314310,26492
26985,Jaecob,M,5,3314315,26774
26986,Jaelanii,F,5,3314320,26597
26987,Jaelei,F,5,3314325,26497
26988,Jaella,F,5,3314330,26505
26989,Jaely,F,5,3314335,26191
26990,Jaemarie,F,5,3314340,26532
26991,Jahaad,M,5,3314345,26804
26992,Jahana,F,5,3314350,26471
26993,Jahar,M,5,3314355,26832
26994,Jaharri,M,5,3314360,26012
26995,Jahdani,M,5,3314365,26919
26996,Jahleah,F,5,3314370,26802
26997,Jahmiel,M,5,3314375,26002
26998,Jahnai,M,5,3314380,26048
26999,Jahnessa,F,5,3314385,26414
27000,Jahnyla,F,5,3314390,27399
27001,Jahquan,M,5,3314395,27492
27002,Jahrell,M,5,3314400,27616
27003,Jahsan,M,5,3314405,27484
27004,Jahshua,M,5,3314410,27520
27005,Jahson,M,5,3314415,27132
27006,Jahvonni,M,5,3314420,27118
27007,Jaicyon,M,5,3314425,27067
27008,Jaidee,F,5,3314430,27600
27009,Jaidin,M,5,3314435,27747
27010,Jaileah,F,5,3314440,27385
27011,Jailiyah,F,5,3314445,27920
27012,Jaily,F,5,3314450,27756
27013,Jaimi,F,5,3314455,27054
27014,Jaine,F,5,3314460,27081
27015,Jainil,M,5,3314465,27677
27016,Jairen,M,5,3314470,27657
27017,Jaise,M,5,3314475,27678
27018,Jaislyn,F,5,3314480,27459
27019,Jaislynn,F,5,3314485,27300
27020,Jaiyce,M,5,3314490,27806
27021,Jaiyon,M,5,3314495,27333
27022,Jakaree,M,5,3314500,27995
27023,Jakarii,M,5,3314505,27570
27024,Jakaylin,F,5,3314510,27163
27025,Jakell,M,5,3314515,27334
27026,Jaken,M,5,3314520,27604
27027,Jakenzie,F,5,3314525,27873
27028,Jakia,F,5,3314530,27608
27029,Jakobee,M,5,3314535,27200
27030,Jakobii,M,5,3314540,27594
27031,Jakolby,M,5,3314545,27353
27032,Jaksen,M,5,3314550,27974
27033,Jakylah,F,5,3314555,27315
27034,Jakyree,M,5,3314560,27282
27035,Jalai,F,5,3314565,27280
27036,Jalaila,F,5,3314570,27812
27037,Jaleen,M,5,3314575,27332
27038,Jaleena,F,5,3314580,27202
27039,Jaleeya,F,5,3314585,27885
27040,Jaleiya,F,5,3314590,27107
27041,Jalila,F,5,3314595,27351
27042,Jalitza,F,5,3314600,27225
27043,Jalyrica,F,5,3314605,27913
27044,Jamael,M,5,3314610,27977
27045,Jamahl,M,5,3314615,27868
27046,Jameison,M,5,3314620,27555
27047,Jamera,F,5,3314625,27804
27048,Jameshenry,M,5,3314630,27770
27049,Jamesson,M,5,3314635,27349
27050,Jamieon,M,5,3314640,27618
27051,Jamilette,F,5,3314645,27096
27052,Jamirr,M,5,3314650,27470
27053,Jamorie,M,5,3314655,27936
27054,Jamyrah,F,5,3314660,27553
27055,Jamyri,F,5,3314665,27888
27056,Janaiyah,F,5,3314670,27830
27057,Janalee,F,5,3314675,27133
27058,Janavi,F,5,3314680,27019
27059,Jance,M,5,3314685,27838
27060,Janea,F,5,3314690,27276
27061,Janelli,F,5,3314695,27852
27062,Janessah,F,5,3314700,27441
27063,Janicia,F,5,3314705,27228
27064,Jannet,F,5,3314710,27754
27065,Janus,M,5,3314715,27803
27066,Janzen,M,5,3314720,27236
27067,Japnoor,F,5,3314725,27863
27068,Jaquel,M,5,3314730,27947
27069,Jarielis,F,5,3314735,27670
27070,Jarielys,F,5,3314740,27642
27071,Jarin,M,5,3314745,27886
27072,Jarmaine,M,5,3314750,27996
27073,Jarquez,M,5,3314755,27370
27074,Jaryiah,F,5,3314760,27268
27075,Jasa,F,5,3314765,27154
27076,Jasaan,M,5,3314770,27183
27077,Jashley,F,5,3314775,27115
27078,Jasilyn,F,5,3314780,27639
27079,Jasion,M,5,3314785,27491
27080,Jaskirat,F,5,3314790,27805
27081,Jasmeen,F,5,3314795,27683
27082,Jasmeet,F,5,3314800,27260
27083,Jasreet,F,5,3314805,27894
27084,Jassir,M,5,3314810,27899
27085,Jatzibe,F,5,3314815,27192
27086,Javarious,M,5,3314820,27914
27087,Javeion,M,5,3314825,27823
27088,Javell,M,5,3314830,27611
27089,Javeyon,M,5,3314835,27131
27090,Javius,M,5,3314840,27105
27091,Jawaun,M,5,3314845,27152
27092,Jaxden,M,5,3314850,27821
27093,Jaxdyn,M,5,3314855,27500
27094,Jaxs,M,5,3314860,27179
27095,Jaycyn,M,5,3314865,27680
27096,Jaydaliz,F,5,3314870,27074
27097,Jaydalynn,F,5,3314875,27550
27098,Jaydis,M,5,3314880,27436
27099,Jaydriel,M,5,3314885,27413
27100,Jayel,M,5,3314890,27835
27101,Jayion,M,5,3314895,27233
27102,Jaykon,M,5,3314900,27496
27103,Jaylanee,F,5,3314905,27014
27104,Jaylea,F,5,3314910,27486
27105,Jayleana,F,5,3314915,27851
27106,Jayley,F,5,3314920,27658
27107,Jaylis,F,5,3314925,27979
27108,Jaylise,F,5,3314930,27429
27109,Jayma,F,5,3314935,27585
27110,Jaymarie,F,5,3314940,27564
27111,Jaynelle,F,5,3314945,27973
27112,Jayoni,F,5,3314950,27798
27113,Jayro,M,5,3314955,27262
27114,Jaysin,M,5,3314960,27929
27115,Jaysson,M,5,3314965,27752
27116,Jazael,M,5,3314970,27365
27117,Jazai,M,5,3314975,27468
27118,Jazalyn,F,5,3314980,27734
27119,Jazayla,F,5,3314985,27505
27120,Jazzlene,F,5,3314990,27364
27121,Jazzmyne,F,5,3314995,27162
27122,Jb,M,5,3315000,27503
27123,Jeanny,F,5,3315005,27148
27124,Jedidah,F,5,3315010,27153
27125,Jehieli,F,5,3315015,27720
27126,Jehsiah,M,5,3315020,27790
27127,Jehziel,M,5,3315025,27991
27128,Jeiden,M,5,3315030,27654
27129,Jeilany,F,5,3315035,27247
27130,Jeloni,M,5,3315040,27569
27131,Jemarion,M,5,3315045,27971
27132,Jemia,F,5,3315050,27302
27133,Jemuel,M,5,3315055,27989
27134,Jenah,F,5,3315060,27078
27135,Jenalee,F,5,3315065,27184
27136,Jenasys,F,5,3315070,27774
27137,Jenavive,F,5,3315075,27172
27138,Jenayah,F,5,3315080,27317
27139,Jency,F,5,3315085,27826
27140,Jendayi,F,5,3315090,27717
27141,Jenessis,F,5,3315095,27994
27142,Jenessy,F,5,3315100,27540
27143,Jeniffer,F,5,3315105,27836
27144,Jenin,F,5,3315110,27648
27145,Jenine,F,5,3315115,27778
27146,Jenisa,F,5,3315120,27849
27147,Jeniya,F,5,3315125,27472
27148,Jennell,F,5,3315130,27278
27149,Jenoah,M,5,3315135,27581
27150,Jenova,F,5,3315140,27834
27151,Jensi,F,5,3315145,27744
27152,Jenzen,M,5,3315150,27832
27153,Jeorge,M,5,3315155,27919
27154,Jeovani,M,5,3315160,27466
27155,Jephte,M,5,3315165,27359
27156,Jerahmeel,M,5,3315170,27619
27157,Jereck,M,5,3315175,27474
27158,Jered,M,5,3315180,27739
27159,Jerek,M,5,3315185,27416
27160,Jeremey,M,5,3315190,27990
27161,Jeremmy,M,5,3315195,27872
27162,Jermarcus,M,5,3315200,27087
27163,Jerrad,M,5,3315205,27020
27164,Jerrik,M,5,3315210,27944
27165,Jerzei,F,5,3315215,27726
27166,Jesed,M,5,3315220,27916
27167,Jeselle,F,5,3315225,27188
27168,Jesley,F,5,3315230,27308
27169,Jeslynn,F,5,3315235,27012
27170,Jessamae,F,5,3315240,27310
27171,Jessen,M,5,3315245,27404
27172,Jessilyn,F,5,3315250,27077
27173,Jesusmanuel,M,5,3315255,27992
27174,Jeswitha,F,5,3315260,27613
27175,Jevaughn,M,5,3315265,27000
27176,Jeveah,F,5,3315270,27335
27177,Jevonte,M,5,3315275,27523
27178,Jewelia,F,5,3315280,27862
27179,Jex,M,5,3315285,27924
27180,Jeycob,M,5,3315290,27935
27181,Jeyli,F,5,3315295,27128
27182,Jeysen,M,5,3315300,27535
27183,Jhaleel,M,5,3315305,27743
27184,Jhan,M,5,3315310,27811
27185,Jhenae,F,5,3315315,27450
27186,Jhoel,M,5,3315320,27021
27187,Jhournei,F,5,3315325,27791
27188,Jiada,F,5,3315330,27661
27189,Jiajun,M,5,3315335,27508
27190,Jiale,M,5,3315340,27961
27191,Jiarui,M,5,3315345,27481
27192,Jiavonna,F,5,3315350,27713
27193,Jiaying,F,5,3315355,27814
27194,Jibraeel,M,5,3315360,27822
27195,Jiel,M,5,3315365,27954
27196,Jimir,M,5,3315370,27238
27197,Jino,M,5,3315375,27591
27198,Jion,M,5,3315380,27361
27199,Jiovonni,M,5,3315385,27966
27200,Jirah,M,5,3315390,27430
27201,Jissel,F,5,3315395,27405
27202,Jivan,M,5,3315400,27463
27203,Jlayah,F,5,3315405,27177
27204,Jnayah,F,5,3315410,27197
27205,Joali,F,5,3315415,27733
27206,Joaneliz,F,5,3315420,27343
27207,Joany,F,5,3315425,27255
27208,Joc,M,5,3315430,27101
27209,Jocee,F,5,3315435,27234
27210,Jocelynne,F,5,3315440,27902
27211,Jocko,M,5,3315445,27903
27212,Jodye,M,5,3315450,27801
27213,Joeleen,F,5,3315455,27845
27214,Joelynn,F,5,3315460,27382
27215,Joeziah,M,5,3315465,27068
27216,Johnlee,M,5,3315470,27983
27217,Johnnathan,M,5,3315475,27850
27218,Johnrobert,M,5,3315480,27065
27219,Johnryan,M,5,3315485,27693
27220,Johnse,M,5,3315490,27079
27221,Joia,F,5,3315495,27175
27222,Joiner,M,5,3315500,27159
27223,Jolianna,F,5,3315505,27809
27224,Joliet,F,5,3315510,27442
27225,Joliette,F,5,3315515,27656
27226,Joliyah,F,5,3315520,27193
27227,Jonahel,M,5,3315525,27384
27228,Jonalyn,F,5,3315530,27215
27229,Jonan,M,5,3315535,27647
27230,Joncarlo,M,5,3315540,27342
27231,Jondriel,M,5,3315545,27218
27232,Joniya,F,5,3315550,27113
27233,Jonmichael,M,5,3315555,27665
27234,Jontez,M,5,3315560,27736
27235,Jonziel,M,5,3315565,27857
27236,Joory,F,5,3315570,27055
27237,Jora,F,5,3315575,27895
27238,Jorell,M,5,3315580,27242
27239,Josaih,M,5,3315585,27828
27240,Josan,M,5,3315590,27456
27241,Josanna,F,5,3315595,27263
27242,Josedavid,M,5,3315600,27498
27243,Josefa,F,5,3315605,27537
27244,Joselina,F,5,3315610,27354
27245,Joshia,M,5,3315615,27506
27246,Joshiah,M,5,3315620,27420
27247,Joshue,M,5,3315625,27870
27248,Josianna,F,5,3315630,27303
27249,Jossilyn,F,5,3315635,27707
27250,Josuan,M,5,3315640,27538
27251,Joules,F,5,3315645,27208
27252,Journy,F,5,3315650,27130
27253,Jovaniel,M,5,3315655,27546
27254,Jovannie,M,5,3315660,27023
27255,Jovante,M,5,3315665,27142
27256,Joviana,F,5,3315670,27281
27257,Jovianna,F,5,3315675,27779
27258,Jovonnie,M,5,3315680,27621
27259,Joyann,F,5,3315685,27531
27260,Joycee,F,5,3315690,27031
27261,Joye,F,5,3315695,27690
27262,Jozelynn,F,5,3315700,27951
27263,Jozy,F,5,3315705,27239
27264,Jsiah,M,5,3315710,27270
27265,Juanmiguel,M,5,3315715,27556
27266,Judit,F,5,3315720,27198
27267,Judsen,M,5,3315725,27212
27268,Juels,M,5,3315730,27937
27269,Julee,F,5,3315735,27615
27270,Julene,F,5,3315740,27473
27271,Juliane,F,5,3315745,27205
27272,Juliarose,F,5,3315750,27380
27273,Jullie,F,5,3315755,27479
27274,Junhao,M,5,3315760,27980
27275,Juniel,M,5,3315765,27298
27276,Junpei,M,5,3315770,27792
27277,Junxi,M,5,3315775,27923
27278,Juriah,M,5,3315780,27735
27279,Jussiah,M,5,3315785,27781
27280,Justicee,F,5,3315790,27549
27281,Justino,M,5,3315795,27138
27282,Jveon,M,5,3315800,27417
27283,Jylan,M,5,3315805,27098
27284,Jyren,M,5,3315810,27046
27285,Jystice,F,5,3315815,27181
27286,Kaanan,M,5,3315820,27595
27287,Kabel,M,5,3315825,27837
27288,Kache,M,5,3315830,27946
27289,Kacion,M,5,3315835,27053
27290,Kadidia,F,5,3315840,27217
27291,Kadidja,F,5,3315845,27279
27292,Kadiel,M,5,3315850,27674
27293,Kadince,F,5,3315855,27646
27294,Kaecyn,M,5,3315860,27170
27295,Kaelah,F,5,3315865,27139
27296,Kaelei,F,5,3315870,27392
27297,Kaelynne,F,5,3315875,27371
27298,Kaesin,M,5,3315880,27509
27299,Kaetlyn,F,5,3315885,27962
27300,Kaevion,M,5,3315890,27671
27301,Kahil,M,5,3315895,27272
27302,Kahleb,M,5,3315900,27082
27303,Kahleo,M,5,3315905,27445
27304,Kahri,F,5,3315910,27552
27305,Kaicey,F,5,3315915,27032
27306,Kaicyn,M,5,3315920,27879
27307,Kaidynn,M,5,3315925,27291
27308,Kaile,F,5,3315930,27543
27309,Kaileena,F,5,3315935,27173
27310,Kailynne,F,5,3315940,27010
27311,Kaimi,M,5,3315945,27596
27312,Kaimora,F,5,3315950,27330
27313,Kainani,F,5,3315955,27740
27314,Kainoah,M,5,3315960,27395
27315,Kainyn,M,5,3315965,27598
27316,Kaiona,F,5,3315970,27663
27317,Kaionna,F,5,3315975,27650
27318,Kairan,M,5,3315980,27584
27319,Kaisey,F,5,3315985,27251
27320,Kaislie,F,5,3315990,27785
27321,Kaity,F,5,3315995,27889
27322,Kaivalya,M,5,3316000,27943
27323,Kaivan,M,5,3316005,27631
27324,Kaize,M,5,3316010,27301
27325,Kaje,M,5,3316015,27577
27326,Kajus,M,5,3316020,27127
27327,Kalais,M,5,3316025,27563
27328,Kalayiah,F,5,3316030,27337
27329,Kalden,M,5,3316035,27906
27330,Kalees,F,5,3316040,27194
27331,Kaleeyah,F,5,3316045,27769
27332,Kaleiya,F,5,3316050,27171
27333,Kalese,F,5,3316055,27451
27334,Kalicia,F,5,3316060,27614
27335,Kalief,M,5,3316065,27056
27336,Kaliko,M,5,3316070,27223
27337,Kalim,M,5,3316075,27285
27338,Kalino,M,5,3316080,27213
27339,Kaliq,M,5,3316085,27825
27340,Kalirae,F,5,3316090,27134
27341,Kalisha,F,5,3316095,27601
27342,Kaliyanei,F,5,3316100,27030
27343,Kallel,M,5,3316105,27002
27344,Kallin,M,5,3316110,27762
27345,Kalob,M,5,3316115,27286
27346,Kalonji,M,5,3316120,27454
27347,Kalyan,M,5,3316125,27759
27348,Kalylah,F,5,3316130,27941
27349,Kalysta,F,5,3316135,27043
27350,Kamariana,F,5,3316140,27846
27351,Kameah,F,5,3316145,27949
27352,Kamelah,F,5,3316150,27341
27353,Kamello,M,5,3316155,27698
27354,Kamera,F,5,3316160,27869
27355,Kameria,F,5,3316165,27243
27356,Kamiera,F,5,3316170,27918
27357,Kamilyah,F,5,3316175,27755
27358,Kamina,F,5,3316180,27017
27359,Kamp,M,5,3316185,27360
27360,Kamyrn,F,5,3316190,27453
27361,Kaniel,M,5,3316195,27772
27362,Kaniela,M,5,3316200,27545
27363,Kanishka,F,5,3316205,27063
27364,Kaon,M,5,3316210,27800
27365,Kapree,F,5,3316215,27048
27366,Kaprice,F,5,3316220,27562
27367,Karalina,F,5,3316225,27049
27368,Kardier,M,5,3316230,27146
27369,Karie,F,5,3316235,27293
27370,Karimah,F,5,3316240,27627
27371,Karlene,F,5,3316245,27259
27372,Karmina,F,5,3316250,27323
27373,Karmoni,F,5,3316255,27400
27374,Karriem,M,5,3316260,27001
27375,Karron,M,5,3316265,27037
27376,Karslyn,F,5,3316270,27034
27377,Kartar,M,5,3316275,27060
27378,Kartell,M,5,3316280,27387
27379,Kary,F,5,3316285,27548
27380,Karyssa,F,5,3316290,27250
27381,Kasaan,M,5,3316295,27462
27382,Kasem,M,5,3316300,27483
27383,Kashia,F,5,3316305,27376
27384,Kashmeir,M,5,3316310,27723
27385,Kasian,M,5,3316315,27075
27386,Kaslyn,F,5,3316320,27059
27387,Kass,M,5,3316325,27114
27388,Kassious,M,5,3316330,27214
27389,Kassy,F,5,3316335,27925
27390,Katalayah,F,5,3316340,27425
27391,Katalinna,F,5,3316345,27136
27392,Kateleigh,F,5,3316350,27292
27393,Katelina,F,5,3316355,27266
27394,Katey,F,5,3316360,27874
27395,Kathrynne,F,5,3316365,27532
27396,Katina,F,5,3316370,27861
27397,Katiya,F,5,3316375,27168
27398,Katniss,F,5,3316380,27409
27399,Katurah,F,5,3316385,27782
27400,Kauri,M,5,3316390,27378
27401,Kaveah,F,5,3316395,27565
27402,Kaveri,F,5,3316400,27178
27403,Kavia,F,5,3316405,27093
27404,Kavina,F,5,3316410,27403
27405,Kaviyah,F,5,3316415,27029
27406,Kawelo,M,5,3316420,27768
27407,Kaybrie,F,5,3316425,27530
27408,Kaycei,F,5,3316430,27289
27409,Kaycion,M,5,3316435,27305
27410,Kayleanna,F,5,3316440,27042
27411,Kayliee,F,5,3316445,27296
27412,Kayliyah,F,5,3316450,27542
27413,Kaymon,M,5,3316455,27725
27414,Kayo,M,5,3316460,27700
27415,Kayoir,F,5,3316465,27684
27416,Kayona,F,5,3316470,27207
27417,Kayren,M,5,3316475,27586
27418,Kaysun,M,5,3316480,27882
27419,Kayzleigh,F,5,3316485,27737
27420,Kazee,M,5,3316490,27644
27421,Kazimierz,M,5,3316495,27437
27422,Keajah,F,5,3316500,27381
27423,Kebron,M,5,3316505,27265
27424,Keegen,M,5,3316510,27750
27425,Keeleigh,F,5,3316515,27930
27426,Keelynn,F,5,3316520,27009
27427,Keenon,M,5,3316525,27311
27428,Keevah,F,5,3316530,27222
27429,Keevon,M,5,3316535,27719
27430,Kehaulani,F,5,3316540,27909
27431,Keiana,F,5,3316545,27904
27432,Keidon,M,5,3316550,27347
27433,Keihlani,F,5,3316555,27104
27434,Keilian,M,5,3316560,27373
27435,Keilynn,F,5,3316565,27476
27436,Keimy,F,5,3316570,27319
27437,Keimya,F,5,3316575,27686
27438,Kein,M,5,3316580,27143
27439,Keinan,M,5,3316585,27760
27440,Keirstyn,F,5,3316590,27558
27441,Keiryn,F,5,3316595,27893
27442,Kekai,M,5,3316600,27900
27443,Kelaia,F,5,3316605,27355
27444,Kelanni,F,5,3316610,27620
27445,Kelany,F,5,3316615,27559
27446,Kelil,M,5,3316620,27464
27447,Kely,F,5,3316625,27165
27448,Kelynn,F,5,3316630,27327
27449,Kemiah,F,5,3316635,27544
27450,Kemon,M,5,3316640,27283
27451,Kemp,M,5,3316645,27103
27452,Kenari,F,5,3316650,27190
27453,Kendrah,F,5,3316655,27109
27454,Kendrixx,M,5,3316660,27398
27455,Kendryx,M,5,3316665,27244
27456,Keni,F,5,3316670,27765
27457,Keniah,F,5,3316675,27497
27458,Kenil,M,5,3316680,27875
27459,Kenisha,F,5,3316685,27593
27460,Kenlea,F,5,3316690,27675
27461,Kennidee,F,5,3316695,27597
27462,Kenniel,M,5,3316700,27219
27463,Kennison,F,5,3316705,27412
27464,Kennley,F,5,3316710,27998
27465,Kennsley,F,5,3316715,27574
27466,Kentaro,M,5,3316720,27186
27467,Kenten,M,5,3316725,27448
27468,Kentlee,F,5,3316730,27185
27469,Keny,M,5,3316735,27426
27470,Kenyata,M,5,3316740,27070
27471,Kenyla,F,5,3316745,27402
27472,Kenz,F,5,3316750,27866
27473,Kenzel,M,5,3316755,27856
27474,Kenzey,F,5,3316760,27687
27475,Kenzye,F,5,3316765,27645
27476,Kerenza,F,5,3316770,27504
27477,Kerielle,F,5,3316775,27518
27478,Kerissa,F,5,3316780,27340
27479,Kerra,F,5,3316785,27758
27480,Kerrianna,F,5,3316790,27156
27481,Keshvi,F,5,3316795,27818
27482,Kessley,F,5,3316800,27038
27483,Ketch,M,5,3316805,27512
27484,Ketcher,M,5,3316810,27617
27485,Kevani,M,5,3316815,27112
27486,Kevaughn,M,5,3316820,27465
27487,Kevia,F,5,3316825,27290
27488,Kevian,M,5,3316830,27275
27489,Kevonna,F,5,3316835,27271
27490,Kevontay,M,5,3316840,27526
27491,Keyanni,F,5,3316845,27997
27492,Keyleen,F,5,3316850,27709
27493,Keylianis,F,5,3316855,27269
27494,Keylianiz,F,5,3316860,27840
27495,Keylon,M,5,3316865,27057
27496,Keymoni,M,5,3316870,27643
27497,Keymora,F,5,3316875,27025
27498,Keyshaun,M,5,3316880,27331
27499,Khadeejah,F,5,3316885,27623
27500,Khadyn,M,5,3316890,27905
27501,Khaire,M,5,3316895,27246
27502,Khalanie,F,5,3316900,27883
27503,Khalanii,F,5,3316905,27455
27504,Khalayah,F,5,3316910,27741
27505,Khaleil,M,5,3316915,27706
27506,Khaley,F,5,3316920,27478
27507,Khalyse,F,5,3316925,27547
27508,Khamilah,F,5,3316930,27799
27509,Khania,F,5,3316935,27295
27510,Kharie,F,5,3316940,27716
27511,Kharla,F,5,3316945,27438
27512,Kharley,F,5,3316950,27583
27513,Kharmen,F,5,3316955,27499
27514,Khavia,F,5,3316960,27612
27515,Khawla,F,5,3316965,27345
27516,Khelil,M,5,3316970,27440
27517,Khian,M,5,3316975,27495
27518,Khiari,F,5,3316980,27414
27519,Khiem,M,5,3316985,27689
27520,Khila,F,5,3316990,27273
27521,Khilyn,F,5,3316995,27926
27522,Khiya,F,5,3317000,27237
27523,Khlaya,F,5,3317005,27871
27524,Kholten,M,5,3317010,27123
27525,Kholton,M,5,3317015,27855
27526,Khosen,M,5,3317020,27636
27527,Khyle,M,5,3317025,27638
27528,Khyliah,F,5,3317030,27248
27529,Khylil,M,5,3317035,27897
27530,Khylo,M,5,3317040,27435
27531,Khyran,M,5,3317045,27681
27532,Khyzen,M,5,3317050,27659
27533,Kiahna,F,5,3317055,27313
27534,Kianah,F,5,3317060,27350
27535,Kianu,M,5,3317065,27605
27536,Kielynn,F,5,3317070,27669
27537,Kierah,F,5,3317075,27793
27538,Kilah,F,5,3317080,27950
27539,Kile,M,5,3317085,27516
27540,Killari,F,5,3317090,27144
27541,Killiam,M,5,3317095,27210
27542,Killyan,M,5,3317100,27915
27543,Kiloni,F,5,3317105,27592
27544,Kimiah,F,5,3317110,27274
27545,Kimmie,F,5,3317115,27957
27546,Kimo,M,5,3317120,27091
27547,Kimon,M,5,3317125,27419
27548,Kimura,F,5,3317130,27572
27549,Kinari,F,5,3317135,27649
27550,Kingamir,M,5,3317140,27284
27551,Kingzley,M,5,3317145,27880
27552,Kinkade,M,5,3317150,27911
27553,Kinnon,M,5,3317155,27753
27554,Kino,M,5,3317160,27241
27555,Kinsly,F,5,3317165,27922
27556,Kinzly,F,5,3317170,27579
27557,Kiomara,F,5,3317175,27080
27558,Kiora,F,5,3317180,27254
27559,Kiowa,M,5,3317185,27630
27560,Kiree,M,5,3317190,27120
27561,Kiron,M,5,3317195,27477
27562,Kirsi,F,5,3317200,27058
27563,Kirstin,F,5,3317205,27958
27564,Kisa,F,5,3317210,27524
27565,Kiyani,F,5,3317215,27467
27566,Kiyen,M,5,3317220,27099
27567,Kiyla,F,5,3317225,27160
27568,Kiylan,M,5,3317230,27394
27569,Kiylee,F,5,3317235,27457
27570,Kiylen,M,5,3317240,27006
27571,Kiyra,F,5,3317245,27045
27572,Kla,F,5,3317250,27525
27573,Klint,M,5,3317255,27795
27574,Kloni,F,5,3317260,27807
27575,Knighton,M,5,3317265,27891
27576,Knixon,M,5,3317270,27767
27577,Knori,F,5,3317275,27169
27578,Ko,M,5,3317280,27396
27579,Koast,M,5,3317285,27858
27580,Koffi,M,5,3317290,27710
27581,Koleston,M,5,3317295,27746
27582,Kollyn,F,5,3317300,27141
27583,Kommon,M,5,3317305,27702
27584,Konway,M,5,3317310,27635
27585,Kopelynn,F,5,3317315,27541
27586,Koralie,F,5,3317320,27843
27587,Kordale,M,5,3317325,27557
27588,Korede,M,5,3317330,27993
27589,Korei,F,5,3317335,27325
27590,Korvin,M,5,3317340,27475
27591,Kosei,M,5,3317345,27383
27592,Kostas,M,5,3317350,27095
27593,Kotaro,M,5,3317355,27507
27594,Kotoha,F,5,3317360,27388
27595,Kourage,F,5,3317365,27182
27596,Kourosh,M,5,3317370,27629
27597,Kovah,F,5,3317375,27590
27598,Kovyn,M,5,3317380,27494
27599,Kowsar,F,5,3317385,27776
27600,Kreedon,M,5,3317390,27666
27601,Kriday,M,5,3317395,27802
27602,Krillin,M,5,3317400,27878
27603,Kripa,F,5,3317405,27965
27604,Krishawn,M,5,3317410,27575
27605,Krishvi,F,5,3317415,27167
27606,Krisley,F,5,3317420,27934
27607,Kroix,M,5,3317425,27069
27608,Krrish,M,5,3317430,27609
27609,Kseniya,F,5,3317435,27022
27610,Kshawn,M,5,3317440,27235
27611,Kubra,F,5,3317445,27356
27612,Kumari,M,5,3317450,27931
27613,Kunal,M,5,3317455,27061
27614,Kundana,F,5,3317460,27433
27615,Kupaa,M,5,3317465,27348
27616,Kurrency,M,5,3317470,27151
27617,Kushagra,M,5,3317475,27390
27618,Kuzma,M,5,3317480,27357
27619,Kyaira,F,5,3317485,27111
27620,Kyam,M,5,3317490,27959
27621,Kyanite,M,5,3317495,27813
27622,Kyaw,M,5,3317500,27424
27623,Kyella,F,5,3317505,27933
27624,Kyere,M,5,3317510,27102
27625,Kyi,M,5,3317515,27668
27626,Kyian,M,5,3317520,27528
27627,Kyier,M,5,3317525,27515
27628,Kyjuan,M,5,3317530,27901
27629,Kylana,F,5,3317535,27921
27630,Kyleia,F,5,3317540,27488
27631,Kylena,F,5,3317545,27129
27632,Kylier,M,5,3317550,27110
27633,Kymbella,F,5,3317555,27881
27634,Kymbree,F,5,3317560,27751
27635,Kyne,M,5,3317565,27240
27636,Kyngstin,M,5,3317570,27401
27637,Kynlea,F,5,3317575,27625
27638,Kynnlee,F,5,3317580,27660
27639,Kynnleigh,F,5,3317585,27780
27640,Kyntrell,M,5,3317590,27050
27641,Kyper,M,5,3317595,27039
27642,Kyraa,F,5,3317600,27324
27643,Kyriaki,F,5,3317605,27051
27644,Kyriana,F,5,3317610,27221
27645,Kyrion,M,5,3317615,27820
27646,Kyrone,M,5,3317620,27328
27647,Kyryn,M,5,3317625,27917
27648,Kysean,M,5,3317630,27097
27649,Kyshaun,M,5,3317635,27787
27650,Kysyn,M,5,3317640,27124
27651,Kytzia,F,5,3317645,27652
27652,Kyus,M,5,3317650,27711
27653,Kyvan,M,5,3317655,27607
27654,Kyvon,M,5,3317660,27407
27655,Kyza,F,5,3317665,27410
27656,Laban,M,5,3317670,27126
27657,Labib,M,5,3317675,27589
27658,Lacelynn,F,5,3317680,27910
27659,Lacen,M,5,3317685,27967
27660,Ladamien,M,5,3317690,27679
27661,Ladavion,M,5,3317695,27322
27662,Ladi,F,5,3317700,27216
27663,Laetitia,F,5,3317705,27859
27664,Lahari,F,5,3317710,27626
27665,Laibah,F,5,3317715,27482
27666,Laika,F,5,3317720,27972
27667,Laikley,F,5,3317725,27062
27668,Lailiana,F,5,3317730,27876
27669,Laily,F,5,3317735,27685
27670,Laiza,F,5,3317740,27599
27671,Lakeisha,F,5,3317745,27369
27672,Lakeson,M,5,3317750,27288
27673,Lakhi,M,5,3317755,27145
27674,Lakoda,M,5,3317760,27727
27675,Lakshya,F,5,3317765,27728
27676,Lakyia,F,5,3317770,27471
27677,Lamis,F,5,3317775,27432
27678,Lamon,M,5,3317780,27841
27679,Lanamae,F,5,3317785,27090
27680,Lanard,M,5,3317790,27008
27681,Lanasia,F,5,3317795,27446
27682,Lancer,M,5,3317800,27389
27683,Landy,M,5,3317805,27839
27684,Lanee,F,5,3317810,27374
27685,Lanette,F,5,3317815,27150
27686,Lantz,M,5,3317820,27932
27687,Laray,M,5,3317825,27015
27688,Lareine,F,5,3317830,27423
27689,Larron,M,5,3317835,27469
27690,Larsa,F,5,3317840,27773
27691,Lasalle,M,5,3317845,27362
27692,Lashon,M,5,3317850,27100
27693,Lasiah,M,5,3317855,27084
27694,Lataya,F,5,3317860,27761
27695,Lateen,F,5,3317865,27176
27696,Laurali,F,5,3317870,27797
27697,Lauralye,F,5,3317875,27554
27698,Lauralyn,F,5,3317880,27578
27699,Laurana,F,5,3317885,27261
27700,Laure,F,5,3317890,27013
27701,Laurelai,F,5,3317895,27865
27702,Laureline,F,5,3317900,27367
27703,Laurell,F,5,3317905,27808
27704,Laurianna,F,5,3317910,27664
27705,Lava,F,5,3317915,27827
27706,Lavaya,F,5,3317920,27161
27707,Laveya,F,5,3317925,27817
27708,Laviah,F,5,3317930,27942
27709,Layaan,F,5,3317935,27180
27710,Layanah,F,5,3317940,27715
27711,Laydon,M,5,3317945,27688
27712,Laylagrace,F,5,3317950,27729
27713,Laylana,F,5,3317955,27232
27714,Laylanna,F,5,3317960,27149
27715,Laylonie,F,5,3317965,27452
27716,Laylyn,F,5,3317970,27007
27717,Layra,F,5,3317975,27745
27718,Lazariah,F,5,3317980,27231
27719,Leamon,M,5,3317985,27667
27720,Leamsi,F,5,3317990,27536
27721,Leanndra,F,5,3317995,27887
27722,Leanthony,M,5,3318000,27329
27723,Ledarrius,M,5,3318005,27195
27724,Legacey,F,5,3318010,27339
27725,Legand,M,5,3318015,27458
27726,Lehi,M,5,3318020,27632
27727,Leighanne,F,5,3318025,27815
27728,Leighland,M,5,3318030,27024
27729,Leiliani,F,5,3318035,27970
27730,Leilyn,F,5,3318040,27428
27731,Leilynn,F,5,3318045,27568
27732,Leiyani,F,5,3318050,27203
27733,Lelynd,M,5,3318055,27653
27734,Lemarcus,M,5,3318060,27724
27735,Lenash,F,5,3318065,27108
27736,Lendon,M,5,3318070,27391
27737,Lenier,M,5,3318075,27064
27738,Leodan,M,5,3318080,27833
27739,Leoncio,M,5,3318085,27999
27740,Leonia,F,5,3318090,27035
27741,Leonis,M,5,3318095,27174
27742,Leonitus,M,5,3318100,27314
27743,Leslee,F,5,3318105,27206
27744,Lesther,M,5,3318110,27460
27745,Leti,F,5,3318115,27757
27746,Letzy,F,5,3318120,27211
27747,Levanna,F,5,3318125,27027
27748,Levent,M,5,3318130,27230
27749,Leviah,F,5,3318135,27444
27750,Lewie,M,5,3318140,27628
27751,Lewin,M,5,3318145,27561
27752,Lexee,F,5,3318150,27072
27753,Lexianna,F,5,3318155,27449
27754,Lexiel,M,5,3318160,27766
27755,Leydy,F,5,3318165,27443
27756,Leyon,M,5,3318170,27860
27757,Leysha,F,5,3318175,27016
27758,Liander,M,5,3318180,27297
27759,Lianeth,F,5,3318185,27676
27760,Lianette,F,5,3318190,27824
27761,Liany,F,5,3318195,27696
27762,Libbi,F,5,3318200,27534
27763,Libni,F,5,3318205,27907
27764,Libny,F,5,3318210,27783
27765,Librado,M,5,3318215,27582
27766,Liby,F,5,3318220,27968
27767,Lienna,F,5,3318225,27763
27768,Lihan,M,5,3318230,27796
27769,Liko,M,5,3318235,27527
27770,Lilan,F,5,3318240,27986
27771,Lile,F,5,3318245,27028
27772,Liliah,F,5,3318250,27135
27773,Liliahna,F,5,3318255,27408
27774,Liliannah,F,5,3318260,27018
27775,Lilienne,F,5,3318265,27749
27776,Lilikoi,F,5,3318270,27580
27777,Liliyan,F,5,3318275,27336
27778,Lilliauna,F,5,3318280,27299
27779,Lillyanah,F,5,3318285,27938
27780,Lillyona,F,5,3318290,27346
27781,Lilyian,F,5,3318295,27227
27782,Lima,F,5,3318300,27573
27783,Linah,F,5,3318305,27196
27784,Linaya,F,5,3318310,27699
27785,Lindan,M,5,3318315,27788
27786,Lindell,M,5,3318320,27004
27787,Linford,M,5,3318325,27447
27788,Linzie,F,5,3318330,27588
27789,Liseth,F,5,3318335,27576
27790,Lissy,F,5,3318340,27777
27791,Liviann,F,5,3318345,27634
27792,Livienne,F,5,3318350,27622
27793,Liyam,M,5,3318355,27624
27794,Lizardo,M,5,3318360,27571
27795,Lizmary,F,5,3318365,27985
27796,Loanny,F,5,3318370,27682
27797,Loch,M,5,3318375,27794
27798,Locklin,F,5,3318380,27912
27799,Lohany,F,5,3318385,27694
27800,Lohith,M,5,3318390,27603
27801,Loie,F,5,3318395,27316
27802,Lolade,F,5,3318400,27810
27803,Lon,M,5,3318405,27352
27804,Lonnell,M,5,3318410,27714
27805,Lonni,F,5,3318415,27421
27806,Lono,M,5,3318420,27960
27807,Loralynn,F,5,3318425,27166
27808,Loran,M,5,3318430,27487
27809,Lorde,M,5,3318435,27427
27810,Lore,F,5,3318440,27908
27811,Loreana,F,5,3318445,27501
27812,Lorelle,F,5,3318450,27560
27813,Loreto,M,5,3318455,27372
27814,Loriah,F,5,3318460,27076
27815,Loujain,F,5,3318465,27606
27816,Lovelle,F,5,3318470,27363
27817,Lovisa,F,5,3318475,27229
27818,Loyaltee,F,5,3318480,27940
27819,Lu,F,5,3318485,27493
27820,Luay,M,5,3318490,27155
27821,Lucea,F,5,3318495,27517
27822,Lucrecia,F,5,3318500,27052
27823,Lucyna,F,5,3318505,27147
27824,Ludovico,M,5,3318510,27252
27825,Ludwin,M,5,3318515,27981
27826,Luismiguel,M,5,3318520,27321
27827,Lujane,F,5,3318525,27955
27828,Lunella,F,5,3318530,27461
27829,Luthor,M,5,3318535,27224
27830,Luzer,M,5,3318540,27309
27831,Luziana,F,5,3318545,27847
27832,Lyberti,F,5,3318550,27775
27833,Lyden,M,5,3318555,27415
27834,Lydianna,F,5,3318560,27511
27835,Lydon,M,5,3318565,27969
27836,Lyiah,F,5,3318570,27705
27837,Lyndyn,F,5,3318575,27094
27838,Lynkoln,M,5,3318580,27784
27839,Lynniah,F,5,3318585,27092
27840,Lynnora,F,5,3318590,27386
27841,Lynora,F,5,3318595,27304
27842,Lynox,F,5,3318600,27158
27843,Lyricc,F,5,3318605,27587
27844,Lyrick,F,5,3318610,27201
27845,Maaliyah,F,5,3318615,27121
27846,Maaya,F,5,3318620,27312
27847,Macalister,M,5,3318625,27789
27848,Macaria,F,5,3318630,27277
27849,Maccoy,M,5,3318635,27521
27850,Macelyn,F,5,3318640,27485
27851,Macelynn,F,5,3318645,27953
27852,Maceon,M,5,3318650,27040
27853,Macgyver,M,5,3318655,27502
27854,Macintyre,M,5,3318660,27514
27855,Macio,M,5,3318665,27209
27856,Maclaine,F,5,3318670,27848
27857,Macrina,F,5,3318675,27771
27858,Maddelin,F,5,3318680,27738
27859,Maddisen,F,5,3318685,27539
27860,Maddock,M,5,3318690,27956
27861,Madelena,F,5,3318695,27896
27862,Madeliene,F,5,3318700,27978
27863,Madelline,F,5,3318705,27318
27864,Madex,M,5,3318710,27418
27865,Madian,M,5,3318715,27816
27866,Madisun,F,5,3318720,27204
27867,Madizon,F,5,3318725,27566
27868,Madlynn,F,5,3318730,27026
27869,Madux,M,5,3318735,27691
27870,Madylynn,F,5,3318740,27434
27871,Maebh,F,5,3318745,27748
27872,Maebri,F,5,3318750,27948
27873,Maejor,M,5,3318755,27089
27874,Maelahni,F,5,3318760,27422
27875,Maelynne,F,5,3318765,27264
27876,Mahaa,F,5,3318770,27406
27877,Mahilan,M,5,3318775,27786
27878,Maian,F,5,3318780,27044
27879,Maiara,F,5,3318785,27712
27880,Maicee,F,5,3318790,27253
27881,Maicie,F,5,3318795,27011
27882,Maijer,M,5,3318800,27963
27883,Maik,M,5,3318805,27368
27884,Maimunah,F,5,3318810,27047
27885,Mais,F,5,3318815,27411
27886,Maitte,F,5,3318820,27695
27887,Maizlyn,F,5,3318825,27267
27888,Maji,M,5,3318830,27005
27889,Majik,M,5,3318835,27036
27890,Makaelyn,F,5,3318840,27066
27891,Makaiah,F,5,3318845,27853
27892,Makaius,M,5,3318850,27655
27893,Makala,F,5,3318855,27189
27894,Makaria,F,5,3318860,27877
27895,Makarios,M,5,3318865,27116
27896,Makenzlee,F,5,3318870,27085
27897,Makhail,M,5,3318875,27294
27898,Makhy,M,5,3318880,27864
27899,Makih,M,5,3318885,27220
27900,Makilah,F,5,3318890,27379
27901,Makonnen,M,5,3318895,27662
27902,Makyiah,F,5,3318900,27673
27903,Malachite,M,5,3318905,27338
27904,Malaisia,F,5,3318910,27602
27905,Malakaii,M,5,3318915,27258
27906,Malakiah,M,5,3318920,27489
27907,Malay,F,5,3318925,27764
27908,Maleak,M,5,3318930,27831
27909,Maley,F,5,3318935,27732
27910,Maliana,F,5,3318940,27140
27911,Malilah,F,5,3318945,27366
27912,Malonni,F,5,3318950,27522
27913,Malykai,M,5,3318955,27641
27914,Malyssa,F,5,3318960,27326
27915,Mama,F,5,3318965,27945
27916,Mamediarra,F,5,3318970,27117
27917,Manan,M,5,3318975,27718
27918,Manara,F,5,3318980,27927
27919,Manase,M,5,3318985,27703
27920,Manasvini,F,5,3318990,27073
27921,Manaswini,F,5,3318995,27884
27922,Mandrell,M,5,3319000,27358
27923,Maneh,F,5,3319005,27287
27924,Manika,F,5,3319010,27672
27925,Manon,F,5,3319015,27119
27926,Mantej,M,5,3319020,27730
27927,Marat,M,5,3319025,27083
27928,Marcee,F,5,3319030,27854
27929,Marcellino,M,5,3319035,27928
27930,Marcelus,M,5,3319040,27651
27931,Marcelyn,F,5,3319045,27480
27932,Marceon,M,5,3319050,27976
27933,Marciel,M,5,3319055,27640
27934,Marck,M,5,3319060,27704
27935,Mareena,F,5,3319065,27567
27936,Mareya,F,5,3319070,27939
27937,Margaery,F,5,3319075,27226
27938,Margherita,F,5,3319080,27633
27939,Mariaantonia,F,5,3319085,27307
27940,Marialaura,F,5,3319090,27701
27941,Marialis,F,5,3319095,27742
27942,Mariangela,F,5,3319100,27187
27943,Mariateresa,F,5,3319105,27106
27944,Marieta,F,5,3319110,27041
27945,Marietou,F,5,3319115,27829
27946,Marijose,F,5,3319120,27984
27947,Marilou,F,5,3319125,27722
27948,Marine,F,5,3319130,27431
27949,Maripaz,F,5,3319135,27892
27950,Maristella,F,5,3319140,27610
27951,Maritta,F,5,3319145,27071
27952,Marium,F,5,3319150,27122
27953,Markeece,M,5,3319155,27164
27954,Markeis,M,5,3319160,27987
27955,Markella,F,5,3319165,27257
27956,Marki,M,5,3319170,27890
27957,Markis,M,5,3319175,27721
27958,Marlando,M,5,3319180,27191
27959,Marlaya,F,5,3319185,27844
27960,Marleyrae,F,5,3319190,27033
27961,Marnae,F,5,3319195,27256
27962,Marnita,F,5,3319200,27964
27963,Maron,M,5,3319205,27245
27964,Marquees,M,5,3319210,27490
27965,Marqus,M,5,3319215,27519
27966,Marrah,F,5,3319220,27157
27967,Marriana,F,5,3319225,27086
27968,Marrion,M,5,3319230,27375
27969,Marseille,F,5,3319235,27320
27970,Marson,M,5,3319240,27510
27971,Martae,M,5,3319245,27731
27972,Martavis,M,5,3319250,27637
27973,Martese,M,5,3319255,27377
27974,Martice,M,5,3319260,27708
27975,Martir,M,5,3319265,27982
27976,Martyn,M,5,3319270,27003
27977,Marvelle,F,5,3319275,27529
27978,Maryamawit,F,5,3319280,27533
27979,Marybella,F,5,3319285,27306
27980,Marye,F,5,3319290,27692
27981,Maryel,F,5,3319295,27513
27982,Maryeli,F,5,3319300,27867
27983,Maryem,F,5,3319305,27988
27984,Maryfer,F,5,3319310,27088
27985,Maryjayne,F,5,3319315,27697
27986,Maryjoy,F,5,3319320,27898
27987,Marzel,M,5,3319325,27842
27988,Masao,M,5,3319330,27551
27989,Mascud,M,5,3319335,27952
27990,Masonalexander,M,5,3319340,27397
27991,Masonlee,M,5,3319345,27819
27992,Masooma,F,5,3319350,27393
27993,Matas,M,5,3319355,27439
27994,Matej,M,5,3319360,27199
27995,Matheson,M,5,3319365,27975
27996,Matia,F,5,3319370,27249
27997,Mato,M,5,3319375,27137
27998,Mattaniah,M,5,3319380,27344
27999,Matthijs,M,5,3319385,27125
28000,Mauriah,F,5,3319390,28416
28001,Maurielle,F,5,3319395,28443
28002,Maurilio,M,5,3319400,28587
28003,Maurio,M,5,3319405,28343
28004,Maurion,M,5,3319410,28517
28005,Mav,M,5,3319415,28634
28006,Maxell,M,5,3319420,28376
28007,Maxi,M,5,3319425,28622
28008,Maximiliana,F,5,3319430,28492
28009,Maxlyn,F,5,3319435,28566
28010,Maxwel,M,5,3319440,28942
28011,Maxyn,M,5,3319445,28428
28012,Maybell,F,5,3319450,28789
28013,Mayce,M,5,3319455,28718
28014,Maydelin,F,5,3319460,28253
28015,Mayerly,F,5,3319465,28217
28016,Mayhem,M,5,3319470,28165
28017,Maylasia,F,5,3319475,28213
28018,Mayleth,F,5,3319480,28000
28019,Mayloni,F,5,3319485,28871
28020,Maylyn,F,5,3319490,28946
28021,Mayor,M,5,3319495,28029
28022,Maysaa,F,5,3319500,28822
28023,Maysoon,F,5,3319505,28047
28024,Maythe,F,5,3319510,28114
28025,Mayuri,F,5,3319515,28967
28026,Mayva,F,5,3319520,28476
28027,Mayzlee,F,5,3319525,28805
28028,Mazelynn,F,5,3319530,28836
28029,Mazuri,F,5,3319535,28419
28030,Mccain,M,5,3319540,28028
28031,Mcguire,M,5,3319545,28209
28032,Mckenzye,F,5,3319550,28640
28033,Mckinnleigh,F,5,3319555,28112
28034,Mckinzee,F,5,3319560,28043
28035,Mckynley,F,5,3319565,28663
28036,Mehwish,F,5,3319570,28499
28037,Meiah,F,5,3319575,28526
28038,Meilanie,F,5,3319580,28415
28039,Meiling,F,5,3319585,28187
28040,Meisa,F,5,3319590,28082
28041,Meka,F,5,3319595,28191
28042,Mekayla,F,5,3319600,28852
28043,Mekenzie,F,5,3319605,28913
28044,Meko,M,5,3319610,28602
28045,Meladie,F,5,3319615,28796
28046,Melakai,M,5,3319620,28630
28047,Melaniee,F,5,3319625,28581
28048,Melanya,F,5,3319630,28930
28049,Meliani,F,5,3319635,28260
28050,Meline,F,5,3319640,28411
28051,Melis,F,5,3319645,28906
28052,Melita,F,5,3319650,28150
28053,Mellani,F,5,3319655,28617
28054,Mellina,F,5,3319660,28045
28055,Mello,M,5,3319665,28883
28056,Mellow,F,5,3319670,28298
28057,Melly,F,5,3319675,28230
28058,Melora,F,5,3319680,28311
28059,Melquisedec,M,5,3319685,28884
28060,Melynda,F,5,3319690,28500
28061,Memphys,M,5,3319695,28281
28062,Mergen,M,5,3319700,28806
28063,Merik,M,5,3319705,28162
28064,Merina,F,5,3319710,28880
28065,Merrit,F,5,3319715,28421
28066,Meru,F,5,3319720,28856
28067,Meshal,M,5,3319725,28393
28068,Messer,M,5,3319730,28984
28069,Messyah,M,5,3319735,28941
28070,Metta,F,5,3319740,28900
28071,Meziah,M,5,3319745,28763
28072,Mhairi,F,5,3319750,28709
28073,Mhia,F,5,3319755,28897
28074,Mi,F,5,3319760,28233
28075,Miaamor,F,5,3319765,28399
28076,Miakoda,F,5,3319770,28592
28077,Micai,M,5,3319775,28714
28078,Micaias,M,5,3319780,28129
28079,Michaelah,F,5,3319785,28136
28080,Michaeljohn,M,5,3319790,28299
28081,Michaelle,F,5,3319795,28983
28082,Michayla,F,5,3319800,28665
28083,Michell,F,5,3319805,28465
28084,Michella,F,5,3319810,28368
28085,Miciah,F,5,3319815,28052
28086,Midhuna,F,5,3319820,28633
28087,Mieko,F,5,3319825,28448
28088,Mighty,M,5,3319830,28816
28089,Mihan,M,5,3319835,28498
28090,Mijoy,F,5,3319840,28993
28091,Mikaiah,F,5,3319845,28510
28092,Mikalyn,F,5,3319850,28186
28093,Mikela,F,5,3319855,28115
28094,Mikhai,M,5,3319860,28360
28095,Mikiyas,M,5,3319865,28312
28096,Mikka,F,5,3319870,28190
28097,Mikolas,M,5,3319875,28464
28098,Mikyah,F,5,3319880,28996
28099,Mikyas,M,5,3319885,28512
28100,Mikyle,M,5,3319890,28243
28101,Milahn,F,5,3319895,28007
28102,Milanee,F,5,3319900,28688
28103,Milas,M,5,3319905,28158
28104,Miliah,F,5,3319910,28653
28105,Milicent,F,5,3319915,28454
28106,Milinda,F,5,3319920,28927
28107,Miliyana,F,5,3319925,28391
28108,Milkias,M,5,3319930,28433
28109,Millina,F,5,3319935,28905
28110,Milner,M,5,3319940,28300
28111,Minhanh,F,5,3319945,28236
28112,Miori,F,5,3319950,28991
28113,Mirabell,F,5,3319955,28726
28114,Miriah,F,5,3319960,28662
28115,Miriya,F,5,3319965,28881
28116,Mirvaan,M,5,3319970,28083
28117,Misaki,F,5,3319975,28552
28118,Mitt,M,5,3319980,28023
28119,Mkai,M,5,3319985,28845
28120,Mkayla,F,5,3319990,28625
28121,Mohamadou,M,5,3319995,28527
28122,Mohmed,M,5,3320000,28294
28123,Mokshith,M,5,3320005,28275
28124,Montague,M,5,3320010,28071
28125,Monti,M,5,3320015,28273
28126,Montre,M,5,3320020,28204
28127,Montserrath,F,5,3320025,28874
28128,Moraya,F,5,3320030,28697
28129,Morea,F,5,3320035,28935
28130,Morgynn,F,5,3320040,28183
28131,Moriya,F,5,3320045,28968
28132,Mortimer,M,5,3320050,28608
28133,Morton,M,5,3320055,28684
28134,Moshie,M,5,3320060,28471
28135,Mosi,M,5,3320065,28706
28136,Moti,M,5,3320070,28256
28137,Motley,F,5,3320075,28981
28138,Mouctar,M,5,3320080,28687
28139,Mowgli,M,5,3320085,28030
28140,Mozelle,F,5,3320090,28562
28141,Mozzy,M,5,3320095,28908
28142,Mudassir,M,5,3320100,28491
28143,Muhammadjon,M,5,3320105,28514
28144,Muhammadmusa,M,5,3320110,28139
28145,Muhammadumar,M,5,3320115,28902
28146,Muhammadwali,M,5,3320120,28011
28147,Muhannad,M,5,3320125,28467
28148,Muktar,M,5,3320130,28910
28149,Muskaan,F,5,3320135,28382
28150,Mussie,M,5,3320140,28344
28151,Mutty,M,5,3320145,28409
28152,Muzaffar,M,5,3320150,28061
28153,Myann,F,5,3320155,28355
28154,Myel,M,5,3320160,28364
28155,Myheir,M,5,3320165,28590
28156,Mykelti,F,5,3320170,28987
28157,Mykyng,M,5,3320175,28103
28158,Mylana,F,5,3320180,28067
28159,Mylarose,F,5,3320185,28493
28160,Myomi,F,5,3320190,28876
28161,Myon,M,5,3320195,28612
28162,Myrikal,F,5,3320200,28446
28163,Mythri,F,5,3320205,28870
28164,Myzel,M,5,3320210,28025
28165,Naara,F,5,3320215,28033
28166,Naataanii,M,5,3320220,28354
28167,Nabhan,M,5,3320225,28724
28168,Nabilah,F,5,3320230,28252
28169,Nachum,M,5,3320235,28830
28170,Nadelyn,F,5,3320240,28520
28171,Nadiah,F,5,3320245,28132
28172,Naella,F,5,3320250,28734
28173,Naeomi,F,5,3320255,28254
28174,Nagi,M,5,3320260,28050
28175,Nahid,F,5,3320265,28284
28176,Nahiem,M,5,3320270,28859
28177,Nahim,M,5,3320275,28097
28178,Nahlij,M,5,3320280,28034
28179,Naiden,M,5,3320285,28328
28180,Naileah,F,5,3320290,28361
28181,Nain,F,5,3320295,28707
28182,Nakenzie,F,5,3320300,28594
28183,Nakhai,M,5,3320305,28875
28184,Nakoah,M,5,3320310,28352
28185,Nakova,F,5,3320315,28398
28186,Nakyia,F,5,3320320,28265
28187,Nalaysia,F,5,3320325,28101
28188,Nalej,M,5,3320330,28046
28189,Nalij,M,5,3320335,28099
28190,Namia,F,5,3320340,28451
28191,Nane,F,5,3320345,28644
28192,Naomika,F,5,3320350,28370
28193,Naphtali,M,5,3320355,28005
28194,Nashlie,F,5,3320360,28216
28195,Nashua,M,5,3320365,28482
28196,Nashville,M,5,3320370,28775
28197,Nasr,M,5,3320375,28519
28198,Nasro,F,5,3320380,28891
28199,Nassiah,M,5,3320385,28270
28200,Nataanii,M,5,3320390,28627
28201,Natallia,F,5,3320395,28529
28202,Natalye,F,5,3320400,28711
28203,Natalyia,F,5,3320405,28020
28204,Natanya,F,5,3320410,28669
28205,Natasia,F,5,3320415,28064
28206,Nathali,F,5,3320420,28655
28207,Nathias,M,5,3320425,28555
28208,Natiri,F,5,3320430,28921
28209,Naura,F,5,3320435,28056
28210,Navarre,M,5,3320440,28461
28211,Navisha,F,5,3320445,28923
28212,Navneet,F,5,3320450,28345
28213,Nawa,F,5,3320455,28771
28214,Nawaal,F,5,3320460,28513
28215,Nay,M,5,3320465,28288
28216,Nayalee,F,5,3320470,28450
28217,Naylin,F,5,3320475,28998
28218,Nazair,M,5,3320480,28444
28219,Nazaya,F,5,3320485,28629
28220,Nazere,M,5,3320490,28758
28221,Nazia,F,5,3320495,28869
28222,Naziya,F,5,3320500,28861
28223,Nealy,F,5,3320505,28525
28224,Neamiah,M,5,3320510,28916
28225,Nechuma,F,5,3320515,28959
28226,Neelah,F,5,3320520,28591
28227,Neeson,M,5,3320525,28459
28228,Neeya,F,5,3320530,28744
28229,Negun,M,5,3320535,28335
28230,Neia,F,5,3320540,28868
28231,Nelinha,F,5,3320545,28017
28232,Nely,F,5,3320550,28266
28233,Nelya,F,5,3320555,28920
28234,Nesly,F,5,3320560,28380
28235,Ness,M,5,3320565,28267
28236,Nethra,F,5,3320570,28316
28237,Nev,F,5,3320575,28716
28238,Nevalyn,F,5,3320580,28808
28239,Nevie,F,5,3320585,28682
28240,Nevo,M,5,3320590,28936
28241,Nevyn,M,5,3320595,28626
28242,Neyah,F,5,3320600,28768
28243,Ngoc,F,5,3320605,28032
28244,Nhien,F,5,3320610,28637
28245,Niaa,F,5,3320615,28511
28246,Nialynn,F,5,3320620,28021
28247,Niari,F,5,3320625,28178
28248,Nicandro,M,5,3320630,28053
28249,Nicasia,F,5,3320635,28245
28250,Nicci,F,5,3320640,28792
28251,Nicholette,F,5,3320645,28783
28252,Nickoy,M,5,3320650,28854
28253,Nicolly,F,5,3320655,28598
28254,Nihansh,M,5,3320660,28537
28255,Nihara,F,5,3320665,28797
28256,Niia,F,5,3320670,28610
28257,Nijel,M,5,3320675,28650
28258,Nikholas,M,5,3320680,28551
28259,Nikol,F,5,3320685,28008
28260,Nili,F,5,3320690,28803
28261,Nilla,F,5,3320695,28292
28262,Nimalan,M,5,3320700,28834
28263,Ninna,F,5,3320705,28563
28264,Nishaad,M,5,3320710,28817
28265,Nishanth,M,5,3320715,28879
28266,Nishawn,M,5,3320720,28795
28267,Nitai,M,5,3320725,28960
28268,Nithilan,M,5,3320730,28571
28269,Niv,F,5,3320735,28864
28270,Nivaya,F,5,3320740,28173
28271,Nivedh,M,5,3320745,28142
28272,Nivisha,F,5,3320750,28635
28273,Nixson,M,5,3320755,28231
28274,Niyar,M,5,3320760,28226
28275,Niyeli,F,5,3320765,28677
28276,Noahray,M,5,3320770,28094
28277,Noell,F,5,3320775,28483
28278,Noelli,F,5,3320780,28814
28279,Noir,M,5,3320785,28110
28280,Nolawit,F,5,3320790,28378
28281,Nolie,F,5,3320795,28515
28282,Nollie,F,5,3320800,28737
28283,Norbu,M,5,3320805,28660
28284,Noria,F,5,3320810,28673
28285,Norine,F,5,3320815,28955
28286,Norrah,F,5,3320820,28018
28287,Nouran,F,5,3320825,28918
28288,Novarose,F,5,3320830,28138
28289,Noveah,F,5,3320835,28285
28290,Noyan,M,5,3320840,28438
28291,Numair,M,5,3320845,28060
28292,Numan,M,5,3320850,28425
28293,Nuriah,F,5,3320855,28698
28294,Nuriel,M,5,3320860,28171
28295,Nyashia,F,5,3320865,28613
28296,Nyeelah,F,5,3320870,28250
28297,Nyeemah,F,5,3320875,28163
28298,Nyela,F,5,3320880,28766
28299,Nyell,F,5,3320885,28015
28300,Nyere,M,5,3320890,28649
28301,Nyheem,M,5,3320895,28810
28302,Nyiah,F,5,3320900,28839
28303,Nyimah,F,5,3320905,28307
28304,Nykai,M,5,3320910,28611
28305,Nykole,F,5,3320915,28223
28306,Nylaiah,F,5,3320920,28041
28307,Nylaya,F,5,3320925,28280
28308,Nyleigh,F,5,3320930,28866
28309,Nylen,M,5,3320935,28652
28310,Nymere,M,5,3320940,28373
28311,Nyonna,F,5,3320945,28159
28312,Nyshawn,M,5,3320950,28636
28313,Nyzere,M,5,3320955,28235
28314,Oba,M,5,3320960,28824
28315,Oban,M,5,3320965,28478
28316,Obediah,M,5,3320970,28985
28317,Oceann,F,5,3320975,28895
28318,Odai,M,5,3320980,28049
28319,Odera,M,5,3320985,28715
28320,Oen,M,5,3320990,28417
28321,Oghenetega,M,5,3320995,28832
28322,Ohene,M,5,3321000,28365
28323,Oladeji,M,5,3321005,28371
28324,Olasubomi,M,5,3321010,28531
28325,Olea,F,5,3321015,28154
28326,Olegario,M,5,3321020,28939
28327,Olianna,F,5,3321025,28109
28328,Olie,M,5,3321030,28258
28329,Oluwafemi,M,5,3321035,28977
28330,Oluwafifehanmi,F,5,3321040,28912
28331,Oluwaseyi,F,5,3321045,28336
28332,Omare,M,5,3321050,28778
28333,Omarian,M,5,3321055,28072
28334,Omarius,M,5,3321060,28397
28335,Omauri,M,5,3321065,28089
28336,Omere,M,5,3321070,28080
28337,Omolara,F,5,3321075,28658
28338,Onice,F,5,3321080,28575
28339,Onika,F,5,3321085,28894
28340,Onnalee,F,5,3321090,28727
28341,Ontario,M,5,3321095,28239
28342,Onur,M,5,3321100,28220
28343,Orestes,M,5,3321105,28867
28344,Oriyan,M,5,3321110,28961
28345,Orlaigh,F,5,3321115,28909
28346,Orlan,M,5,3321120,28317
28347,Ornella,F,5,3321125,28549
28348,Orren,M,5,3321130,28070
28349,Orry,M,5,3321135,28576
28350,Orsen,M,5,3321140,28405
28351,Osa,F,5,3321145,28680
28352,Osha,M,5,3321150,28784
28353,Oshane,M,5,3321155,28318
28354,Oshay,M,5,3321160,28342
28355,Osher,M,5,3321165,28468
28356,Oshyn,F,5,3321170,28098
28357,Oumy,F,5,3321175,28263
28358,Owan,M,5,3321180,28567
28359,Oya,F,5,3321185,28776
28360,Ozai,M,5,3321190,28695
28361,Ozwald,M,5,3321195,28781
28362,Paesyn,F,5,3321200,28720
28363,Paetynn,F,5,3321205,28202
28364,Paisleymae,F,5,3321210,28735
28365,Paisliegh,F,5,3321215,28054
28366,Paiten,F,5,3321220,28997
28367,Paitlyn,F,5,3321225,28161
28368,Paizlie,F,5,3321230,28596
28369,Paizlyn,F,5,3321235,28982
28370,Palace,F,5,3321240,28518
28371,Panagiota,F,5,3321245,28970
28372,Panos,M,5,3321250,28713
28373,Pantera,F,5,3321255,28135
28374,Paras,M,5,3321260,28474
28375,Pareesa,F,5,3321265,28130
28376,Parid,M,5,3321270,28102
28377,Parishay,F,5,3321275,28208
28378,Parizay,F,5,3321280,28599
28379,Parkyr,M,5,3321285,28679
28380,Parley,M,5,3321290,28472
28381,Parmis,F,5,3321295,28949
28382,Parneet,F,5,3321300,28277
28383,Pars,M,5,3321305,28672
28384,Pauleth,F,5,3321310,28188
28385,Pavan,M,5,3321315,28106
28386,Pavika,F,5,3321320,28638
28387,Pavlos,M,5,3321325,28301
28388,Paxtynn,F,5,3321330,28826
28389,Paycen,M,5,3321335,28873
28390,Paysleigh,F,5,3321340,28315
28391,Payslie,F,5,3321345,28077
28392,Paytience,F,5,3321350,28690
28393,Pearla,F,5,3321355,28413
28394,Pelagia,F,5,3321360,28403
28395,Pele,F,5,3321365,28339
28396,Pennie,F,5,3321370,28904
28397,Pennylane,F,5,3321375,28219
28398,Perceval,M,5,3321380,28620
28399,Perola,F,5,3321385,28460
28400,Pessi,F,5,3321390,28002
28401,Petr,M,5,3321395,28609
28402,Phabian,M,5,3321400,28952
28403,Phallon,F,5,3321405,28268
28404,Pharell,M,5,3321410,28670
28405,Philomina,F,5,3321415,28882
28406,Phinneas,M,5,3321420,28863
28407,Piersen,M,5,3321425,28708
28408,Piya,F,5,3321430,28278
28409,Pnina,F,5,3321435,28332
28410,Pol,M,5,3321440,28557
28411,Powell,M,5,3321445,28156
28412,Prabhnoor,F,5,3321450,28095
28413,Prajwal,M,5,3321455,28601
28414,Pranish,M,5,3321460,28078
28415,Pranisha,F,5,3321465,28057
28416,Pranit,M,5,3321470,28019
28417,Pranshu,M,5,3321475,28296
28418,Prayaan,M,5,3321480,28442
28419,Presha,F,5,3321485,28189
28420,Prezley,F,5,3321490,28087
28421,Primm,F,5,3321495,28849
28422,Primo,M,5,3321500,28798
28423,Princeamir,M,5,3321505,28036
28424,Princeanthony,M,5,3321510,28597
28425,Princetin,M,5,3321515,28181
28426,Priseis,F,5,3321520,28843
28427,Promiss,F,5,3321525,28286
28428,Promysse,F,5,3321530,28402
28429,Ptolemy,M,5,3321535,28022
28430,Qairo,M,5,3321540,28333
28431,Qari,M,5,3321545,28227
28432,Quadair,M,5,3321550,28168
28433,Quartney,F,5,3321555,28892
28434,Quay,M,5,3321560,28521
28435,Quaylon,M,5,3321565,28055
28436,Queensley,F,5,3321570,28232
28437,Quency,M,5,3321575,28404
28438,Quetzal,M,5,3321580,28969
28439,Quillen,M,5,3321585,28528
28440,Quillon,M,5,3321590,28933
28441,Quince,M,5,3321595,28176
28442,Quinncy,M,5,3321600,28547
28443,Quitman,M,5,3321605,28755
28444,Raaghav,M,5,3321610,28811
28445,Raani,F,5,3321615,28572
28446,Rachit,M,5,3321620,28659
28447,Radeen,M,5,3321625,28044
28448,Radvin,M,5,3321630,28829
28449,Radwan,M,5,3321635,28887
28450,Radyn,M,5,3321640,28240
28451,Raeana,F,5,3321645,28589
28452,Raeanne,F,5,3321650,28196
28453,Raeleen,F,5,3321655,28066
28454,Raella,F,5,3321660,28027
28455,Raequan,M,5,3321665,28846
28456,Raeyah,F,5,3321670,28408
28457,Raffael,M,5,3321675,28823
28458,Rafiel,M,5,3321680,28692
28459,Ragnarok,M,5,3321685,28641
28460,Raheemah,F,5,3321690,28059
28461,Rahmatullah,F,5,3321695,28058
28462,Raida,F,5,3321700,28733
28463,Raifa,F,5,3321705,28283
28464,Raimy,F,5,3321710,28643
28465,Raistlin,M,5,3321715,28753
28466,Raiyaan,M,5,3321720,28944
28467,Raiyah,F,5,3321725,28359
28468,Rajiv,M,5,3321730,28815
28469,Rajvir,M,5,3321735,28924
28470,Rakhi,M,5,3321740,28790
28471,Rakin,M,5,3321745,28579
28472,Ralayah,F,5,3321750,28851
28473,Rambo,M,5,3321755,28390
28474,Rameer,M,5,3321760,28979
28475,Rameir,M,5,3321765,28915
28476,Ramello,M,5,3321770,28666
28477,Ramie,F,5,3321775,28338
28478,Ramsses,M,5,3321780,28108
28479,Randee,F,5,3321785,28751
28480,Randie,F,5,3321790,28853
28481,Randle,M,5,3321795,28347
28482,Rankin,M,5,3321800,28535
28483,Ransford,M,5,3321805,28431
28484,Ransh,M,5,3321810,28140
28485,Rasa,M,5,3321815,28395
28486,Rasaan,M,5,3321820,28565
28487,Rashida,F,5,3321825,28207
28488,Rasika,F,5,3321830,28878
28489,Rawda,F,5,3321835,28502
28490,Rawlin,M,5,3321840,28126
28491,Rayanthony,M,5,3321845,28885
28492,Raydin,M,5,3321850,28006
28493,Rayjay,M,5,3321855,28694
28494,Rayleah,F,5,3321860,28249
28495,Rayman,M,5,3321865,28556
28496,Raymie,F,5,3321870,28331
28497,Raymone,M,5,3321875,28113
28498,Rayvn,F,5,3321880,28889
28499,Rayya,F,5,3321885,28120
28500,Reagann,F,5,3321890,28495
28501,Recardo,M,5,3321895,28088
28502,Redeem,M,5,3321900,28479
28503,Reemas,F,5,3321905,28092
28504,Reginaldo,M,5,3321910,28295
28505,Regine,F,5,3321915,28717
28506,Regino,M,5,3321920,28794
28507,Region,M,5,3321925,28578
28508,Reha,F,5,3321930,28992
28509,Rehat,F,5,3321935,28542
28510,Reicher,M,5,3321940,28523
28511,Reighlee,F,5,3321945,28313
28512,Reighna,F,5,3321950,28788
28513,Reily,M,5,3321955,28321
28514,Reise,F,5,3321960,28309
28515,Reiss,F,5,3321965,28164
28516,Remey,M,5,3321970,28833
28517,Remiah,F,5,3321975,28760
28518,Remidee,F,5,3321980,28667
28519,Reni,F,5,3321985,28325
28520,Reniah,F,5,3321990,28966
28521,Reniya,F,5,3321995,28430
28522,Rennon,M,5,3322000,28896
28523,Renton,M,5,3322005,28972
28524,Revi,F,5,3322010,28177
28525,Revy,F,5,3322015,28741
28526,Rewa,F,5,3322020,28432
28527,Reyhan,M,5,3322025,28675
28528,Reylee,F,5,3322030,28385
28529,Reylen,M,5,3322035,28076
28530,Reylyn,F,5,3322040,28925
28531,Rezin,M,5,3322045,28740
28532,Rezwan,M,5,3322050,28838
28533,Rhealee,F,5,3322055,28574
28534,Rhiann,F,5,3322060,28195
28535,Rhyelle,F,5,3322065,28456
28536,Rhyian,F,5,3322070,28291
28537,Rhyla,F,5,3322075,28841
28538,Rhyson,M,5,3322080,28229
28539,Riad,M,5,3322085,28084
28540,Rias,F,5,3322090,28825
28541,Ricci,M,5,3322095,28420
28542,Richardo,M,5,3322100,28466
28543,Ricko,M,5,3322105,28730
28544,Ridgley,F,5,3322110,28704
28545,Ries,M,5,3322115,28199
28546,Rigden,M,5,3322120,28319
28547,Rilian,M,5,3322125,28297
28548,Rilley,F,5,3322130,28646
28549,Rim,F,5,3322135,28990
28550,Rinlee,F,5,3322140,28749
28551,Rise,M,5,3322145,28167
28552,Rishikesh,M,5,3322150,28470
28553,Rishitha,F,5,3322155,28911
28554,Rithika,F,5,3322160,28264
28555,Rithvi,F,5,3322165,28037
28556,Ritika,F,5,3322170,28458
28557,Ritter,M,5,3322175,28439
28558,Ritvi,F,5,3322180,28544
28559,Rjay,M,5,3322185,28725
28560,Rmon,M,5,3322190,28772
28561,Roaa,F,5,3322195,28621
28562,Roah,F,5,3322200,28203
28563,Roanan,M,5,3322205,28228
28564,Robbin,F,5,3322210,28172
28565,Rockefeller,M,5,3322215,28141
28566,Rocki,F,5,3322220,28143
28567,Rocklynn,F,5,3322225,28580
28568,Rodric,M,5,3322230,28976
28569,Roe,F,5,3322235,28192
28570,Roee,M,5,3322240,28290
28571,Roham,M,5,3322245,28016
28572,Rohi,M,5,3322250,28506
28573,Rola,F,5,3322255,28631
28574,Rolly,M,5,3322260,28440
28575,Romana,F,5,3322265,28119
28576,Romely,F,5,3322270,28785
28577,Romere,M,5,3322275,28647
28578,Romin,M,5,3322280,28721
28579,Rominna,F,5,3322285,28995
28580,Romio,M,5,3322290,28184
28581,Rommell,M,5,3322295,28327
28582,Roney,M,5,3322300,28954
28583,Rooster,M,5,3322305,28872
28584,Roqaya,F,5,3322310,28013
28585,Roric,M,5,3322315,28664
28586,Rosabell,F,5,3322320,28674
28587,Rosaleena,F,5,3322325,28926
28588,Rosaliyah,F,5,3322330,28886
28589,Rosalyna,F,5,3322335,28484
28590,Rosalynda,F,5,3322340,28750
28591,Rosalynne,F,5,3322345,28151
28592,Rosangela,F,5,3322350,28541
28593,Roselena,F,5,3322355,28427
28594,Rosellie,F,5,3322360,28210
28595,Rosemaria,F,5,3322365,28375
28596,Rosha,F,5,3322370,28051
28597,Roshelle,F,5,3322375,28257
28598,Rosio,F,5,3322380,28435
28599,Roslin,F,5,3322385,28903
28600,Rossie,F,5,3322390,28497
28601,Rousse,F,5,3322395,28671
28602,Rousseau,M,5,3322400,28447
28603,Rovan,F,5,3322405,28073
28604,Rownan,M,5,3322410,28539
28605,Roxi,F,5,3322415,28274
28606,Royall,F,5,3322420,28452
28607,Royalte,F,5,3322425,28701
28608,Royan,M,5,3322430,28174
28609,Royden,M,5,3322435,28329
28610,Royel,M,5,3322440,28553
28611,Rozae,M,5,3322445,28381
28612,Rozalee,F,5,3322450,28828
28613,Rozalin,F,5,3322455,28986
28614,Rozay,M,5,3322460,28117
28615,Rozaya,F,5,3322465,28554
28616,Rubye,F,5,3322470,28330
28617,Rudolfo,M,5,3322475,28221
28618,Rufio,M,5,3322480,28953
28619,Ruqiya,F,5,3322485,28255
28620,Rurik,M,5,3322490,28012
28621,Rushda,F,5,3322495,28950
28622,Ruslana,F,5,3322500,28917
28623,Rutherford,M,5,3322505,28418
28624,Ryana,F,5,3322510,28166
28625,Rydan,M,5,3322515,28111
28626,Ryel,F,5,3322520,28093
28627,Ryer,M,5,3322525,28244
28628,Ryhanna,F,5,3322530,28676
28629,Ryinn,F,5,3322535,28538
28630,Rykar,M,5,3322540,28085
28631,Rynley,F,5,3322545,28543
28632,Ryse,M,5,3322550,28487
28633,Ryze,M,5,3322555,28306
28634,Saaim,M,5,3322560,28583
28635,Saam,M,5,3322565,28282
28636,Saamir,M,5,3322570,28614
28637,Saanya,F,5,3322575,28536
28638,Saaral,F,5,3322580,28463
28639,Sabastion,M,5,3322585,28757
28640,Sabiel,M,5,3322590,28308
28641,Sabirah,F,5,3322595,28651
28642,Sabrine,F,5,3322600,28242
28643,Sadaya,F,5,3322605,28604
28644,Sadeem,F,5,3322610,28837
28645,Sadey,F,5,3322615,28642
28646,Sadieann,F,5,3322620,28645
28647,Sadiejane,F,5,3322625,28696
28648,Sadik,M,5,3322630,28123
28649,Sadira,F,5,3322635,28400
28650,Sador,F,5,3322640,28689
28651,Sae,F,5,3322645,28424
28652,Saed,M,5,3322650,28786
28653,Saelor,F,5,3322655,28752
28654,Safan,M,5,3322660,28148
28655,Safana,F,5,3322665,28386
28656,Sahaana,F,5,3322670,28693
28657,Sahab,F,5,3322675,28429
28658,Saheem,M,5,3322680,28246
28659,Sahory,F,5,3322685,28353
28660,Saiansh,M,5,3322690,28762
28661,Saidou,M,5,3322695,28890
28662,Saifullah,M,5,3322700,28131
28663,Saikrishna,M,5,3322705,28372
28664,Saile,F,5,3322710,28363
28665,Sailee,F,5,3322715,28632
28666,Sailer,F,5,3322720,28914
28667,Sairus,M,5,3322725,28449
28668,Saivion,M,5,3322730,28310
28669,Saiyon,M,5,3322735,28683
28670,Sakara,F,5,3322740,28764
28671,Sakeena,F,5,3322745,28685
28672,Sakhani,M,5,3322750,28206
28673,Sakiyah,F,5,3322755,28068
28674,Saksham,M,5,3322760,28501
28675,Saleha,F,5,3322765,28048
28676,Salimatou,F,5,3322770,28480
28677,Salmah,F,5,3322775,28293
28678,Salora,F,5,3322780,28200
28679,Samairah,F,5,3322785,28237
28680,Samariyah,F,5,3322790,28469
28681,Samerah,F,5,3322795,28107
28682,Samhitha,F,5,3322800,28656
28683,Samiir,M,5,3322805,28558
28684,Samip,M,5,3322810,28197
28685,Samirjon,M,5,3322815,28623
28686,Samrudh,M,5,3322820,28898
28687,Samuell,M,5,3322825,28369
28688,Samvit,M,5,3322830,28004
28689,San,M,5,3322835,28341
28690,Sanaai,F,5,3322840,28157
28691,Sanara,F,5,3322845,28276
28692,Sanne,F,5,3322850,28947
28693,Santigo,M,5,3322855,28648
28694,Saqib,M,5,3322860,28279
28695,Saqr,M,5,3322865,28100
28696,Sarahgrace,F,5,3322870,28807
28697,Saraiah,F,5,3322875,28185
28698,Sarang,F,5,3322880,28769
28699,Sardor,M,5,3322885,28198
28700,Sarelle,F,5,3322890,28147
28701,Sargis,M,5,3322895,28877
28702,Sariaya,F,5,3322900,28818
28703,Sarrah,F,5,3322905,28248
28704,Sascha,M,5,3322910,28508
28705,Savaughn,M,5,3322915,28686
28706,Savea,F,5,3322920,28039
28707,Savianna,F,5,3322925,28699
28708,Savin,M,5,3322930,28124
28709,Savino,M,5,3322935,28860
28710,Savy,F,5,3322940,28160
28711,Sayah,F,5,3322945,28989
28712,Saylee,F,5,3322950,28978
28713,Sayon,M,5,3322955,28350
28714,Schaefer,M,5,3322960,28407
28715,Scholar,M,5,3322965,28813
28716,Scylla,F,5,3322970,28205
28717,Season,F,5,3322975,28153
28718,Sebrina,F,5,3322980,28437
28719,Seely,F,5,3322985,28324
28720,Seerit,F,5,3322990,28661
28721,Sehar,F,5,3322995,28767
28722,Seiji,M,5,3323000,28754
28723,Seini,F,5,3323005,28919
28724,Seiya,M,5,3323010,28261
28725,Selassie,M,5,3323015,28628
28726,Semaje,M,5,3323020,28560
28727,Sen,M,5,3323025,28546
28728,Senara,F,5,3323030,28384
28729,Sencere,M,5,3323035,28799
28730,Senua,F,5,3323040,28024
28731,Serenityrose,F,5,3323045,28234
28732,Serenna,F,5,3323050,28081
28733,Serin,F,5,3323055,28943
28734,Serine,F,5,3323060,28729
28735,Set,M,5,3323065,28678
28736,Setareh,F,5,3323070,28453
28737,Seumas,M,5,3323075,28392
28738,Sevak,M,5,3323080,28956
28739,Sevannah,F,5,3323085,28958
28740,Seve,M,5,3323090,28747
28741,Shabazz,M,5,3323095,28712
28742,Shaelan,F,5,3323100,28988
28743,Shahab,M,5,3323105,28847
28744,Shahana,F,5,3323110,28218
28745,Shahed,F,5,3323115,28774
28746,Shahin,M,5,3323120,28723
28747,Shahina,F,5,3323125,28496
28748,Shahm,M,5,3323130,28835
28749,Shahveer,M,5,3323135,28773
28750,Shaikha,F,5,3323140,28745
28751,Shailah,F,5,3323145,28588
28752,Shailen,M,5,3323150,28247
28753,Shaiya,F,5,3323155,28742
28754,Shakayla,F,5,3323160,28010
28755,Shakiya,F,5,3323165,28003
28756,Shaley,F,5,3323170,28014
28757,Shalin,M,5,3323175,28932
28758,Shama,F,5,3323180,28494
28759,Shamaya,F,5,3323185,28937
28760,Shanae,F,5,3323190,28475
28761,Shanav,M,5,3323195,28809
28762,Shanay,M,5,3323200,28761
28763,Shantae,F,5,3323205,28848
28764,Shantall,F,5,3323210,28516
28765,Shante,F,5,3323215,28606
28766,Shantell,F,5,3323220,28812
28767,Shanyah,F,5,3323225,28121
28768,Shanyia,F,5,3323230,28146
28769,Sharaya,F,5,3323235,28963
28770,Sharika,F,5,3323240,28155
28771,Sharina,F,5,3323245,28457
28772,Sharrod,M,5,3323250,28224
28773,Sharvesh,M,5,3323255,28348
28774,Shavar,M,5,3323260,28782
28775,Shayn,M,5,3323265,28550
28776,Shazier,M,5,3323270,28593
28777,Shehbaaz,M,5,3323275,28322
28778,Sheku,M,5,3323280,28522
28779,Shelbee,F,5,3323285,28462
28780,Sher,M,5,3323290,28999
28781,Shereen,F,5,3323295,28272
28782,Sherrie,F,5,3323300,28074
28783,Sheva,F,5,3323305,28532
28784,Shianna,F,5,3323310,28619
28785,Shihab,M,5,3323315,28607
28786,Shin,M,5,3323320,28374
28787,Shirina,F,5,3323325,28850
28788,Shivesh,M,5,3323330,28951
28789,Shivi,F,5,3323335,28410
28790,Shmeil,M,5,3323340,28241
28791,Shola,F,5,3323345,28366
28792,Shreenika,F,5,3323350,28212
28793,Shreeyan,M,5,3323355,28509
28794,Shrija,F,5,3323360,28585
28795,Shriram,M,5,3323365,28657
28796,Shriyaan,M,5,3323370,28603
28797,Shy,M,5,3323375,28654
28798,Shyheem,M,5,3323380,28009
28799,Siaire,M,5,3323385,28490
28800,Siale,M,5,3323390,28215
28801,Sianney,F,5,3323395,28957
28802,Sidak,M,5,3323400,28700
28803,Siddhan,M,5,3323405,28865
28804,Siem,M,5,3323410,28412
28805,Silka,F,5,3323415,28980
28806,Silvie,F,5,3323420,28169
28807,Simir,M,5,3323425,28827
28808,Simisola,F,5,3323430,28907
28809,Simrin,F,5,3323435,28259
28810,Sinaya,F,5,3323440,28819
28811,Siranthony,M,5,3323445,28934
28812,Sircharles,M,5,3323450,28406
28813,Sirr,M,5,3323455,28116
28814,Sistine,F,5,3323460,28722
28815,Skaii,F,5,3323465,28719
28816,Skyemarie,F,5,3323470,28367
28817,Skylaa,F,5,3323475,28595
28818,Skylarr,F,5,3323480,28821
28819,Skylette,F,5,3323485,28931
28820,Skyra,F,5,3323490,28238
28821,Skyrah,F,5,3323495,28710
28822,Slader,M,5,3323500,28703
28823,Slevin,M,5,3323505,28289
28824,Sly,M,5,3323510,28540
28825,Socrates,M,5,3323515,28194
28826,Soe,F,5,3323520,28756
28827,Sofhia,F,5,3323525,28534
28828,Sofiarose,F,5,3323530,28945
28829,Sohvi,F,5,3323535,28477
28830,Solani,F,5,3323540,28505
28831,Solanus,M,5,3323545,28211
28832,Solenn,F,5,3323550,28086
28833,Solenne,F,5,3323555,28702
28834,Solvei,F,5,3323560,28559
28835,Somara,F,5,3323565,28971
28836,Somtochukwu,M,5,3323570,28445
28837,Son,M,5,3323575,28201
28838,Sonika,F,5,3323580,28303
28839,Sosie,F,5,3323585,28149
28840,Sotero,M,5,3323590,28287
28841,Soulayman,M,5,3323595,28304
28842,Sovann,M,5,3323600,28573
28843,Spurgeon,M,5,3323605,28779
28844,Sreeja,F,5,3323610,28489
28845,Sreenika,F,5,3323615,28738
28846,Sreeyansh,M,5,3323620,28899
28847,Srianshreddy,M,5,3323625,28728
28848,Srihari,M,5,3323630,28893
28849,Srihith,M,5,3323635,28062
28850,Srikari,F,5,3323640,28383
28851,Staley,F,5,3323645,28379
28852,Stanly,M,5,3323650,28530
28853,Starley,F,5,3323655,28436
28854,Stavya,M,5,3323660,28302
28855,Steffi,F,5,3323665,28122
28856,Stellamae,F,5,3323670,28743
28857,Stephaine,F,5,3323675,28488
28858,Stephy,F,5,3323680,28145
28859,Stina,F,5,3323685,28586
28860,Stonewall,M,5,3323690,28079
28861,Storee,F,5,3323695,28948
28862,Stormii,F,5,3323700,28434
28863,Stran,M,5,3323705,28938
28864,Suad,F,5,3323710,28777
28865,Subaru,M,5,3323715,28624
28866,Subhaan,M,5,3323720,28801
28867,Sulem,F,5,3323725,28922
28868,Sultaan,M,5,3323730,28800
28869,Sundae,F,5,3323735,28962
28870,Superior,M,5,3323740,28063
28871,Surrey,F,5,3323745,28334
28872,Surveen,F,5,3323750,28144
28873,Sussan,F,5,3323755,28091
28874,Suvir,M,5,3323760,28377
28875,Suzeth,F,5,3323765,28175
28876,Suzi,F,5,3323770,28533
28877,Swae,M,5,3323775,28668
28878,Swapnil,M,5,3323780,28888
28879,Swayzi,F,5,3323785,28577
28880,Sweden,F,5,3323790,28065
28881,Syanna,F,5,3323795,28964
28882,Sydnei,F,5,3323800,28739
28883,Syhir,M,5,3323805,28584
28884,Syllas,M,5,3323810,28038
28885,Sylvee,F,5,3323815,28222
28886,Syren,F,5,3323820,28568
28887,Taanvi,F,5,3323825,28736
28888,Taara,F,5,3323830,28214
28889,Taela,F,5,3323835,28401
28890,Taemin,M,5,3323840,28564
28891,Taeo,M,5,3323845,28271
28892,Taeshaun,M,5,3323850,28691
28893,Taeya,F,5,3323855,28357
28894,Taeyang,M,5,3323860,28485
28895,Tagen,M,5,3323865,28346
28896,Tahirah,F,5,3323870,28441
28897,Tahjae,M,5,3323875,28748
28898,Tahjere,M,5,3323880,28504
28899,Taichi,M,5,3323885,28040
28900,Taija,F,5,3323890,28901
28901,Taisei,M,5,3323895,28804
28902,Taitlyn,F,5,3323900,28844
28903,Taja,F,5,3323905,28069
28904,Tajae,M,5,3323910,28793
28905,Tajai,M,5,3323915,28170
28906,Tajuan,M,5,3323920,28940
28907,Takeshi,M,5,3323925,28125
28908,Takia,F,5,3323930,28035
28909,Talaia,F,5,3323935,28314
28910,Talbert,M,5,3323940,28486
28911,Taleb,M,5,3323945,28857
28912,Taleeah,F,5,3323950,28180
28913,Tallin,M,5,3323955,28134
28914,Taloni,F,5,3323960,28251
28915,Talton,M,5,3323965,28182
28916,Talulla,F,5,3323970,28862
28917,Talyah,F,5,3323975,28193
28918,Tamani,F,5,3323980,28842
28919,Tamaria,F,5,3323985,28351
28920,Tameah,F,5,3323990,28605
28921,Tamerlan,M,5,3323995,28780
28922,Tamra,F,5,3324000,28600
28923,Tamzyn,F,5,3324005,28387
28924,Tanayah,F,5,3324010,28133
28925,Tanis,M,5,3324015,28616
28926,Tanishi,F,5,3324020,28349
28927,Taniyla,F,5,3324025,28323
28928,Tarahji,F,5,3324030,28396
28929,Taraoluwa,F,5,3324035,28356
28930,Tareq,M,5,3324040,28031
28931,Tarez,M,5,3324045,28840
28932,Tarini,F,5,3324050,28473
28933,Tarius,M,5,3324055,28618
28934,Tarrance,M,5,3324060,28042
28935,Tashvi,F,5,3324065,28118
28936,Tasi,F,5,3324070,28362
28937,Tasman,M,5,3324075,28765
28938,Tasmia,F,5,3324080,28179
28939,Tathan,M,5,3324085,28561
28940,Tatyanna,F,5,3324090,28326
28941,Tavaria,F,5,3324095,28731
28942,Tavio,M,5,3324100,28090
28943,Tay,M,5,3324105,28582
28944,Taygen,F,5,3324110,28746
28945,Tayseer,M,5,3324115,28681
28946,Tayvien,M,5,3324120,28639
28947,Tayyibah,F,5,3324125,28269
28948,Teagann,F,5,3324130,28545
28949,Teagon,M,5,3324135,28137
28950,Teana,F,5,3324140,28423
28951,Teejay,M,5,3324145,28770
28952,Tehzeeb,F,5,3324150,28615
28953,Tejansh,M,5,3324155,28026
28954,Tekoa,M,5,3324160,28858
28955,Teliah,F,5,3324165,28994
28956,Tema,F,5,3324170,28455
28957,Temesgen,M,5,3324175,28732
28958,Temi,F,5,3324180,28759
28959,Temitope,F,5,3324185,28422
28960,Temmy,F,5,3324190,28262
28961,Tenia,F,5,3324195,28705
28962,Terance,M,5,3324200,28104
28963,Teresita,F,5,3324205,28928
28964,Teri,F,5,3324210,28831
28965,Terrie,F,5,3324215,28388
28966,Terrilynn,F,5,3324220,28337
28967,Terriona,F,5,3324225,28929
28968,Tesean,M,5,3324230,28340
28969,Tessalynn,F,5,3324235,28128
28970,Tesslyn,F,5,3324240,28105
28971,Testimony,M,5,3324245,28426
28972,Teyonna,F,5,3324250,28075
28973,Thailyn,F,5,3324255,28802
28974,Thaliana,F,5,3324260,28414
28975,Thanvika,F,5,3324265,28389
28976,Theadore,M,5,3324270,28503
28977,Thira,F,5,3324275,28305
28978,Thiya,F,5,3324280,28524
28979,Thom,M,5,3324285,28973
28980,Thomasjames,M,5,3324290,28975
28981,Thomasjohn,M,5,3324295,28152
28982,Thomson,M,5,3324300,28394
28983,Thorbjorn,M,5,3324305,28787
28984,Tiera,F,5,3324310,28548
28985,Tiferet,F,5,3324315,28820
28986,Tiller,M,5,3324320,28791
28987,Timari,F,5,3324325,28855
28988,Timiyah,F,5,3324330,28358
28989,Timya,F,5,3324335,28001
28990,Tinzlee,F,5,3324340,28225
28991,Tion,M,5,3324345,28481
28992,Tionne,F,5,3324350,28570
28993,Tiran,M,5,3324355,28507
28994,Tirion,M,5,3324360,28965
28995,Tirrell,M,5,3324365,28096
28996,Tirtza,F,5,3324370,28569
28997,Tishya,F,5,3324375,28320
28998,Tiwalade,F,5,3324380,28974
28999,Tkai,M,5,3324385,28127
29000,Tlaloc,M,5,3324390,29117
29001,Tniyah,F,5,3324395,29044
29002,Tobenna,M,5,3324400,29983
29003,Tobie,F,5,3324405,29593
29004,Tobyas,M,5,3324410,29338
29005,Tola,F,5,3324415,29577
29006,Tong,M,5,3324420,29456
29007,Toretto,M,5,3324425,29899
29008,Torii,F,5,3324430,29695
29009,Torynn,F,5,3324435,29859
29010,Toula,F,5,3324440,29667
29011,Tovi,F,5,3324445,29026
29012,Toviyah,F,5,3324450,29096
29013,Towns,M,5,3324455,29744
29014,Tracyn,M,5,3324460,29013
29015,Traivon,M,5,3324465,29618
29016,Tramir,M,5,3324470,29219
29017,Tranae,F,5,3324475,29412
29018,Trase,M,5,3324480,29736
29019,Trashawn,M,5,3324485,29608
29020,Travelle,M,5,3324490,29684
29021,Traveon,M,5,3324495,29484
29022,Travious,M,5,3324500,29471
29023,Trax,M,5,3324505,29344
29024,Treazzure,F,5,3324510,29913
29025,Trevonne,M,5,3324515,29754
29026,Treylon,M,5,3324520,29262
29027,Tri,M,5,3324525,29890
29028,Trianna,F,5,3324530,29664
29029,Trinten,M,5,3324535,29743
29030,Trinton,M,5,3324540,29051
29031,Trishaan,M,5,3324545,29951
29032,Truee,F,5,3324550,29938
29033,Trulie,F,5,3324555,29093
29034,Truvy,F,5,3324560,29661
29035,Trynity,F,5,3324565,29011
29036,Tuan,M,5,3324570,29413
29037,Tuana,F,5,3324575,29959
29038,Tuli,M,5,3324580,29339
29039,Tulia,F,5,3324585,29580
29040,Tvisha,F,5,3324590,29538
29041,Tyara,F,5,3324595,29595
29042,Tyari,F,5,3324600,29565
29043,Tyauna,F,5,3324605,29546
29044,Tyesha,F,5,3324610,29909
29045,Tyke,M,5,3324615,29347
29046,Tylaya,F,5,3324620,29965
29047,Tylaysia,F,5,3324625,29103
29048,Tylea,F,5,3324630,29237
29049,Tymire,M,5,3324635,29460
29050,Tyner,M,5,3324640,29053
29051,Tyrae,M,5,3324645,29252
29052,Tyreece,M,5,3324650,29775
29053,Tyreik,M,5,3324655,29054
29054,Tyrice,M,5,3324660,29498
29055,Tysir,M,5,3324665,29885
29056,Tywin,M,5,3324670,29937
29057,Tyzir,M,5,3324675,29464
29058,Tzion,M,5,3324680,29755
29059,Tzuri,F,5,3324685,29101
29060,Ubah,F,5,3324690,29318
29061,Ullr,M,5,3324695,29671
29062,Ulrik,M,5,3324700,29277
29063,Ulugbek,M,5,3324705,29945
29064,Ulyssa,F,5,3324710,29111
29065,Universe,F,5,3324715,29131
29066,Uraz,M,5,3324720,29164
29067,Urian,M,5,3324725,29156
29068,Usha,F,5,3324730,29392
29069,Usiel,M,5,3324735,29633
29070,Usmon,M,5,3324740,29688
29071,Uswa,F,5,3324745,29463
29072,Uvaldo,M,5,3324750,29454
29073,Uwase,F,5,3324755,29724
29074,Uzayr,M,5,3324760,29408
29075,Vadah,F,5,3324765,29729
29076,Vaela,F,5,3324770,29353
29077,Vaelin,M,5,3324775,29554
29078,Vaira,F,5,3324780,29548
29079,Valak,M,5,3324785,29585
29080,Valdemar,M,5,3324790,29462
29081,Valencio,M,5,3324795,29557
29082,Valentim,M,5,3324800,29865
29083,Vali,F,5,3324805,29807
29084,Valiente,M,5,3324810,29311
29085,Valik,M,5,3324815,29531
29086,Vallentina,F,5,3324820,29765
29087,Vallerie,F,5,3324825,29704
29088,Valli,F,5,3324830,29160
29089,Valyria,F,5,3324835,29602
29090,Vanadey,F,5,3324840,29960
29091,Vardaan,M,5,3324845,29749
29092,Varna,F,5,3324850,29447
29093,Vartan,M,5,3324855,29536
29094,Vasco,M,5,3324860,29872
29095,Vasilia,F,5,3324865,29811
29096,Vasudev,M,5,3324870,29855
29097,Vaydah,F,5,3324875,29653
29098,Vayden,M,5,3324880,29161
29099,Vaylen,F,5,3324885,29206
29100,Vea,F,5,3324890,29317
29101,Vedya,F,5,3324895,29158
29102,Vee,F,5,3324900,29358
29103,Venellope,F,5,3324905,29843
29104,Versai,M,5,3324910,29550
29105,Versailles,F,5,3324915,29269
29106,Viaana,F,5,3324920,29779
29107,Vianka,F,5,3324925,29737
29108,Vibhav,M,5,3324930,29672
29109,Vicktoria,F,5,3324935,29052
29110,Victoriana,F,5,3324940,29974
29111,Victorina,F,5,3324945,29301
29112,Victorious,M,5,3324950,29613
29113,Victorya,F,5,3324955,29615
29114,Vidhaan,M,5,3324960,29381
29115,Vigo,M,5,3324965,29629
29116,Vihaa,F,5,3324970,29698
29117,Vikrant,M,5,3324975,29840
29118,Vintage,F,5,3324980,29980
29119,Viridian,F,5,3324985,29911
29120,Viveca,F,5,3324990,29280
29121,Viveka,F,5,3324995,29303
29122,Voltaire,M,5,3325000,29246
29123,Voss,M,5,3325005,29766
29124,Vsevolod,M,5,3325010,29575
29125,Vukan,M,5,3325015,29527
29126,Vyomi,F,5,3325020,29701
29127,Vysion,F,5,3325025,29603
29128,Waelynn,F,5,3325030,29854
29129,Wahab,M,5,3325035,29975
29130,Wahid,M,5,3325040,29505
29131,Wailynn,F,5,3325045,29591
29132,Waker,M,5,3325050,29075
29133,Wakinyan,M,5,3325055,29814
29134,Waliyah,F,5,3325060,29069
29135,Wanita,F,5,3325065,29650
29136,Watsyn,M,5,3325070,29946
29137,Wattson,M,5,3325075,29085
29138,Weaver,M,5,3325080,29067
29139,Webber,M,5,3325085,29573
29140,Wellsley,F,5,3325090,29451
29141,Wen,F,5,3325095,29867
29142,Wenceslao,M,5,3325100,29953
29143,Wesli,F,5,3325105,29172
29144,Wila,F,5,3325110,29035
29145,Wildon,M,5,3325115,29496
29146,Willamae,F,5,3325120,29751
29147,Willoughby,F,5,3325125,29509
29148,Wilmary,F,5,3325130,29282
29149,Wilondja,M,5,3325135,29948
29150,Winchester,M,5,3325140,29809
29151,Winnter,F,5,3325145,29788
29152,Winny,F,5,3325150,29468
29153,Winrey,F,5,3325155,29631
29154,Winta,F,5,3325160,29979
29155,Wittman,M,5,3325165,29556
29156,Wrylie,F,5,3325170,29714
29157,Wrynlee,F,5,3325175,29238
29158,Wulfric,M,5,3325180,29990
29159,Wuraola,F,5,3325185,29894
29160,Wyld,M,5,3325190,29142
29161,Wynterrose,F,5,3325195,29441
29162,Xabi,M,5,3325200,29806
29163,Xahria,F,5,3325205,29234
29164,Xailynn,F,5,3325210,29295
29165,Xaiya,F,5,3325215,29193
29166,Xalynn,F,5,3325220,29599
29167,Xanden,M,5,3325225,29094
29168,Xania,F,5,3325230,29196
29169,Xaviana,F,5,3325235,29008
29170,Xaviel,M,5,3325240,29819
29171,Xaydrian,M,5,3325245,29041
29172,Xayvier,M,5,3325250,29474
29173,Xcaret,F,5,3325255,29851
29174,Xella,F,5,3325260,29151
29175,Xeven,M,5,3325265,29253
29176,Xiamara,F,5,3325270,29789
29177,Xiara,F,5,3325275,29405
29178,Xiclali,F,5,3325280,29351
29179,Xin,F,5,3325285,29005
29180,Xina,F,5,3325290,29768
29181,Xitlalic,F,5,3325295,29293
29182,Xiyan,F,5,3325300,29366
29183,Xora,F,5,3325305,29964
29184,Xzaiden,M,5,3325310,29530
29185,Xzavior,M,5,3325315,29031
29186,Xzayden,M,5,3325320,29803
29187,Yaalini,F,5,3325325,29677
29188,Yaasir,M,5,3325330,29006
29189,Yachy,F,5,3325335,29217
29190,Yadir,M,5,3325340,29904
29191,Yadrian,M,5,3325345,29228
29192,Yaely,F,5,3325350,29665
29193,Yahna,F,5,3325355,29503
29194,Yahra,F,5,3325360,29617
29195,Yahri,F,5,3325365,29738
29196,Yaileen,F,5,3325370,29030
29197,Yajur,M,5,3325375,29038
29198,Yakob,M,5,3325380,29276
29199,Yaletzi,F,5,3325385,29459
29200,Yali,F,5,3325390,29299
29201,Yaliah,F,5,3325395,29962
29202,Yami,F,5,3325400,29941
29203,Yamili,F,5,3325405,29139
29204,Yanai,M,5,3325410,29522
29205,Yanal,M,5,3325415,29436
29206,Yanay,F,5,3325420,29084
29207,Yancarlo,M,5,3325425,29712
29208,Yanci,F,5,3325430,29146
29209,Yaneisy,F,5,3325435,29985
29210,Yanel,F,5,3325440,29823
29211,Yanellie,F,5,3325445,29022
29212,Yanielis,F,5,3325450,29574
29213,Yanneli,F,5,3325455,29112
29214,Yao,M,5,3325460,29243
29215,Yaqoob,M,5,3325465,29925
29216,Yarden,M,5,3325470,29270
29217,Yaremi,F,5,3325475,29776
29218,Yaretsi,F,5,3325480,29734
29219,Yarielys,F,5,3325485,29445
29220,Yaritzel,F,5,3325490,29287
29221,Yasar,M,5,3325495,29801
29222,Yashar,M,5,3325500,29062
29223,Yashira,F,5,3325505,29360
29224,Yasma,F,5,3325510,29298
29225,Yassmin,F,5,3325515,29414
29226,Yasuri,F,5,3325520,29651
29227,Yaxel,M,5,3325525,29389
29228,Yazmina,F,5,3325530,29416
29229,Yazmyn,F,5,3325535,29202
29230,Yehudit,F,5,3325540,29929
29231,Yeicob,M,5,3325545,29999
29232,Yeilani,F,5,3325550,29787
29233,Yen,M,5,3325555,29705
29234,Yenni,F,5,3325560,29091
29235,Yeraldi,F,5,3325565,29242
29236,Yesha,F,5,3325570,29687
29237,Yesli,F,5,3325575,29662
29238,Yeslie,F,5,3325580,29645
29239,Yetzel,M,5,3325585,29190
29240,Yeyetzi,F,5,3325590,29623
29241,Yeyson,M,5,3325595,29140
29242,Yiddy,M,5,3325600,29184
29243,Yiovanni,M,5,3325605,29709
29244,Yissochor,M,5,3325610,29058
29245,Yitong,F,5,3325615,29896
29246,Yitzel,F,5,3325620,29589
29247,Yixuan,F,5,3325625,29850
29248,Yizel,F,5,3325630,29386
29249,Ylan,M,5,3325635,29571
29250,Ylva,F,5,3325640,29747
29251,Yoandy,M,5,3325645,29915
29252,Yohaan,M,5,3325650,29430
29253,Yolany,F,5,3325655,29345
29254,Yonasan,M,5,3325660,29770
29255,Yordanos,F,5,3325665,29700
29256,Yoshio,M,5,3325670,29875
29257,Yovan,M,5,3325675,29336
29258,Ysidro,M,5,3325680,29264
29259,Ytzel,F,5,3325685,29450
29260,Yuhan,F,5,3325690,29418
29261,Yuji,M,5,3325695,29419
29262,Yulema,F,5,3325700,29437
29263,Yuliani,F,5,3325705,29845
29264,Yume,F,5,3325710,29260
29265,Yunalesca,F,5,3325715,29966
29266,Yunes,M,5,3325720,29798
29267,Yuriy,M,5,3325725,29099
29268,Yuzuki,F,5,3325730,29254
29269,Yy,M,5,3325735,29889
29270,Zabian,M,5,3325740,29049
29271,Zaccheus,M,5,3325745,29526
29272,Zachai,M,5,3325750,29077
29273,Zacharius,M,5,3325755,29019
29274,Zackariya,M,5,3325760,29569
29275,Zacorey,M,5,3325765,29564
29276,Zadien,M,5,3325770,29040
29277,Zaelee,F,5,3325775,29534
29278,Zaeleigh,F,5,3325780,29401
29279,Zaevon,M,5,3325785,29897
29280,Zafirah,F,5,3325790,29212
29281,Zafiro,F,5,3325795,29343
29282,Zaheen,M,5,3325800,29903
29283,Zaheer,M,5,3325805,29630
29284,Zahiya,F,5,3325810,29296
29285,Zahri,F,5,3325815,29274
29286,Zahriya,F,5,3325820,29927
29287,Zaily,F,5,3325825,29926
29288,Zaivier,M,5,3325830,29648
29289,Zakaiden,M,5,3325835,29489
29290,Zakaryah,M,5,3325840,29004
29291,Zakee,M,5,3325845,29102
29292,Zakeem,M,5,3325850,29000
29293,Zakirah,F,5,3325855,29272
29294,Zakiy,M,5,3325860,29469
29295,Zaleia,F,5,3325865,29649
29296,Zaleya,F,5,3325870,29727
29297,Zaliya,F,5,3325875,29581
29298,Zamair,M,5,3325880,29792
29299,Zamarii,M,5,3325885,29968
29300,Zamoria,F,5,3325890,29136
29301,Zamyiah,F,5,3325895,29483
29302,Zan,M,5,3325900,29908
29303,Zanaiyah,F,5,3325905,29893
29304,Zanaria,F,5,3325910,29639
29305,Zariella,F,5,3325915,29523
29306,Zarifa,F,5,3325920,29205
29307,Zarin,F,5,3325925,29443
29308,Zarria,F,5,3325930,29699
29309,Zaul,M,5,3325935,29517
29310,Zavannah,F,5,3325940,29828
29311,Zavaya,F,5,3325945,29822
29312,Zavayah,F,5,3325950,29864
29313,Zavontae,M,5,3325955,29135
29314,Zaydie,F,5,3325960,29396
29315,Zayion,M,5,3325965,29394
29316,Zaymar,M,5,3325970,29956
29317,Zaymir,M,5,3325975,29540
29318,Zayquan,M,5,3325980,29528
29319,Zayvin,M,5,3325985,29995
29320,Zealan,M,5,3325990,29879
29321,Zeandre,M,5,3325995,29261
29322,Zeanna,F,5,3326000,29377
29323,Zecharias,M,5,3326005,29027
29324,Zecharyah,M,5,3326010,29878
29325,Zeida,F,5,3326015,29634
29326,Zeik,M,5,3326020,29455
29327,Zekai,M,5,3326025,29034
29328,Zelaya,F,5,3326030,29532
29329,Zeliah,F,5,3326035,29304
29330,Zeline,F,5,3326040,29781
29331,Zell,M,5,3326045,29637
29332,Zenab,F,5,3326050,29891
29333,Zende,M,5,3326055,29626
29334,Zeni,F,5,3326060,29213
29335,Zeo,M,5,3326065,29558
29336,Zephyra,F,5,3326070,29782
29337,Zerah,F,5,3326075,29568
29338,Zerrick,M,5,3326080,29790
29339,Zeshan,M,5,3326085,29407
29340,Zeyah,F,5,3326090,29910
29341,Zeyda,F,5,3326095,29433
29342,Zeyn,M,5,3326100,29356
29343,Zhalia,F,5,3326105,29127
29344,Zhenya,F,5,3326110,29816
29345,Zhi,M,5,3326115,29197
29346,Zhiyi,F,5,3326120,29354
29347,Zhoey,F,5,3326125,29180
29348,Ziamara,F,5,3326130,29981
29349,Ziani,F,5,3326135,29187
29350,Ziayre,M,5,3326140,29940
29351,Zichen,M,5,3326145,29750
29352,Ziheng,M,5,3326150,29740
29353,Zila,F,5,3326155,29876
29354,Ziley,F,5,3326160,29479
29355,Zimmal,F,5,3326165,29404
29356,Zinachimdi,F,5,3326170,29255
29357,Zinaya,F,5,3326175,29970
29358,Zio,M,5,3326180,29174
29359,Ziomara,F,5,3326185,29510
29360,Ziquan,M,5,3326190,29656
29361,Zire,M,5,3326195,29721
29362,Zirel,F,5,3326200,29335
29363,Zitlaly,F,5,3326205,29620
29364,Zixi,F,5,3326210,29183
29365,Ziyani,F,5,3326215,29039
29366,Zkai,M,5,3326220,29873
29367,Zlaty,F,5,3326225,29525
29368,Zoah,F,5,3326230,29576
29369,Zoeey,F,5,3326235,29832
29370,Zoelynn,F,5,3326240,29773
29371,Zoeyann,F,5,3326245,29476
29372,Zoeymarie,F,5,3326250,29080
29373,Zoeyrose,F,5,3326255,29010
29374,Zolana,F,5,3326260,29611
29375,Zolee,F,5,3326265,29329
29376,Zolin,M,5,3326270,29681
29377,Zophie,F,5,3326275,29715
29378,Zoriana,F,5,3326280,29060
29379,Zoser,M,5,3326285,29271
29380,Zoyah,F,5,3326290,29786
29381,Zsofia,F,5,3326295,29939
29382,Zuhra,F,5,3326300,29225
29383,Zuhri,F,5,3326305,29805
29384,Zuleimy,F,5,3326310,29833
29385,Zulma,F,5,3326315,29713
29386,Zuni,F,5,3326320,29411
29387,Zurah,F,5,3326325,29604
29388,Zurain,M,5,3326330,29251
29389,Zyairah,F,5,3326335,29758
29390,Zyare,M,5,3326340,29831
29391,Zygmunt,M,5,3326345,29793
29392,Zyhaire,M,5,3326350,29673
29393,Zyheem,M,5,3326355,29363
29394,Zykel,M,5,3326360,29290
29395,Zyking,M,5,3326365,29194
29396,Zyliyah,F,5,3326370,29996
29397,Zymia,F,5,3326375,29856
29398,Zymirah,F,5,3326380,29877
29399,Zyn,M,5,3326385,29753
29400,Zyna,F,5,3326390,29121
29401,Zynlee,F,5,3326395,29933
29402,Zyran,M,5,3326400,29342
29403,Zyrielle,F,5,3326405,29116
29404,Aonghas,M,4,3326409,29473
29405,Arlah,F,4,3326413,29171
29406,Caolan,M,4,3326417,29488
29407,Coll,M,4,3326421,29285
29408,Jorgi,F,4,3326425,29512
29409,Jura,M,4,3326429,29009
29410,Kornelia,F,4,3326433,29494
29411,Lomond,M,4,3326437,29449
29412,Milosz,M,4,3326441,29640
29413,Pearse,M,4,3326445,29492
29414,Seonaidh,M,4,3326449,29020
29415,Aaran,M,3,3326452,29818
29416,Alyth,F,3,3326455,29795
29417,Aonghus,M,3,3326458,29204
29418,Baillie,F,3,3326461,29278
29419,Bethan,F,3,3326464,29849
29420,Cezary,M,3,3326467,29327
29421,Chay,M,3,3326470,29916
29422,Cobyn,M,3,3326473,29179
29423,Copland,M,3,3326476,29742
29424,Eimear,F,3,3326479,29881
29425,Eirinn,F,3,3326482,29147
29426,Ffion,F,3,3326485,29397
29427,Frazer,M,3,3326488,29081
29428,Georgi,F,3,3326491,29683
29429,Gethin,M,3,3326494,29949
29430,Greig,M,3,3326497,29610
29431,Innis,M,3,3326500,29114
29432,Ishbel,F,3,3326503,29746
29433,Iustin,M,3,3326506,29186
29434,Kerys,F,3,3326509,29357
29435,Kornel,M,3,3326512,29018
29436,Liusaidh,F,3,3326515,29930
29437,Lochie,M,3,3326518,29862
29438,Malgorzata,F,3,3326521,29373
29439,Marsali,F,3,3326524,29250
29440,Morag,F,3,3326527,29748
29441,Murryn,F,3,3326530,29552
29442,Neive,F,3,3326533,29387
29443,Nimrah,F,3,3326536,29235
29444,Rahela,F,3,3326539,29383
29445,Ralphy,M,3,3326542,29511
29446,Reevah,F,3,3326545,29944
29447,Rhudi,M,3,3326548,29001
29448,Roberts,M,3,3326551,29074
29449,Ruan,M,3,3326554,29943
29450,Sigurd,M,3,3326557,29860
29451,Thorfinn,M,3,3326560,29300
29452,Weronika,F,3,3326563,29706
29453,Aaidah,F,2,3326565,29934
29454,Adie,M,2,3326567,29109
29455,Aian,M,2,3326569,29696
29456,Ailbhe,F,2,3326571,29113
29457,Alexandrina,F,2,3326573,29332
29458,Alisdair,M,2,3326575,29177
29459,Aliyaan,M,2,3326577,29745
29460,Anays,F,2,3326579,29827
29461,Anupriya,F,2,3326581,29200
29462,Argyle,M,2,3326583,29977
29463,Asel,F,2,3326585,29572
29464,Atholl,M,2,3326587,29594
29465,Balfour,M,2,3326589,29752
29466,Breagh,F,2,3326591,29231
29467,Bronagh,F,2,3326593,29380
29468,Buzz,M,2,3326595,29378
29469,Cadha,F,2,3326597,29646
29470,Cailan,M,2,3326599,29710
29471,Caillan,M,2,3326601,29928
29472,Cally,F,2,3326603,29024
29473,Caoimhin,M,2,3326605,29390
29474,Ceitidh,F,2,3326607,29420
29475,Cliona,F,2,3326609,29083
29476,Coben,M,2,3326611,29170
29477,Darach,M,2,3326613,29559
29478,Dayle,M,2,3326615,29333
29479,Dearbhla,F,2,3326617,29268
29480,Derry,M,2,3326619,29050
29481,Deryn,F,2,3326621,29143
29482,Domantas,M,2,3326623,29070
29483,Dominykas,M,2,3326625,29658
29484,Dovydas,M,2,3326627,29061
29485,Eabha,F,2,3326629,29504
29486,Eesah,M,2,3326631,29226
29487,Elijus,M,2,3326633,29942
29488,Emils,M,2,3326635,29762
29489,Enlli,F,2,3326637,29644
29490,Erland,M,2,3326639,29257
29491,Eszter,F,2,3326641,29265
29492,Ewa,F,2,3326643,29582
29493,Farwah,F,2,3326645,29579
29494,Faustas,M,2,3326647,29888
29495,Fayzan,M,2,3326649,29382
29496,Fearn,F,2,3326651,29429
29497,Floraidh,F,2,3326653,29586
29498,Florrie,F,2,3326655,29029
29499,Fyfe,M,2,3326657,29442
29500,Gaja,F,2,3326659,29663
29501,Geordie,M,2,3326661,29487
29502,Harri,M,2,3326663,29583
29503,Herkus,M,2,3326665,29507
29504,Jagoda,F,2,3326667,29802
29505,Keavie,F,2,3326669,29784
29506,Ker,M,2,3326671,29337
29507,Kieara,F,2,3326673,29501
29508,Kinlay,M,2,3326675,29722
29509,Klae,M,2,3326677,29220
29510,Kobin,M,2,3326679,29072
29511,Kobyn,M,2,3326681,29660
29512,Konstanty,M,2,3326683,29628
29513,Kray,M,2,3326685,29088
29514,Ksawery,M,2,3326687,29071
29515,Kuba,M,2,3326689,29655
29516,Leja,F,2,3326691,29560
29517,Lotti,F,2,3326693,29780
29518,Lyal,M,2,3326695,29115
29519,Malwina,F,2,3326697,29917
29520,Millen,M,2,3326699,29992
29521,Mohab,M,2,3326701,29997
29522,Moray,M,2,3326703,29676
29523,Mubeen,M,2,3326705,29042
29524,Muireann,F,2,3326707,29082
29525,Nawaz,M,2,3326709,29895
29526,Nerea,F,2,3326711,29785
29527,Orran,M,2,3326713,29621
29528,Oskaras,M,2,3326715,29606
29529,Pip,M,2,3326717,29055
29530,Reve,M,2,3326719,29605
29531,Rhogan,M,2,3326721,29323
29532,Rhu,M,2,3326723,29230
29533,Rhue,F,2,3326725,29497
29534,Rionagh,F,2,3326727,29233
29535,Ruaidhri,M,2,3326729,29592
29536,Rumaysah,F,2,3326731,29322
29537,Rusalina,F,2,3326733,29210
29538,Safah,F,2,3326735,29137
29539,Saffie,F,2,3326737,29016
29540,Seb,M,2,3326739,29947
29541,Seoras,M,2,3326741,29167
29542,Shaunnie,F,2,3326743,29453
29543,Shiza,F,2,3326745,29037
29544,Simina,F,2,3326747,29728
29545,Somhairle,M,2,3326749,29362
29546,Sorley,M,2,3326751,29757
29547,Sri,F,2,3326753,29090
29548,Tiarnan,M,2,3326755,29286
29549,Torran,M,2,3326757,29636
29550,Tuba,F,2,3326759,29533
29551,Vilte,F,2,3326761,29439
29552,Wojciech,M,2,3326763,29543
29553,Ya,F,2,3326765,29482
29554,Aafiq,M,1,3326766,29063
29555,Aaiva,F,1,3326767,29759
29556,Aalea,F,1,3326768,29245
29557,Aaleigha,F,1,3326769,29596
29558,Aalifa,F,1,3326770,29914
29559,Aamie,F,1,3326771,29804
29560,Aaneyah,F,1,3326772,29201
29561,Aanhad,M,1,3326773,29799
29562,Aania,F,1,3326774,29427
29563,Aansh,M,1,3326775,29375
29564,Aarchie,F,1,3326776,29316
29565,Aarla,F,1,3326777,29320
29566,Aaroh,M,1,3326778,29969
29567,Aaryanna,F,1,3326779,29836
29568,Aaryia,F,1,3326780,29561
29569,Aathiran,M,1,3326781,29032
29570,Aaycen,M,1,3326782,29922
29571,Aayesha,F,1,3326783,29100
29572,Aaylah,F,1,3326784,29247
29573,Aaziz,F,1,3326785,29425
29574,Abdalah,M,1,3326786,29092
29575,Abdelmoneim,M,1,3326787,29797
29576,Abdoulie,M,1,3326788,29491
29577,Abduallah,M,1,3326789,29199
29578,Abdulrazzaq,M,1,3326790,29967
29579,Abduraheem,M,1,3326791,29732
29580,Abdussalam,M,1,3326792,29562
29581,Abhainn,M,1,3326793,29258
29582,Abhav,M,1,3326794,29769
29583,Abhyuday,M,1,3326795,29098
29584,Abinav,M,1,3326796,29328
29585,Abiral,M,1,3326797,29297
29586,Abiselom,M,1,3326798,29972
29587,Abtin,M,1,3326799,29138
29588,Acee,M,1,3326800,29931
29589,Achim,M,1,3326801,29478
29590,Adalet,F,1,3326802,29216
29591,Adamas,M,1,3326803,29600
29592,Adas,M,1,3326804,29374
29593,Adbah,F,1,3326805,29643
29594,Addhafir,M,1,3326806,29224
29595,Addysyn,F,1,3326807,29988
29596,Adebare,M,1,3326808,29982
29597,Adebola,F,1,3326809,29461
29598,Adheen,M,1,3326810,29457
29599,Adhiya,F,1,3326811,29919
29600,Adimchinobi,M,1,3326812,29448
29601,Adita,F,1,3326813,29921
29602,Adjoa,F,1,3326814,29731
29603,Adrians,M,1,3326815,29905
29604,Adrius,M,1,3326816,29359
29605,Adyss,F,1,3326817,29675
29606,Aemil,M,1,3326818,29989
29607,Afeeya,F,1,3326819,29087
29608,Afizah,F,1,3326820,29195
29609,Afolabi,M,1,3326821,29307
29610,Afolawe,F,1,3326822,29145
29611,Afsah,F,1,3326823,29400
29612,Agha,M,1,3326824,29166
29613,Agham,M,1,3326825,29725
29614,Ahlby,M,1,3326826,29870
29615,Ahran,M,1,3326827,29308
29616,Ahrya,F,1,3326828,29129
29617,Aibrahym,M,1,3326829,29963
29618,Aiddah,F,1,3326830,29984
29619,Aiiila,F,1,3326831,29539
29620,Aijaz,M,1,3326832,29218
29621,Ailbie,M,1,3326833,29624
29622,Aimel,F,1,3326834,29130
29623,Aimellia,F,1,3326835,29808
29624,Ainey,M,1,3326836,29735
29625,Airith,M,1,3326837,29741
29626,Aise,F,1,3326838,29678
29627,Ajsa,F,1,3326839,29670
29628,Ajus,M,1,3326840,29733
29629,Akaal,M,1,3326841,29767
29630,Akinmade,M,1,3326842,29326
29631,Akvile,F,1,3326843,29774
29632,Alaana,F,1,3326844,29348
29633,Alaeze,F,1,3326845,29852
29634,Alaistair,M,1,3326846,29395
29635,Alanas,M,1,3326847,29679
29636,Alaniz,F,1,3326848,29477
29637,Aleasha,F,1,3326849,29892
29638,Aled,M,1,3326850,29410
29639,Aleecia,F,1,3326851,29467
29640,Aleezah,F,1,3326852,29886
29641,Aleighs,F,1,3326853,29403
29642,Alexica,F,1,3326854,29813
29643,Alfee,M,1,3326855,29490
29644,Alfons,M,1,3326856,29954
29645,Alfonsina,F,1,3326857,29632
29646,Alhora,F,1,3326858,29826
29647,Alienor,F,1,3326859,29868
29648,Alirea,F,1,3326860,29229
29649,Alishah,F,1,3326861,29025
29650,Alishbah,F,1,3326862,29647
29651,Aljaili,M,1,3326863,29835
29652,Allannia,F,1,3326864,29884
29653,Allaric,M,1,3326865,29043
29654,Altha,F,1,3326866,29641
29655,Alyshea,F,1,3326867,29033
29656,Amaaya,F,1,3326868,29950
29657,Amanpreet,F,1,3326869,29107
29658,Amanvir,M,1,3326870,29906
29659,Amanya,F,1,3326871,29516
29660,Ambre,F,1,3326872,29697
29661,Amelija,F,1,3326873,29128
29662,Anaaley,F,1,3326874,29105
29663,Anaf,M,1,3326875,29874
29664,Anakeni,F,1,3326876,29056
29665,Anatolia,F,1,3326877,29882
29666,Anaum,F,1,3326878,29829
29667,Ance,F,1,3326879,29305
29668,Andhrianos,M,1,3326880,29182
29669,Andhuvan,M,1,3326881,29570
29670,Andikan,M,1,3326882,29472
29671,Andrada,F,1,3326883,29520
29672,Andras,M,1,3326884,29674
29673,Andrejus,M,1,3326885,29866
29674,Anfaal,F,1,3326886,29341
29675,Anfal,F,1,3326887,29148
29676,Angadbir,M,1,3326888,29314
29677,Anishza,F,1,3326889,29957
29678,Annest,F,1,3326890,29810
29679,Annilyse,F,1,3326891,29880
29680,Annis,F,1,3326892,29066
29681,Ano,M,1,3326893,29361
29682,Anoor,M,1,3326894,29791
29683,Ansharah,F,1,3326895,29566
29684,Ansumana,M,1,3326896,29857
29685,Antek,M,1,3326897,29334
29686,Aoibhe,F,1,3326898,29587
29687,Aoibhinn,F,1,3326899,29152
29688,Aqdas,F,1,3326900,29694
29689,Arabela,F,1,3326901,29159
29690,Araisha,F,1,3326902,29312
29691,Aramya,F,1,3326903,29141
29692,Araucaria,F,1,3326904,29424
29693,Archi,M,1,3326905,29711
29694,Ardan,M,1,3326906,29064
29695,Ardashir,M,1,3326907,29499
29696,Ardena,F,1,3326908,29289
29697,Ardhy,M,1,3326909,29537
29698,Aretousa,F,1,3326910,29045
29699,Areyana,F,1,3326911,29209
29700,Argyll,M,1,3326912,29685
29701,Ariadni,F,1,3326913,29444
29702,Arijus,M,1,3326914,29991
29703,Ariko,M,1,3326915,29994
29704,Aristea,F,1,3326916,29417
29705,Arisu,F,1,3326917,29249
29706,Arkadiusz,M,1,3326918,29616
29707,Arlina,F,1,3326919,29861
29708,Aroha,F,1,3326920,29485
29709,Aroj,M,1,3326921,29707
29710,Arooj,F,1,3326922,29434
29711,Arrah,F,1,3326923,29726
29712,Arrian,M,1,3326924,29842
29713,Arsam,M,1,3326925,29638
29714,Arsel,M,1,3326926,29263
29715,Arsyila,F,1,3326927,29384
29716,Arteel,M,1,3326928,29821
29717,Artemios,M,1,3326929,29291
29718,Artioma,M,1,3326930,29153
29719,Arto,M,1,3326931,29976
29720,Arty,F,1,3326932,29958
29721,Arvis,M,1,3326933,29422
29722,Aryanathan,M,1,3326934,29502
29723,Ashim,M,1,3326935,29815
29724,Ashlea,F,1,3326936,29059
29725,Ashmith,M,1,3326937,29783
29726,Asmatullah,M,1,3326938,29028
29727,Assem,M,1,3326939,29612
29728,Asta,F,1,3326940,29007
29729,Asteya,F,1,3326941,29259
29730,Aswana,F,1,3326942,29012
29731,Atanas,M,1,3326943,29181
29732,Ather,M,1,3326944,29961
29733,Atiba,M,1,3326945,29824
29734,Atilla,M,1,3326946,29609
29735,Atla,F,1,3326947,29406
29736,Atmika,F,1,3326948,29124
29737,Aubyn,M,1,3326949,29306
29738,Auf,M,1,3326950,29122
29739,Augustyn,M,1,3326951,29379
29740,Aurrie,M,1,3326952,29232
29741,Avairy,F,1,3326953,29551
29742,Avarra,F,1,3326954,29907
29743,Avehe,M,1,3326955,29820
29744,Aviagh,F,1,3326956,29796
29745,Avraam,M,1,3326957,29690
29746,Avraj,M,1,3326958,29165
29747,Avtej,M,1,3326959,29223
29748,Awen,F,1,3326960,29848
29749,Awsan,M,1,3326961,29703
29750,Axll,M,1,3326962,29309
29751,Ayank,M,1,3326963,29693
29752,Ayevbosa,F,1,3326964,29057
29753,Ayleashateri,F,1,3326965,29764
29754,Ayleigh,F,1,3326966,29883
29755,Ayley,F,1,3326967,29192
29756,Aylish,F,1,3326968,29365
29757,Aymun,F,1,3326969,29106
29758,Ayna,F,1,3326970,29973
29759,Ayrun,M,1,3326971,29385
29760,Ayryn,M,1,3326972,29324
29761,Ayshenur,F,1,3326973,29515
29762,Ayushi,F,1,3326974,29508
29763,Ayzak,M,1,3326975,29739
29764,Azaiiyah,F,1,3326976,29150
29765,Azdrid,F,1,3326977,29952
29766,Azeen,F,1,3326978,29371
29767,Azhan,M,1,3326979,29578
29768,Azmayen,M,1,3326980,29198
29769,Azmi,M,1,3326981,29777
29770,Bacar,M,1,3326982,29717
29771,Bakri,M,1,3326983,29480
29772,Baldur,M,1,3326984,29211
29773,Balil,M,1,3326985,29590
29774,Banar,M,1,3326986,29014
29775,Bareera,F,1,3326987,29292
29776,Barima,M,1,3326988,29524
29777,Barkley,M,1,3326989,29340
29778,Barryjohn,M,1,3326990,29132
29779,Batyr,M,1,3326991,29588
29780,Bayer,M,1,3326992,29376
29781,Bazil,M,1,3326993,29173
29782,Beaufort,M,1,3326994,29901
29783,Befreen,F,1,3326995,29097
29784,Beftu,F,1,3326996,29607
29785,Bekk,M,1,3326997,29438
29786,Benas,M,1,3326998,29794
29787,Bendeguz,M,1,3326999,29834
29788,Beniamin,M,1,3327000,29841
29789,Benjymin,M,1,3327001,29435
29790,Benley,M,1,3327002,29598
29791,Benneit,M,1,3327003,29622
29792,Beugh,F,1,3327004,29514
29793,Bevan,M,1,3327005,29452
29794,Bhavtaz,M,1,3327006,29123
29795,Bhrodi,M,1,3327007,29691
29796,Bitanya,F,1,3327008,29154
29797,Biwar,M,1,3327009,29887
29798,Bligh,M,1,3327010,29756
29799,Bomen,M,1,3327011,29079
29800,Bon,M,1,3327012,29853
29801,Borislav,M,1,3327013,29325
29802,Boshra,F,1,3327014,29730
29803,Braa,F,1,3327015,29760
29804,Brae,F,1,3327016,29817
29805,Braegha,F,1,3327017,29837
29806,Braidan,M,1,3327018,29279
29807,Braith,M,1,3327019,29175
29808,Brajens,M,1,3327020,29284
29809,Bramble,F,1,3327021,29267
29810,Branik,M,1,3327022,29350
29811,Branimir,M,1,3327023,29227
29812,Braxx,M,1,3327024,29839
29813,Bridgit,F,1,3327025,29399
29814,Briea,F,1,3327026,29432
29815,Brieaca,F,1,3327027,29544
29816,Brinard,F,1,3327028,29157
29817,Broadie,M,1,3327029,29519
29818,Brodan,M,1,3327030,29912
29819,Broghan,F,1,3327031,29248
29820,Bryse,F,1,3327032,29431
29821,Bupe,F,1,3327033,29402
29822,Buraq,F,1,3327034,29918
29823,Butool,F,1,3327035,29215
29824,Cabe,M,1,3327036,29239
29825,Cadey,F,1,3327037,29155
29826,Cadhla,F,1,3327038,29214
29827,Caeben,M,1,3327039,29118
29828,Caellum,M,1,3327040,29283
29829,Caera,F,1,3327041,29567
29830,Caicee,F,1,3327042,29421
29831,Caicey,F,1,3327043,29144
29832,Caie,M,1,3327044,29481
29833,Cailie,F,1,3327045,29330
29834,Cairistiona,F,1,3327046,29191
29835,Cait,F,1,3327047,29470
29836,Calah,F,1,3327048,29244
29837,Calanais,F,1,3327049,29847
29838,Calize,F,1,3327050,29047
29839,Callah,F,1,3327051,29584
29840,Callidh,F,1,3327052,29702
29841,Calumn,M,1,3327053,29021
29842,Calyssa,F,1,3327054,29178
29843,Cambell,M,1,3327055,29313
29844,Camie,F,1,3327056,29108
29845,Carsan,F,1,3327057,29003
29846,Carta,M,1,3327058,29095
29847,Casea,F,1,3327059,29541
29848,Cathal,M,1,3327060,29920
29849,Catrin,F,1,3327061,29871
29850,Caylabe,M,1,3327062,29119
29851,Caylah,F,1,3327063,29331
29852,Caylan,M,1,3327064,29506
29853,Cayrn,M,1,3327065,29440
29854,Ce,F,1,3327066,29393
29855,Ceilidh,F,1,3327067,29133
29856,Ceira,F,1,3327068,29869
29857,Ceitlin,F,1,3327069,29682
29858,Ceryn,F,1,3327070,29547
29859,Chahat,F,1,3327071,29902
29860,Chang,M,1,3327072,29800
29861,Chaniel,M,1,3327073,29281
29862,Chantilly,F,1,3327074,29493
29863,Charleena,F,1,3327075,29900
29864,Charmian,F,1,3327076,29619
29865,Cheaunce,M,1,3327077,29275
29866,Cheng,M,1,3327078,29104
29867,Chiagozie,F,1,3327079,29763
29868,Chideziri,M,1,3327080,29321
29869,Chimara,F,1,3327081,29349
29870,Chimdike,F,1,3327082,29391
29871,Chimdinma,F,1,3327083,29542
29872,Chimfurumnanya,F,1,3327084,29369
29873,Chimuamanda,F,1,3327085,29657
29874,Chimzara,F,1,3327086,29771
29875,Chimzaram,F,1,3327087,29163
29876,Chimzorom,M,1,3327088,29266
29877,Chrissi,F,1,3327089,29388
29878,Chrissie,F,1,3327090,29466
29879,Christodoulia,F,1,3327091,29368
29880,Chukwudum,M,1,3327092,29073
29881,Cianan,M,1,3327093,29134
29882,Ciar,M,1,3327094,29518
29883,Ciaren,M,1,3327095,29372
29884,Ciaria,F,1,3327096,29513
29885,Cievah,F,1,3327097,29415
29886,Cilla,F,1,3327098,29310
29887,Ciorstaidh,F,1,3327099,29932
29888,Ciprian,M,1,3327100,29203
29889,Claiton,M,1,3327101,29352
29890,Claye,M,1,3327102,29426
29891,Cliodhna,F,1,3327103,29036
29892,Coban,M,1,3327104,29486
29893,Cobin,M,1,3327105,29346
29894,Coeray,M,1,3327106,29409
29895,Coghan,M,1,3327107,29149
29896,Coila,F,1,3327108,29015
29897,Coinneach,M,1,3327109,29668
29898,Coira,F,1,3327110,29086
29899,Coletyn,M,1,3327111,29188
29900,Colla,M,1,3327112,29545
29901,Conal,M,1,3327113,29185
29902,Conic,M,1,3327114,29987
29903,Conlie,M,1,3327115,29830
29904,Conlin,M,1,3327116,29189
29905,Conlon,M,1,3327117,29076
29906,Connach,M,1,3327118,29563
29907,Connah,M,1,3327119,29666
29908,Connaire,M,1,3327120,29625
29909,Connal,M,1,3327121,29089
29910,Connall,M,1,3327122,29978
29911,Connan,M,1,3327123,29692
29912,Conni,F,1,3327124,29367
29913,Connovar,M,1,3327125,29844
29914,Corla,F,1,3327126,29723
29915,Cormack,M,1,3327127,29846
29916,Cornel,M,1,3327128,29761
29917,Corr,M,1,3327129,29221
29918,Cuillan,M,1,3327130,29555
29919,Cuillin,M,1,3327131,29208
29920,Cuthbert,M,1,3327132,29023
29921,Cyria,F,1,3327133,29110
29922,Cyva,M,1,3327134,29288
29923,Daakshee,F,1,3327135,29319
29924,Dadiva,F,1,3327136,29686
29925,Daena,F,1,3327137,29222
29926,Daeney,F,1,3327138,29017
29927,Dagmara,F,1,3327139,29898
29928,Daithi,M,1,3327140,29256
29929,Daividh,M,1,3327141,29549
29930,Daleyr,F,1,3327142,29168
29931,Dalin,M,1,3327143,29241
29932,Dalloch,M,1,3327144,29716
29933,Dalriada,F,1,3327145,29065
29934,Damla,F,1,3327146,29986
29935,Danielius,M,1,3327147,29614
29936,Daniels,M,1,3327148,29046
29937,Danii,F,1,3327149,29689
29938,Daragh,M,1,3327150,29924
29939,Darceyleigh,F,1,3327151,29446
29940,Darlah,F,1,3327152,29458
29941,Darman,M,1,3327153,29935
29942,Darrach,M,1,3327154,29495
29943,Darrah,F,1,3327155,29169
29944,Darroch,M,1,3327156,29465
29945,Deacyn,M,1,3327157,29176
29946,Deane,M,1,3327158,29597
29947,Deceneu,M,1,3327159,29521
29948,Deeya,F,1,3327160,29718
29949,Deivik,M,1,3327161,29635
29950,Denisa,F,1,3327162,29680
29951,Deran,M,1,3327163,29273
29952,Derrie,F,1,3327164,29162
29953,Derryn,F,1,3327165,29315
29954,Dervla,F,1,3327166,29125
29955,Desireoluwa,M,1,3327167,29720
29956,Dexi,M,1,3327168,29002
29957,Dhana,F,1,3327169,29669
29958,Dhanwin,M,1,3327170,29398
29959,Dharla,F,1,3327171,29652
29960,Dhayaal,F,1,3327172,29601
29961,Dherri,F,1,3327173,29993
29962,Dhiksha,F,1,3327174,29364
29963,Dhillon,M,1,3327175,29529
29964,Dhruvik,M,1,3327176,29719
29965,Dicaprio,M,1,3327177,29838
29966,Dilek,F,1,3327178,29627
29967,Dinis,M,1,3327179,29825
29968,Dioreann,F,1,3327180,29294
29969,Dishita,F,1,3327181,29858
29970,Diwan,M,1,3327182,29240
29971,Diyar,M,1,3327183,29955
29972,Djawad,M,1,3327184,29236
29973,Dobromir,M,1,3327185,29654
29974,Doina,F,1,3327186,29048
29975,Doireann,F,1,3327187,29553
29976,Dolton,M,1,3327188,29475
29977,Doltyn,M,1,3327189,29708
29978,Dome,M,1,3327190,29812
29979,Domhnall,M,1,3327191,29207
29980,Dominican,M,1,3327192,29923
29981,Donnacha,M,1,3327193,29998
29982,Dorota,F,1,3327194,29078
29983,Dougie,M,1,3327195,29302
29984,Doune,F,1,3327196,29120
29985,Drummond,M,1,3327197,29659
29986,Druss,M,1,3327198,29778
29987,Duffy,M,1,3327199,29370
29988,Dur,F,1,3327200,29936
29989,Dyllann,F,1,3327201,29428
29990,Dziugas,M,1,3327202,29642
29991,Eaden,F,1,3327203,29355
29992,Eave,F,1,3327204,29535
29993,Ebonie,F,1,3327205,29500
29994,Ebou,M,1,3327206,29068
29995,Eddi,F,1,3327207,29971
29996,Edite,F,1,3327208,29772
29997,Edsger,M,1,3327209,29863
29998,Efa,F,1,3327210,29423
29999,Efah,F,1,3327211,29126
30000,Efterpi,F,1,3327212,30449
30001,Ehsin,M,1,3327213,30209
30002,Eia,F,1,3327214,30960
30003,Eidee,F,1,3327215,30685
30004,Eidis,F,1,3327216,30653
30005,Eifa,F,1,3327217,30249
30006,Eijaz,M,1,3327218,30410
30007,Eilif,M,1,3327219,30448
30008,Eimaan,F,1,3327220,30425
30009,Eimhir,F,1,3327221,30204
30010,Eirea,F,1,3327222,30970
30011,Eireann,F,1,3327223,30179
30012,Eisei,M,1,3327224,30143
30013,Eithne,F,1,3327225,30869
30014,Ekamjeet,F,1,3327226,30128
30015,Ekamveer,M,1,3327227,30897
30016,Ekman,F,1,3327228,30376
30017,Ektoras,M,1,3327229,30529
30018,Elaiyah,F,1,3327230,30584
30019,Elalouise,F,1,3327231,30871
30020,Eleira,F,1,3327232,30460
30021,Elinewinga,M,1,3327233,30825
30022,Elisaveta,F,1,3327234,30632
30023,Eliss,M,1,3327235,30716
30024,Elissandre,F,1,3327236,30892
30025,Elizabeta,F,1,3327237,30420
30026,Ellanyah,F,1,3327238,30282
30027,Elnaz,F,1,3327239,30819
30028,Elouan,M,1,3327240,30939
30029,Elsje,F,1,3327241,30456
30030,Eluid,M,1,3327242,30181
30031,Elyzia,F,1,3327243,30944
30032,Emer,F,1,3327244,30129
30033,Emilien,M,1,3327245,30552
30034,Emilios,M,1,3327246,30763
30035,Emire,F,1,3327247,30196
30036,Emmellen,F,1,3327248,30405
30037,Emrae,F,1,3327249,30887
30038,Enaam,F,1,3327250,30544
30039,Enara,F,1,3327251,30916
30040,Endian,F,1,3327252,30359
30041,Enifome,F,1,3327253,30995
30042,Enija,F,1,3327254,30849
30043,Enitanwa,F,1,3327255,30807
30044,Enol,M,1,3327256,30650
30045,Enxu,M,1,3327257,30327
30046,Eoghann,M,1,3327258,30126
30047,Eray,M,1,3327259,30822
30048,Erlend,M,1,3327260,30184
30049,Ermia,M,1,3327261,30319
30050,Eryx,M,1,3327262,30060
30051,Erzhan,M,1,3327263,30709
30052,Eshe,F,1,3327264,30147
30053,Esila,F,1,3327265,30497
30054,Estifanos,M,1,3327266,30074
30055,Etanas,M,1,3327267,30373
30056,Ethar,F,1,3327268,30171
30057,Euthymia,F,1,3327269,30377
30058,Evaa,F,1,3327270,30959
30059,Evanas,M,1,3327271,30833
30060,Evangelynn,F,1,3327272,30675
30061,Everlaii,F,1,3327273,30772
30062,Evinnie,F,1,3327274,30872
30063,Evrin,M,1,3327275,30078
30064,Excel,F,1,3327276,30731
30065,Eyaad,M,1,3327277,30517
30066,Eylah,F,1,3327278,30794
30067,Ezmii,F,1,3327279,30496
30068,Fady,M,1,3327280,30839
30069,Fadzai,F,1,3327281,30224
30070,Fahid,M,1,3327282,30773
30071,Fanmo,M,1,3327283,30318
30072,Faraquhar,M,1,3327284,30055
30073,Farhaz,M,1,3327285,30587
30074,Fariz,M,1,3327286,30273
30075,Farron,F,1,3327287,30222
30076,Farys,F,1,3327288,30617
30077,Farzan,M,1,3327289,30615
30078,Fathy,M,1,3327290,30630
30079,Fayha,F,1,3327291,30046
30080,Fazura,F,1,3327292,30364
30081,Feben,F,1,3327293,30086
30082,Feile,F,1,3327294,30471
30083,Feyza,F,1,3327295,30387
30084,Fiachra,M,1,3327296,30020
30085,Fiah,F,1,3327297,30507
30086,Fida,M,1,3327298,30721
30087,Fifer,F,1,3327299,30741
30088,Filimoni,M,1,3327300,30605
30089,Filipa,F,1,3327301,30472
30090,Fillan,M,1,3327302,30509
30091,Finnlaogh,M,1,3327303,30585
30092,Fionnain,M,1,3327304,30105
30093,Firas,M,1,3327305,30028
30094,Firoza,F,1,3327306,30844
30095,Fjonn,M,1,3327307,30865
30096,Flavius,M,1,3327308,30017
30097,Fleour,F,1,3327309,30760
30098,Florance,F,1,3327310,30766
30099,Florentyna,F,1,3327311,30537
30100,Flori,F,1,3327312,30367
30101,Flossie,F,1,3327313,30856
30102,Foley,M,1,3327314,30567
30103,Franek,M,1,3327315,30726
30104,Frayha,F,1,3327316,30637
30105,Frayja,F,1,3327317,30180
30106,Freddi,M,1,3327318,30431
30107,Freshta,F,1,3327319,30676
30108,Fritha,F,1,3327320,30232
30109,Fryderyk,M,1,3327321,30826
30110,Furkan,M,1,3327322,30090
30111,Fynnlay,M,1,3327323,30705
30112,Gabora,F,1,3327324,30502
30113,Gabriana,F,1,3327325,30033
30114,Galin,M,1,3327326,30108
30115,Galla,F,1,3327327,30454
30116,Gallacher,M,1,3327328,30796
30117,Galya,F,1,3327329,30664
30118,Garciella,F,1,3327330,30845
30119,Garon,M,1,3327331,30185
30120,Gayanthika,F,1,3327332,30335
30121,Gbemisola,F,1,3327333,30678
30122,Gearoid,M,1,3327334,30699
30123,Genessa,F,1,3327335,30941
30124,Georgena,F,1,3327336,30623
30125,Georgy,M,1,3327337,30432
30126,Georja,F,1,3327338,30781
30127,Gerasimos,M,1,3327339,30704
30128,Gergana,F,1,3327340,30677
30129,Geuomata,M,1,3327341,30089
30130,Ghezal,F,1,3327342,30008
30131,Ghulam,M,1,3327343,30809
30132,Gillen,M,1,3327344,30118
30133,Gillie,M,1,3327345,30303
30134,Giorgie,F,1,3327346,30333
30135,Gniewomir,M,1,3327347,30001
30136,Gnoveriti,F,1,3327348,30088
30137,Golam,M,1,3327349,30761
30138,Golibe,M,1,3327350,30943
30139,Gorkem,M,1,3327351,30061
30140,Graedyn,M,1,3327352,30296
30141,Gryffen,M,1,3327353,30770
30142,Gryfin,M,1,3327354,30500
30143,Gunes,F,1,3327355,30893
30144,Guravi,M,1,3327356,30492
30145,Gurekam,M,1,3327357,30347
30146,Gurmanjot,F,1,3327358,30573
30147,Gurwansh,M,1,3327359,30589
30148,Gurzack,M,1,3327360,30787
30149,Guste,F,1,3327361,30253
30150,Haadiya,F,1,3327362,30407
30151,Haala,F,1,3327363,30986
30152,Habibur,M,1,3327364,30951
30153,Hadee,M,1,3327365,30739
30154,Hadis,M,1,3327366,30568
30155,Haidara,M,1,3327367,30834
30156,Haigan,M,1,3327368,30065
30157,Haighden,M,1,3327369,30379
30158,Hajraah,F,1,3327370,30245
30159,Hajrah,F,1,3327371,30723
30160,Hamdaan,M,1,3327372,30175
30161,Hamdo,M,1,3327373,30434
30162,Hammanah,F,1,3327374,30494
30163,Hams,F,1,3327375,30047
30164,Haniye,F,1,3327376,30767
30165,Haniyya,F,1,3327377,30966
30166,Hannes,M,1,3327378,30792
30167,Hanro,M,1,3327379,30513
30168,Hanyia,F,1,3327380,30600
30169,Hao,M,1,3327381,30479
30170,Haram,F,1,3327382,30952
30171,Harbury,M,1,3327383,30634
30172,Harjapji,F,1,3327384,30813
30173,Harjeea,F,1,3327385,30230
30174,Harjot,F,1,3327386,30094
30175,Harliie,F,1,3327387,30831
30176,Harloh,F,1,3327388,30397
30177,Harmander,M,1,3327389,30113
30178,Haron,M,1,3327390,30627
30179,Harpriya,F,1,3327391,30592
30180,Harrisson,M,1,3327392,30563
30181,Harrissyn,M,1,3327393,30281
30182,Harrli,F,1,3327394,30551
30183,Harsimran,F,1,3327395,30011
30184,Haruna,F,1,3327396,30836
30185,Harys,F,1,3327397,30009
30186,Hashiny,F,1,3327398,30022
30187,Hasonat,F,1,3327399,30978
30188,Haton,F,1,3327400,30207
30189,Hauwa,F,1,3327401,30647
30190,Havian,F,1,3327402,30278
30191,Hawazin,F,1,3327403,30708
30192,Haydenne,F,1,3327404,30730
30193,Haydley,F,1,3327405,30130
30194,Hazlain,M,1,3327406,30394
30195,Heela,F,1,3327407,30861
30196,Heike,F,1,3327408,30395
30197,Helaine,F,1,3327409,30930
30198,Helin,F,1,3327410,30002
30199,Hemin,M,1,3327411,30689
30200,Hendry,M,1,3327412,30586
30201,Herkeet,F,1,3327413,30066
30202,Hew,M,1,3327414,30719
30203,Hewie,M,1,3327415,30884
30204,Hibbah,F,1,3327416,30436
30205,Hifza,F,1,3327417,30123
30206,Hirad,M,1,3327418,30340
30207,Hirsa,M,1,3327419,30724
30208,Hiza,F,1,3327420,30681
30209,Hoi,F,1,3327421,30571
30210,Hooriya,F,1,3327422,30178
30211,Hopi,F,1,3327423,30217
30212,Horia,F,1,3327424,30931
30213,Hukam,M,1,3327425,30798
30214,Hussnain,M,1,3327426,30214
30215,Huw,M,1,3327427,30354
30216,Huzaifah,M,1,3327428,30981
30217,Hyaan,M,1,3327429,30071
30218,Hydar,M,1,3327430,30141
30219,Hylton,M,1,3327431,30697
30220,Iagan,M,1,3327432,30670
30221,Iasmina,F,1,3327433,30652
30222,Iason,M,1,3327434,30658
30223,Ibrah,F,1,3327435,30860
30224,Ibukunoluwa,M,1,3327436,30999
30225,Idette,F,1,3327437,30081
30226,Ieva,F,1,3327438,30388
30227,Ifeanyi,M,1,3327439,30661
30228,Ifran,M,1,3327440,30881
30229,Ignas,M,1,3327441,30295
30230,Ijeze,F,1,3327442,30744
30231,Ilbey,M,1,3327443,30251
30232,Iley,F,1,3327444,30288
30233,Ilhaan,M,1,3327445,30157
30234,Illy,F,1,3327446,30950
30235,Imageon,F,1,3327447,30034
30236,Imali,F,1,3327448,30302
30237,Imke,F,1,3327449,30021
30238,Imma,F,1,3327450,30136
30239,Immi,F,1,3327451,30264
30240,Immillah,F,1,3327452,30795
30241,Ioana,F,1,3327453,30619
30242,Ionah,F,1,3327454,30545
30243,Ionatan,M,1,3327455,30352
30244,Ionut,M,1,3327456,30100
30245,Iordi,M,1,3327457,30194
30246,Iosif,M,1,3327458,30934
30247,Iraena,F,1,3327459,30688
30248,Ireoluwakitan,M,1,3327460,30701
30249,Iretioluwa,M,1,3327461,30116
30250,Irvine,M,1,3327462,30483
30251,Ishabel,F,1,3327463,30711
30252,Ishal,F,1,3327464,30145
30253,Issouf,M,1,3327465,30308
30254,Ivarr,M,1,3327466,30556
30255,Iveyleigh,F,1,3327467,30172
30256,Iwo,M,1,3327468,30121
30257,Iyada,F,1,3327469,30487
30258,Iyvhn,M,1,3327470,30416
30259,Izhaaq,M,1,3327471,30435
30260,Izobella,F,1,3327472,30162
30261,Jackob,M,1,3327473,30846
30262,Jacopo,M,1,3327474,30518
30263,Jacub,M,1,3327475,30579
30264,Jacus,M,1,3327476,30853
30265,Jaejae,F,1,3327477,30532
30266,Jafian,M,1,3327478,30167
30267,Jaikaar,M,1,3327479,30241
30268,Jaimiee,F,1,3327480,30830
30269,Jamielee,F,1,3327481,30385
30270,Janiba,F,1,3327482,30803
30271,Jann,M,1,3327483,30964
30272,Jany,F,1,3327484,30119
30273,Janyar,M,1,3327485,30954
30274,Jashvika,F,1,3327486,30690
30275,Jasnit,F,1,3327487,30231
30276,Jassar,M,1,3327488,30268
30277,Jaswinder,M,1,3327489,30103
30278,Javeria,F,1,3327490,30442
30279,Jaycey,F,1,3327491,30082
30280,Jebaibai,F,1,3327492,30044
30281,Jebii,F,1,3327493,30669
30282,Jedemiah,M,1,3327494,30588
30283,Jedrzej,M,1,3327495,30891
30284,Jeiran,F,1,3327496,30968
30285,Jekabs,M,1,3327497,30287
30286,Jem,M,1,3327498,30005
30287,Jemine,F,1,3327499,30751
30288,Jennae,F,1,3327500,30582
30289,Jennita,F,1,3327501,30817
30290,Jennson,M,1,3327502,30583
30291,Jeorjia,F,1,3327503,30927
30292,Jeremiasz,M,1,3327504,30215
30293,Jeshwin,M,1,3327505,30824
30294,Jessyca,F,1,3327506,30977
30295,Jezzelle,F,1,3327507,30380
30296,Jiaxuan,F,1,3327508,30362
30297,Jie,M,1,3327509,30541
30298,Jieun,F,1,3327510,30344
30299,Jinchen,M,1,3327511,30703
30300,Jip,M,1,3327512,30606
30301,Jock,M,1,3327513,30908
30302,Jockey,M,1,3327514,30139
30303,Johnnymartin,M,1,3327515,30260
30304,Jokubas,M,1,3327516,30920
30305,Jole,F,1,3327517,30098
30306,Jonjo,M,1,3327518,30411
30307,Jordanpreet,M,1,3327519,30430
30308,Joris,M,1,3327520,30829
30309,Joshdeep,M,1,3327521,30357
30310,Joshuaa,M,1,3327522,30428
30311,Jugraj,M,1,3327523,30200
30312,Julea,F,1,3327524,30369
30313,Julyous,M,1,3327525,30680
30314,Jumanah,F,1,3327526,30577
30315,Juneiper,F,1,3327527,30076
30316,Juwariah,F,1,3327528,30974
30317,Juwayriya,F,1,3327529,30457
30318,Juwayriyah,F,1,3327530,30247
30319,Jypsy,F,1,3327531,30640
30320,Kaatyayani,F,1,3327532,30645
30321,Kabinga,M,1,3327533,30298
30322,Kabyn,M,1,3327534,30140
30323,Kachi,M,1,3327535,30828
30324,Kachimsideya,M,1,3327536,30110
30325,Kachiside,M,1,3327537,30610
30326,Kadijah,F,1,3327538,30695
30327,Kaedie,F,1,3327539,30642
30328,Kaelenn,M,1,3327540,30014
30329,Kaelo,M,1,3327541,30189
30330,Kailum,M,1,3327542,30843
30331,Kaireen,F,1,3327543,30564
30332,Kairn,M,1,3327544,30743
30333,Kairney,M,1,3327545,30804
30334,Kaisy,F,1,3327546,30152
30335,Kaiyra,F,1,3327547,30400
30336,Kajetan,M,1,3327548,30882
30337,Kajol,F,1,3327549,30975
30338,Kalabe,M,1,3327550,30758
30339,Kaleela,F,1,3327551,30851
30340,Kalleb,M,1,3327552,30613
30341,Kaloyan,M,1,3327553,30929
30342,Kambel,M,1,3327554,30668
30343,Kambell,M,1,3327555,30562
30344,Kamharida,F,1,3327556,30221
30345,Kamsi,M,1,3327557,30233
30346,Kamsiy,M,1,3327558,30053
30347,Karaleigh,F,1,3327559,30004
30348,Karamo,M,1,3327560,30598
30349,Karar,M,1,3327561,30870
30350,Karessa,F,1,3327562,30665
30351,Karlii,F,1,3327563,30889
30352,Karlyle,M,1,3327564,30971
30353,Karsyon,M,1,3327565,30350
30354,Kashiny,F,1,3327566,30877
30355,Kasparas,M,1,3327567,30648
30356,Kaspars,M,1,3327568,30752
30357,Katalin,F,1,3327569,30940
30358,Katarzyna,F,1,3327570,30838
30359,Katieanne,F,1,3327571,30246
30360,Kavinila,F,1,3327572,30534
30361,Kaylaa,F,1,3327573,30092
30362,Keaten,M,1,3327574,30035
30363,Keavah,F,1,3327575,30271
30364,Keavy,F,1,3327576,30672
30365,Keesha,F,1,3327577,30243
30366,Keevagh,F,1,3327578,30727
30367,Keevan,M,1,3327579,30898
30368,Keeyano,M,1,3327580,30270
30369,Keiano,M,1,3327581,30621
30370,Keighana,F,1,3327582,30814
30371,Keillor,M,1,3327583,30945
30372,Keirney,M,1,3327584,30381
30373,Keisara,F,1,3327585,30007
30374,Keitija,F,1,3327586,30753
30375,Kell,M,1,3327587,30722
30376,Kellaine,F,1,3327588,30399
30377,Kelsa,F,1,3327589,30161
30378,Kenaya,F,1,3327590,30559
30379,Kennagh,F,1,3327591,30307
30380,Kennedymarie,F,1,3327592,30850
30381,Kenniday,F,1,3327593,30748
30382,Kennor,M,1,3327594,30886
30383,Keqiang,M,1,3327595,30063
30384,Kergan,M,1,3327596,30764
30385,Kerhys,F,1,3327597,30923
30386,Kerica,F,1,3327598,30523
30387,Kerin,F,1,3327599,30790
30388,Kerindu,F,1,3327600,30883
30389,Kerren,F,1,3327601,30473
30390,Kerrera,F,1,3327602,30747
30391,Kerris,F,1,3327603,30901
30392,Kerryn,F,1,3327604,30112
30393,Kesson,M,1,3327605,30339
30394,Kester,M,1,3327606,30242
30395,Keylah,F,1,3327607,30404
30396,Khairan,M,1,3327608,30316
30397,Khalari,M,1,3327609,30569
30398,Khalessia,F,1,3327610,30539
30399,Khandice,F,1,3327611,30384
30400,Khason,M,1,3327612,30900
30401,Kheenan,M,1,3327613,30274
30402,Khizr,M,1,3327614,30976
30403,Kholbie,M,1,3327615,30378
30404,Kholsen,M,1,3327616,30527
30405,Khorie,M,1,3327617,30133
30406,Khumbo,M,1,3327618,30372
30407,Kiaraa,F,1,3327619,30402
30408,Kiaren,M,1,3327620,30144
30409,Kiellan,M,1,3327621,30932
30410,Kierney,M,1,3327622,30419
30411,Kieva,F,1,3327623,30396
30412,Kievah,F,1,3327624,30729
30413,Kiira,F,1,3327625,30791
30414,Kimonas,M,1,3327626,30481
30415,Kinga,F,1,3327627,30801
30416,Kirstie,F,1,3327628,30937
30417,Kiryn,F,1,3327629,30895
30418,Kitti,F,1,3327630,30477
30419,Klaidas,M,1,3327631,30890
30420,Kleon,M,1,3327632,30406
30421,Koala,F,1,3327633,30417
30422,Koban,M,1,3327634,30293
30423,Koedyn,F,1,3327635,30880
30424,Kohan,M,1,3327636,30756
30425,Kohinoor,F,1,3327637,30297
30426,Kolbeinn,M,1,3327638,30779
30427,Kolben,M,1,3327639,30443
30428,Kolbey,M,1,3327640,30280
30429,Koldo,M,1,3327641,30633
30430,Komal,F,1,3327642,30484
30431,Konall,M,1,3327643,30757
30432,Konlan,M,1,3327644,30928
30433,Koray,M,1,3327645,30862
30434,Kore,F,1,3327646,30624
30435,Koshan,M,1,3327647,30106
30436,Kosimeya,F,1,3327648,30480
30437,Kosten,M,1,3327649,30036
30438,Kouper,M,1,3327650,30549
30439,Kovin,M,1,3327651,30488
30440,Koyar,M,1,3327652,30789
30441,Krishnan,M,1,3327653,30864
30442,Krissi,F,1,3327654,30275
30443,Krissie,F,1,3327655,30611
30444,Kristiano,M,1,3327656,30782
30445,Krsna,F,1,3327657,30199
30446,Kruiz,M,1,3327658,30299
30447,Krystof,M,1,3327659,30336
30448,Krystyna,F,1,3327660,30467
30449,Krzysztof,M,1,3327661,30363
30450,Ksawier,M,1,3327662,30907
30451,Kshitij,M,1,3327663,30868
30452,Kucha,M,1,3327664,30312
30453,Kumba,F,1,3327665,30102
30454,Kushum,F,1,3327666,30693
30455,Kyannah,F,1,3327667,30805
30456,Kyarran,M,1,3327668,30016
30457,Kyfer,M,1,3327669,30257
30458,Kyrann,M,1,3327670,30300
30459,Laaibah,F,1,3327671,30516
30460,Laceyjay,F,1,3327672,30957
30461,Lachlainn,M,1,3327673,30041
30462,Lafiza,F,1,3327674,30236
30463,Lagrace,F,1,3327675,30114
30464,Laic,M,1,3327676,30262
30465,Laich,M,1,3327677,30700
30466,Laighla,F,1,3327678,30506
30467,Laire,F,1,3327679,30173
30468,Lairig,M,1,3327680,30027
30469,Laissa,F,1,3327681,30413
30470,Lakain,M,1,3327682,30533
30471,Lakeshia,F,1,3327683,30218
30472,Langa,F,1,3327684,30235
30473,Lannah,F,1,3327685,30266
30474,Laowy,M,1,3327686,30393
30475,Larcyn,M,1,3327687,30323
30476,Larsson,M,1,3327688,30657
30477,Latiesha,F,1,3327689,30151
30478,Lauchie,M,1,3327690,30531
30479,Lauchryn,M,1,3327691,30314
30480,Laucklan,M,1,3327692,30912
30481,Laughlin,M,1,3327693,30649
30482,Lavand,M,1,3327694,30666
30483,Lavinya,F,1,3327695,30993
30484,Lawe,M,1,3327696,30581
30485,Lawi,M,1,3327697,30469
30486,Lawri,F,1,3327698,30536
30487,Lawrie,M,1,3327699,30961
30488,Layelwe,M,1,3327700,30933
30489,Laylan,M,1,3327701,30183
30490,Laylind,M,1,3327702,30572
30491,Laytin,M,1,3327703,30947
30492,Learose,F,1,3327704,30125
30493,Leelaas,F,1,3327705,30383
30494,Leese,M,1,3327706,30366
30495,Leicester,M,1,3327707,30311
30496,Leithan,M,1,3327708,30077
30497,Lelle,F,1,3327709,30265
30498,Leodhais,M,1,3327710,30052
30499,Leonhard,M,1,3327711,30284
30500,Leoura,F,1,3327712,30555
30501,Letitia,F,1,3327713,30169
30502,Levison,M,1,3327714,30197
30503,Levko,M,1,3327715,30452
30504,Lewy,M,1,3327716,30962
30505,Leyghlynne,F,1,3327717,30925
30506,Leytyn,M,1,3327718,30591
30507,Libai,M,1,3327719,30590
30508,Liepa,F,1,3327720,30827
30509,Lilanya,F,1,3327721,30660
30510,Lilias,F,1,3327722,30982
30511,Lini,F,1,3327723,30510
30512,Lisle,F,1,3327724,30240
30513,Lithgow,M,1,3327725,30412
30514,Liyle,F,1,3327726,30371
30515,Llana,F,1,3327727,30475
30516,Llewen,M,1,3327728,30597
30517,Lochiel,M,1,3327729,30875
30518,Lochleia,F,1,3327730,30823
30519,Lochy,M,1,3327731,30490
30520,Lokki,M,1,3327732,30433
30521,Lonikaanshi,F,1,3327733,30095
30522,Loreta,F,1,3327734,30750
30523,Lotta,F,1,3327735,30594
30524,Louan,M,1,3327736,30991
30525,Loucas,M,1,3327737,30334
30526,Loucia,F,1,3327738,30636
30527,Loughlin,M,1,3327739,30580
30528,Lowe,F,1,3327740,30158
30529,Lowenna,F,1,3327741,30718
30530,Lowri,F,1,3327742,30921
30531,Lowrie,M,1,3327743,30755
30532,Lteen,F,1,3327744,30079
30533,Luai,M,1,3327745,30291
30534,Lucella,F,1,3327746,30996
30535,Lucianah,F,1,3327747,30768
30536,Lucianne,F,1,3327748,30421
30537,Ludo,M,1,3327749,30429
30538,Lukne,F,1,3327750,30131
30539,Lukuz,M,1,3327751,30905
30540,Lulaa,F,1,3327752,30495
30541,Luule,F,1,3327753,30193
30542,Luyi,F,1,3327754,30453
30543,Lybbie,F,1,3327755,30535
30544,Lylle,M,1,3327756,30067
30545,Lytton,M,1,3327757,30203
30546,Maanvik,M,1,3327758,30955
30547,Mabroor,M,1,3327759,30575
30548,Macauley,M,1,3327760,30965
30549,Machair,M,1,3327761,30368
30550,Machrie,M,1,3327762,30762
30551,Maciej,M,1,3327763,30220
30552,Maevi,F,1,3327764,30924
30553,Maeya,F,1,3327765,30058
30554,Mafalda,F,1,3327766,30566
30555,Magaidh,F,1,3327767,30626
30556,Mahadi,M,1,3327768,30229
30557,Mahita,F,1,3327769,30987
30558,Mahran,M,1,3327770,30616
30559,Mahrous,M,1,3327771,30261
30560,Mahrukh,F,1,3327772,30048
30561,Mahya,F,1,3327773,30032
30562,Maiben,M,1,3327774,30155
30563,Maicen,M,1,3327775,30075
30564,Maidie,F,1,3327776,30910
30565,Maisri,F,1,3327777,30546
30566,Maiwen,F,1,3327778,30570
30567,Maiziey,F,1,3327779,30793
30568,Majka,F,1,3327780,30269
30569,Malaz,F,1,3327781,30154
30570,Malikah,F,1,3327782,30740
30571,Malliea,F,1,3327783,30309
30572,Mallon,M,1,3327784,30343
30573,Mamadi,M,1,3327785,30902
30574,Manaaki,M,1,3327786,30068
30575,Manalyaa,F,1,3327787,30683
30576,Manavi,F,1,3327788,30219
30577,Mandra,F,1,3327789,30305
30578,Mandrita,F,1,3327790,30165
30579,Maneet,M,1,3327791,30671
30580,Manesa,F,1,3327792,30084
30581,Manisa,F,1,3327793,30759
30582,Mankirt,M,1,3327794,30622
30583,Manolis,M,1,3327795,30277
30584,Mantasha,F,1,3327796,30239
30585,Manus,M,1,3327797,30694
30586,Marcas,M,1,3327798,30392
30587,Marcey,F,1,3327799,30198
30588,Marenne,F,1,3327800,30228
30589,Mariuss,M,1,3327801,30315
30590,Marjaan,F,1,3327802,30707
30591,Markas,M,1,3327803,30918
30592,Markuss,M,1,3327804,30663
30593,Marky,M,1,3327805,30894
30594,Maro,M,1,3327806,30522
30595,Marro,M,1,3327807,30037
30596,Marsaili,F,1,3327808,30746
30597,Marsie,F,1,3327809,30967
30598,Martynas,M,1,3327810,30867
30599,Maryjean,F,1,3327811,30042
30600,Masal,F,1,3327812,30286
30601,Mashal,F,1,3327813,30358
30602,Mashiyat,M,1,3327814,30909
30603,Masturah,F,1,3327815,30505
30604,Mathani,F,1,3327816,30015
30605,Maurycy,M,1,3327817,30499
30606,Mawin,M,1,3327818,30101
30607,Maxy,M,1,3327819,30097
30608,Mayameko,F,1,3327820,30903
30609,Mayasser,F,1,3327821,30601
30610,Maysha,F,1,3327822,30070
30611,Mbinomujame,F,1,3327823,30858
30612,Mcaulay,M,1,3327824,30873
30613,Mccauley,M,1,3327825,30389
30614,Meagh,F,1,3327826,30225
30615,Meerum,F,1,3327827,30337
30616,Meggan,F,1,3327828,30156
30617,Meggy,F,1,3327829,30439
30618,Megyn,F,1,3327830,30478
30619,Mehek,F,1,3327831,30913
30620,Meherima,F,1,3327832,30774
30621,Mehmood,M,1,3327833,30520
30622,Mehnoor,F,1,3327834,30374
30623,Mehraban,F,1,3327835,30237
30624,Meia,F,1,3327836,30401
30625,Meihla,F,1,3327837,30087
30626,Meithaq,F,1,3327838,30256
30627,Meja,F,1,3327839,30879
30628,Melda,F,1,3327840,30963
30629,Melkah,F,1,3327841,30174
30630,Mellissa,F,1,3327842,30596
30631,Menahil,F,1,3327843,30321
30632,Mercadiez,F,1,3327844,30135
30633,Merel,F,1,3327845,30812
30634,Meribelle,F,1,3327846,30574
30635,Meridah,F,1,3327847,30802
30636,Meusaidh,F,1,3327848,30765
30637,Mevillea,F,1,3327849,30620
30638,Mhari,F,1,3327850,30953
30639,Mhurrin,F,1,3327851,30414
30640,Mhylie,F,1,3327852,30485
30641,Miasy,F,1,3327853,30749
30642,Mieszko,M,1,3327854,30985
30643,Mihai,M,1,3327855,30423
30644,Mihri,F,1,3327856,30029
30645,Milaa,F,1,3327857,30717
30646,Milanox,M,1,3327858,30936
30647,Milanya,F,1,3327859,30418
30648,Mileja,F,1,3327860,30810
30649,Milita,F,1,3327861,30674
30650,Milkas,M,1,3327862,30212
30651,Milne,M,1,3327863,30205
30652,Milou,F,1,3327864,30003
30653,Minni,F,1,3327865,30958
30654,Minoosha,F,1,3327866,30602
30655,Miraaya,F,1,3327867,30356
30656,Miransh,M,1,3327868,30732
30657,Mirbey,M,1,3327869,30595
30658,Mirin,F,1,3327870,30447
30659,Mirrha,F,1,3327871,30248
30660,Mirrhyn,F,1,3327872,30540
30661,Mirrin,F,1,3327873,30519
30662,Miruna,F,1,3327874,30906
30663,Miryn,F,1,3327875,30644
30664,Missandei,F,1,3327876,30038
30665,Missi,F,1,3327877,30896
30666,Miylee,F,1,3327878,30736
30667,Mmesomachukwu,F,1,3327879,30163
30668,Moanah,F,1,3327880,30328
30669,Moeen,M,1,3327881,30054
30670,Mohkam,M,1,3327882,30542
30671,Moisa,M,1,3327883,30547
30672,Mokashfy,M,1,3327884,30738
30673,Monaco,F,1,3327885,30361
30674,Moncef,M,1,3327886,30170
30675,Moneera,F,1,3327887,30091
30676,Monira,F,1,3327888,30322
30677,Mopewafunjesu,M,1,3327889,30438
30678,Mori,F,1,3327890,30289
30679,Morwen,F,1,3327891,30250
30680,Moteribafoluwa,M,1,3327892,30558
30681,Motirioluwa,M,1,3327893,30855
30682,Motunrayo,F,1,3327894,30057
30683,Moze,M,1,3327895,30639
30684,Mpoi,F,1,3327896,30093
30685,Muayyad,M,1,3327897,30040
30686,Mudaser,M,1,3327898,30446
30687,Mudawi,M,1,3327899,30713
30688,Muen,F,1,3327900,30437
30689,Muhmmad,M,1,3327901,30450
30690,Muir,M,1,3327902,30508
30691,Muirinn,F,1,3327903,30769
30692,Mujiu,F,1,3327904,30461
30693,Muntasin,M,1,3327905,30775
30694,Muodebelu,M,1,3327906,30111
30695,Murael,F,1,3327907,30604
30696,Murrin,F,1,3327908,30603
30697,Murtagh,M,1,3327909,30543
30698,Murtii,M,1,3327910,30784
30699,Murtza,M,1,3327911,30988
30700,Mustabshira,F,1,3327912,30998
30701,Mylaa,F,1,3327913,30010
30702,Mylea,F,1,3327914,30238
30703,Myler,M,1,3327915,30612
30704,Myli,F,1,3327916,30946
30705,Myrren,F,1,3327917,30777
30706,Myrrin,F,1,3327918,30150
30707,Naelah,F,1,3327919,30283
30708,Naemie,F,1,3327920,30332
30709,Nafas,F,1,3327921,30979
30710,Nafil,M,1,3327922,30866
30711,Nairyn,F,1,3327923,30524
30712,Nakshatraa,F,1,3327924,30330
30713,Nakshthra,F,1,3327925,30956
30714,Namariq,F,1,3327926,30348
30715,Nancie,F,1,3327927,30561
30716,Naresi,M,1,3327928,30832
30717,Narin,F,1,3327929,30427
30718,Narmin,F,1,3327930,30290
30719,Nasmah,F,1,3327931,30899
30720,Natascha,F,1,3327932,30192
30721,Navpreet,F,1,3327933,30733
30722,Nayadie,F,1,3327934,30324
30723,Nazal,M,1,3327935,30565
30724,Neama,F,1,3327936,30159
30725,Neason,M,1,3327937,30069
30726,Neavan,M,1,3327938,30593
30727,Neelan,M,1,3327939,30329
30728,Neevah,F,1,3327940,30878
30729,Neeve,F,1,3327941,30304
30730,Nefelie,F,1,3327942,30422
30731,Neiva,F,1,3327943,30641
30732,Neivada,F,1,3327944,30550
30733,Nejla,F,1,3327945,30922
30734,Nelleh,F,1,3327946,30696
30735,Nelma,F,1,3327947,30341
30736,Nemi,F,1,3327948,30062
30737,Nenya,F,1,3327949,30691
30738,Nephelie,F,1,3327950,30122
30739,Nesma,F,1,3327951,30667
30740,Nesrine,F,1,3327952,30525
30741,Nevanah,F,1,3327953,30276
30742,Neyma,F,1,3327954,30935
30743,Ngajozikue,M,1,3327955,30466
30744,Niadh,F,1,3327956,30426
30745,Nial,M,1,3327957,30515
30746,Nicolaos,M,1,3327958,30628
30747,Nikhilan,M,1,3327959,30797
30748,Nilay,M,1,3327960,30073
30749,Nimah,F,1,3327961,30208
30750,Nimal,M,1,3327962,30160
30751,Nirbhana,F,1,3327963,30840
30752,Niri,F,1,3327964,30263
30753,Nithyasri,F,1,3327965,30391
30754,Nkosinathi,M,1,3327966,30223
30755,Nkwenti,M,1,3327967,30818
30756,Nmesomachi,M,1,3327968,30474
30757,Nneoma,F,1,3327969,30599
30758,Noh,M,1,3327970,30226
30759,Noi,M,1,3327971,30059
30760,Nojus,M,1,3327972,30576
30761,Nokubonga,F,1,3327973,30625
30762,Nollan,M,1,3327974,30039
30763,Noorya,F,1,3327975,30451
30764,Novara,F,1,3327976,30127
30765,Nowfil,M,1,3327977,30182
30766,Nuin,M,1,3327978,30142
30767,Nula,F,1,3327979,30459
30768,Nulah,F,1,3327980,30651
30769,Nuo,F,1,3327981,30973
30770,Nuoyao,F,1,3327982,30904
30771,Nurahan,M,1,3327983,30984
30772,Nurys,F,1,3327984,30863
30773,Nusyba,F,1,3327985,30728
30774,Nyan,M,1,3327986,30989
30775,Nye,M,1,3327987,30346
30776,Obianuri,F,1,3327988,30557
30777,Ode,F,1,3327989,30317
30778,Odysseas,M,1,3327990,30815
30779,Oghenetejiri,M,1,3327991,30146
30780,Ohlin,M,1,3327992,30201
30781,Ohmie,F,1,3327993,30821
30782,Oisean,M,1,3327994,30206
30783,Oktay,M,1,3327995,30137
30784,Oladele,M,1,3327996,30458
30785,Olaitan,M,1,3327997,30734
30786,Olaoluwakitan,M,1,3327998,30026
30787,Olav,M,1,3327999,30444
30788,Oleigh,M,1,3328000,30188
30789,Olek,M,1,3328001,30355
30790,Olisaemeka,M,1,3328002,30455
30791,Olivers,M,1,3328003,30195
30792,Olivija,F,1,3328004,30720
30793,Oliwa,F,1,3328005,30788
30794,Oliwer,M,1,3328006,30915
30795,Olubusayo,F,1,3328007,30134
30796,Oluwadurotimi,M,1,3328008,30310
30797,Oluwakorede,M,1,3328009,30754
30798,Oluwalonimi,F,1,3328010,30553
30799,Onosemudiana,M,1,3328011,30684
30800,Ooliana,F,1,3328012,30470
30801,Oreofe,F,1,3328013,30712
30802,Oreoluwakitan,M,1,3328014,30491
30803,Oreon,M,1,3328015,30164
30804,Orevaoghene,M,1,3328016,30325
30805,Oriol,M,1,3328017,30424
30806,Orlah,F,1,3328018,30463
30807,Orlarose,F,1,3328019,30403
30808,Orlyn,F,1,3328020,30445
30809,Oroghene,M,1,3328021,30656
30810,Orryn,M,1,3328022,30706
30811,Osagumwenro,F,1,3328023,30124
30812,Osamuetiyan,F,1,3328024,30085
30813,Osaretin,M,1,3328025,30107
30814,Osarumwese,M,1,3328026,30498
30815,Osayimwese,M,1,3328027,30023
30816,Oseann,F,1,3328028,30659
30817,Oseremen,M,1,3328029,30811
30818,Oshan,M,1,3328030,30841
30819,Oslin,F,1,3328031,30462
30820,Osose,F,1,3328032,30370
30821,Otter,M,1,3328033,30476
30822,Ouzmaan,M,1,3328034,30786
30823,Ozzi,M,1,3328035,30938
30824,Paagulan,M,1,3328036,30227
30825,Paddy,M,1,3328037,30735
30826,Padruig,M,1,3328038,30440
30827,Paeslhi,F,1,3328039,30375
30828,Paidi,M,1,3328040,30997
30829,Palmas,M,1,3328041,30031
30830,Parkash,M,1,3328042,30820
30831,Parla,F,1,3328043,30153
30832,Partapdeep,M,1,3328044,30783
30833,Pashmak,F,1,3328045,30313
30834,Patrik,M,1,3328046,30512
30835,Patrycja,F,1,3328047,30006
30836,Pauljohn,M,1,3328048,30698
30837,Pei,F,1,3328049,30138
30838,Peigi,F,1,3328050,30837
30839,Penney,F,1,3328051,30848
30840,Perran,M,1,3328052,30353
30841,Peru,M,1,3328053,30949
30842,Petrovich,M,1,3328054,30012
30843,Phenomenal,M,1,3328055,30854
30844,Pichapak,F,1,3328056,30948
30845,Pinar,F,1,3328057,30186
30846,Pirro,M,1,3328058,30876
30847,Pixi,F,1,3328059,30254
30848,Pollie,F,1,3328060,30148
30849,Pompeyo,M,1,3328061,30464
30850,Praiselyn,F,1,3328062,30990
30851,Prasant,M,1,3328063,30799
30852,Prashika,F,1,3328064,30710
30853,Preben,M,1,3328065,30115
30854,Prinze,M,1,3328066,30213
30855,Pritam,M,1,3328067,30526
30856,Puscas,F,1,3328068,30056
30857,Qaria,F,1,3328069,30166
30858,Qasem,M,1,3328070,30857
30859,Quaintrelle,F,1,3328071,30538
30860,Raafat,M,1,3328072,30252
30861,Raameen,F,1,3328073,30842
30862,Rabie,M,1,3328074,30888
30863,Rachele,F,1,3328075,30109
30864,Rada,F,1,3328076,30294
30865,Radost,F,1,3328077,30816
30866,Raefe,M,1,3328078,30969
30867,Rafee,M,1,3328079,30211
30868,Raffy,M,1,3328080,30486
30869,Rafida,F,1,3328081,30692
30870,Ragamegan,M,1,3328082,30501
30871,Rahf,F,1,3328083,30847
30872,Rahiz,M,1,3328084,30099
30873,Rahya,F,1,3328085,30714
30874,Raigardas,M,1,3328086,30272
30875,Raighan,F,1,3328087,30608
30876,Raith,M,1,3328088,30682
30877,Rajeeyah,F,1,3328089,30132
30878,Rakhshan,F,1,3328090,30785
30879,Ralia,F,1,3328091,30064
30880,Rameigh,F,1,3328092,30338
30881,Ranulf,M,1,3328093,30320
30882,Raphipasara,F,1,3328094,30279
30883,Rares,M,1,3328095,30521
30884,Raseem,M,1,3328096,30267
30885,Rashi,F,1,3328097,30578
30886,Ratu,M,1,3328098,30687
30887,Raviv,F,1,3328099,30800
30888,Rawad,M,1,3328100,30190
30889,Rebekkah,F,1,3328101,30983
30890,Redgie,M,1,3328102,30778
30891,Reel,F,1,3328103,30049
30892,Reevan,M,1,3328104,30655
30893,Reevi,F,1,3328105,30638
30894,Regann,M,1,3328106,30177
30895,Reigha,F,1,3328107,30504
30896,Reigyn,F,1,3328108,30285
30897,Reilie,M,1,3328109,30679
30898,Reimi,F,1,3328110,30514
30899,Reme,F,1,3328111,30530
30900,Remedios,F,1,3328112,30013
30901,Renars,M,1,3328113,30187
30902,Renith,M,1,3328114,30554
30903,Renz,M,1,3328115,30972
30904,Rereloluwa,F,1,3328116,30083
30905,Reyanshdeep,M,1,3328117,30511
30906,Reyanshi,F,1,3328118,30351
30907,Rezgallah,M,1,3328119,30216
30908,Rhaea,F,1,3328120,30331
30909,Rhaia,F,1,3328121,30654
30910,Rheava,F,1,3328122,30835
30911,Rhianne,F,1,3328123,30742
30912,Rhion,M,1,3328124,30482
30913,Rhiver,M,1,3328125,30528
30914,Rhiyash,M,1,3328126,30503
30915,Rho,F,1,3328127,30771
30916,Rhoddy,M,1,3328128,30382
30917,Rhuairidh,M,1,3328129,30673
30918,Rhuan,M,1,3328130,30780
30919,Rhuari,M,1,3328131,30635
30920,Rhuaridh,M,1,3328132,30980
30921,Rhubeigh,F,1,3328133,30715
30922,Rhuben,M,1,3328134,30885
30923,Rhuby,F,1,3328135,30024
30924,Rhuna,F,1,3328136,30117
30925,Rhuraigh,M,1,3328137,30255
30926,Rhuri,M,1,3328138,30917
30927,Riagan,M,1,3328139,30662
30928,Riami,F,1,3328140,30306
30929,Riario,M,1,3328141,30326
30930,Ribh,F,1,3328142,30646
30931,Ridazehra,F,1,3328143,30859
30932,Rievah,F,1,3328144,30096
30933,Rieve,F,1,3328145,30992
30934,Riia,F,1,3328146,30202
30935,Riminozu,M,1,3328147,30643
30936,Rinas,F,1,3328148,30465
30937,Riou,M,1,3328149,30018
30938,Ritan,F,1,3328150,30120
30939,Rivaansh,M,1,3328151,30019
30940,Rivana,F,1,3328152,30737
30941,Rivian,F,1,3328153,30702
30942,Riyaa,F,1,3328154,30301
30943,Roabie,M,1,3328155,30631
30944,Roag,M,1,3328156,30994
30945,Roahdee,M,1,3328157,30258
30946,Robsan,M,1,3328158,30609
30947,Rocci,M,1,3328159,30942
30948,Rodaidh,M,1,3328160,30415
30949,Roddie,M,1,3328161,30176
30950,Rodrian,M,1,3328162,30168
30951,Roghan,M,1,3328163,30043
30952,Rohaise,F,1,3328164,30051
30953,Roise,F,1,3328165,30365
30954,Rojus,M,1,3328166,30493
30955,Rokka,M,1,3328167,30191
30956,Rokko,M,1,3328168,30725
30957,Roksana,F,1,3328169,30072
30958,Romanie,F,1,3328170,30686
30959,Romano,M,1,3328171,30398
30960,Romany,F,1,3328172,30390
30961,Romay,F,1,3328173,30409
30962,Romeao,M,1,3328174,30345
30963,Romeesa,F,1,3328175,30210
30964,Roneet,M,1,3328176,30874
30965,Ronnin,M,1,3328177,30244
30966,Rora,F,1,3328178,30614
30967,Rossana,F,1,3328179,30030
30968,Rostas,M,1,3328180,30292
30969,Roula,F,1,3328181,30919
30970,Rowanne,F,1,3328182,30745
30971,Rox,M,1,3328183,30926
30972,Rozali,F,1,3328184,30776
30973,Rroshi,F,1,3328185,30607
30974,Ruadh,F,1,3328186,30259
30975,Ruadhagain,M,1,3328187,30000
30976,Ruadhan,M,1,3328188,30548
30977,Ruairy,M,1,3328189,30911
30978,Ruban,M,1,3328190,30852
30979,Rufayah,F,1,3328191,30806
30980,Rufta,F,1,3328192,30441
30981,Rukai,M,1,3328193,30360
30982,Rukayya,F,1,3328194,30149
30983,Rukyah,F,1,3328195,30408
30984,Ruo,F,1,3328196,30808
30985,Rurie,M,1,3328197,30386
30986,Rusanda,F,1,3328198,30045
30987,Ruvarashe,F,1,3328199,30560
30988,Ruxa,F,1,3328200,30104
30989,Ruzenka,F,1,3328201,30025
30990,Ryeah,F,1,3328202,30489
30991,Ryia,F,1,3328203,30234
30992,Ryiellie,F,1,3328204,30342
30993,Rytel,F,1,3328205,30080
30994,Saahas,M,1,3328206,30468
30995,Sabawoon,M,1,3328207,30349
30996,Saboor,F,1,3328208,30618
30997,Sachal,M,1,3328209,30629
30998,Sadros,M,1,3328210,30914
30999,Saeeda,F,1,3328211,30050
31000,Safaara,F,1,3328212,31200
31001,Safet,M,1,3328213,31209
31002,Safoora,F,1,3328214,31321
31003,Saihan,M,1,3328215,31017
31004,Saishankar,M,1,3328216,31075
31005,Saji,M,1,3328217,31230
31006,Sali,F,1,3328218,31055
31007,Salomea,F,1,3328219,31221
31008,Salsibeel,F,1,3328220,31211
31009,Salvation,M,1,3328221,31097
31010,Samandra,F,1,3328222,31153
31011,Samanjeet,M,1,3328223,31283
31012,Sambor,M,1,3328224,31042
31013,Samik,M,1,3328225,31036
31014,Samiul,M,1,3328226,31308
31015,Samuil,M,1,3328227,31172
31016,Sancho,M,1,3328228,31167
31017,Sandi,F,1,3328229,31171
31018,Sandie,F,1,3328230,31058
31019,Sangvika,F,1,3328231,31199
31020,Sansar,M,1,3328232,31241
31021,Sanvith,M,1,3328233,31253
31022,Sanziana,F,1,3328234,31309
31023,Saorlaith,F,1,3328235,31116
31024,Saorsa,F,1,3328236,31125
31025,Saphria,F,1,3328237,31054
31026,Sarja,M,1,3328238,31034
31027,Sarlyn,F,1,3328239,31261
31028,Sarok,M,1,3328240,31187
31029,Sashreya,F,1,3328241,31088
31030,Saule,F,1,3328242,31112
31031,Sauravi,F,1,3328243,31229
31032,Savanha,F,1,3328244,31257
31033,Savariah,F,1,3328245,31219
31034,Sawaab,M,1,3328246,31323
31035,Sayfullah,M,1,3328247,31096
31036,Sayhan,M,1,3328248,31030
31037,Scheherazade,F,1,3328249,31115
31038,Scierra,F,1,3328250,31210
31039,Scirocco,M,1,3328251,31232
31040,Scotia,F,1,3328252,31331
31041,Segni,M,1,3328253,31132
31042,Sehajleen,F,1,3328254,31315
31043,Sehej,M,1,3328255,31037
31044,Sehejveer,M,1,3328256,31184
31045,Sejalpreet,F,1,3328257,31149
31046,Selbie,M,1,3328258,31207
31047,Semion,M,1,3328259,31190
31048,Senimili,F,1,3328260,31223
31049,Serafim,M,1,3328261,31297
31050,Serennah,F,1,3328262,31269
31051,Serien,F,1,3328263,31296
31052,Sevuloni,M,1,3328264,31051
31053,Sewa,F,1,3328265,31117
31054,Seyed,M,1,3328266,31185
31055,Shahnaz,F,1,3328267,31243
31056,Shahroz,M,1,3328268,31198
31057,Shaine,M,1,3328269,31280
31058,Shakil,M,1,3328270,31196
31059,Shakran,F,1,3328271,31222
31060,Shalahuddin,M,1,3328272,31275
31061,Shalana,F,1,3328273,31060
31062,Shanda,F,1,3328274,31300
31063,Sharik,M,1,3328275,31064
31064,Sharron,F,1,3328276,31307
31065,Shashvinth,M,1,3328277,31138
31066,Shauni,F,1,3328278,31197
31067,Sheehanah,F,1,3328279,31003
31068,Shehnoor,F,1,3328280,31031
31069,Shehran,M,1,3328281,31217
31070,Shehzal,F,1,3328282,31182
31071,Shenouda,M,1,3328283,31324
31072,Sherab,M,1,3328284,31091
31073,Sheralee,F,1,3328285,31008
31074,Shevonne,F,1,3328286,31076
31075,Sheyi,M,1,3328287,31135
31076,Shi,M,1,3328288,31246
31077,Shihan,F,1,3328289,31000
31078,Shinjini,F,1,3328290,31028
31079,Sholto,M,1,3328291,31286
31080,Shouptik,M,1,3328292,31056
31081,Shuchi,F,1,3328293,31320
31082,Shug,M,1,3328294,31027
31083,Shujah,M,1,3328295,31228
31084,Shuo,M,1,3328296,31284
31085,Shuxin,F,1,3328297,31126
31086,Shuyao,F,1,3328298,31203
31087,Shzanaya,F,1,3328299,31305
31088,Siannan,F,1,3328300,31326
31089,Siarra,F,1,3328301,31208
31090,Siddhika,F,1,3328302,31046
31091,Sigi,F,1,3328303,31156
31092,Silisitino,M,1,3328304,31303
31093,Simko,M,1,3328305,31318
31094,Siomha,F,1,3328306,31016
31095,Siyamthanda,M,1,3328307,31144
31096,Skandan,M,1,3328308,31081
31097,Skhyler,F,1,3328309,31118
31098,Skiellah,F,1,3328310,31220
31099,Skyelyr,F,1,3328311,31164
31100,Smira,F,1,3328312,31106
31101,Sofiyah,F,1,3328313,31079
31102,Solfrid,F,1,3328314,31082
31103,Somow,F,1,3328315,31043
31104,Sophocles,M,1,3328316,31173
31105,Sophronia,F,1,3328317,31304
31106,Sophyia,F,1,3328318,31192
31107,Sorrel,F,1,3328319,31077
31108,Soterios,M,1,3328320,31213
31109,Sourya,M,1,3328321,31294
31110,Srafiel,M,1,3328322,31268
31111,Sreya,F,1,3328323,31278
31112,Stavriani,F,1,3328324,31044
31113,Stephie,F,1,3328325,31168
31114,Stevee,F,1,3328326,31302
31115,Stevey,F,1,3328327,31301
31116,Stijn,M,1,3328328,31087
31117,Strath,M,1,3328329,31292
31118,Suhansh,M,1,3328330,31225
31119,Sujana,F,1,3328331,31007
31120,Sukhbir,M,1,3328332,31099
31121,Sukhraj,M,1,3328333,31236
31122,Sukhroop,M,1,3328334,31083
31123,Sula,F,1,3328335,31245
31124,Sullee,M,1,3328336,31270
31125,Sumeyra,F,1,3328337,31142
31126,Summayah,F,1,3328338,31274
31127,Sumya,F,1,3328339,31162
31128,Sunaiya,F,1,3328340,31205
31129,Sunari,F,1,3328341,31193
31130,Suyao,F,1,3328342,31183
31131,Swami,F,1,3328343,31271
31132,Swanik,M,1,3328344,31334
31133,Swastik,M,1,3328345,31247
31134,Swastima,F,1,3328346,31262
31135,Swift,M,1,3328347,31256
31136,Szaffi,F,1,3328348,31240
31137,Szilas,M,1,3328349,31316
31138,Szymek,M,1,3328350,31062
31139,Taaylr,M,1,3328351,31287
31140,Taayton,M,1,3328352,31012
31141,Tabita,F,1,3328353,31282
31142,Tacko,F,1,3328354,31161
31143,Tafawul,F,1,3328355,31265
31144,Tafseera,F,1,3328356,31080
31145,Taij,M,1,3328357,31026
31146,Tajus,M,1,3328358,31085
31147,Takunda,M,1,3328359,31325
31148,Talla,F,1,3328360,31131
31149,Tallien,F,1,3328361,31123
31150,Taman,F,1,3328362,31175
31151,Tamando,M,1,3328363,31048
31152,Tamaratena,M,1,3328364,31070
31153,Tamekia,F,1,3328365,31214
31154,Tanvitha,F,1,3328366,31139
31155,Tanyaradzwa,F,1,3328367,31113
31156,Taotao,M,1,3328368,31018
31157,Tarka,M,1,3328369,31159
31158,Tarran,M,1,3328370,31267
31159,Tasbih,F,1,3328371,31189
31160,Taskil,M,1,3328372,31148
31161,Tayim,M,1,3328373,31281
31162,Tefta,F,1,3328374,31095
31163,Tehreem,F,1,3328375,31333
31164,Teja,M,1,3328376,31061
31165,Telfer,M,1,3328377,31136
31166,Temiyato,F,1,3328378,31288
31167,Temujin,M,1,3328379,31133
31168,Terezia,F,1,3328380,31151
31169,Tesh,M,1,3328381,31006
31170,Thaleia,F,1,3328382,31216
31171,Thalissi,F,1,3328383,31010
31172,Thanapat,M,1,3328384,31063
31173,Thanasis,M,1,3328385,31114
31174,Thando,M,1,3328386,31335
31175,Tharunika,F,1,3328387,31066
31176,Theano,F,1,3328388,31032
31177,Theodric,M,1,3328389,31094
31178,Thilo,M,1,3328390,31314
31179,Thiral,M,1,3328391,31328
31180,Thistle,F,1,3328392,31152
31181,Tholokuhle,F,1,3328393,31040
31182,Thoriq,M,1,3328394,31227
31183,Tianming,M,1,3328395,31020
31184,Tieanna,F,1,3328396,31009
31185,Tieryne,M,1,3328397,31092
31186,Tiffiny,F,1,3328398,31130
31187,Tilvy,F,1,3328399,31299
31188,Tily,F,1,3328400,31329
31189,Timea,F,1,3328401,31025
31190,Timmothy,M,1,3328402,31264
31191,Timurs,M,1,3328403,31078
31192,Tinashe,M,1,3328404,31013
31193,Tobiasz,M,1,3328405,31047
31194,Tobius,M,1,3328406,31021
31195,Todor,M,1,3328407,31186
31196,Tomany,F,1,3328408,31272
31197,Tomaz,M,1,3328409,31250
31198,Tommylee,M,1,3328410,31255
31199,Tomos,M,1,3328411,31110
31200,Tomy,M,1,3328412,31170
31201,Tootsie,F,1,3328413,31254
31202,Torcuil,M,1,3328414,31119
31203,Torkel,M,1,3328415,31069
31204,Toros,M,1,3328416,31327
31205,Toumast,F,1,3328417,31089
31206,Toviel,M,1,3328418,31005
31207,Traolach,M,1,3328419,31258
31208,Trihaan,M,1,3328420,31165
31209,Trim,M,1,3328421,31317
31210,Triman,M,1,3328422,31102
31211,Trump,M,1,3328423,31071
31212,Tsabeena,F,1,3328424,31049
31213,Tsegezeab,M,1,3328425,31259
31214,Tsering,M,1,3328426,31073
31215,Tudor,M,1,3328427,31310
31216,Twaritha,F,1,3328428,31239
31217,Tyga,F,1,3328429,31188
31218,Tzanis,M,1,3328430,31141
31219,Udhay,M,1,3328431,31033
31220,Uendjipa,F,1,3328432,31330
31221,Uendjiundja,M,1,3328433,31100
31222,Ugochi,F,1,3328434,31238
31223,Uilleam,M,1,3328435,31146
31224,Ukashah,M,1,3328436,31107
31225,Ulrike,F,1,3328437,31015
31226,Ulya,F,1,3328438,31105
31227,Umama,F,1,3328439,31206
31228,Umamah,F,1,3328440,31277
31229,Umayyah,F,1,3328441,31120
31230,Upe,F,1,3328442,31224
31231,Uther,M,1,3328443,31169
31232,Utjiuomuni,F,1,3328444,31128
31233,Vaclav,M,1,3328445,31059
31234,Vajk,M,1,3328446,31319
31235,Valdis,M,1,3328447,31336
31236,Valenchia,F,1,3328448,31158
31237,Vanda,F,1,3328449,31231
31238,Vasilis,M,1,3328450,31145
31239,Vaticana,F,1,3328451,31248
31240,Venomukona,M,1,3328452,31001
31241,Vhari,F,1,3328453,31279
31242,Vhea,F,1,3328454,31134
31243,Vikashini,F,1,3328455,31313
31244,Viktorija,F,1,3328456,31201
31245,Vilius,M,1,3328457,31311
31246,Vincentas,M,1,3328458,31337
31247,Visaghan,M,1,3328459,31215
31248,Vishva,M,1,3328460,31035
31249,Vishwam,M,1,3328461,31293
31250,Vogue,F,1,3328462,31289
31251,Wafa,F,1,3328463,31121
31252,Waheed,M,1,3328464,31143
31253,Waianiwa,F,1,3328465,31090
31254,Wajeeha,F,1,3328466,31104
31255,Wareesha,F,1,3328467,31194
31256,Warisha,F,1,3328468,31004
31257,Wayu,M,1,3328469,31065
31258,Weaam,F,1,3328470,31155
31259,Wei,M,1,3328471,31226
31260,Whynter,F,1,3328472,31057
31261,Willum,M,1,3328473,31180
31262,Wilow,F,1,3328474,31312
31263,Wimut,M,1,3328475,31011
31264,Wincent,M,1,3328476,31084
31265,Wish,F,1,3328477,31067
31266,Witold,M,1,3328478,31111
31267,Woodi,M,1,3328479,31109
31268,Wurrd,M,1,3328480,31176
31269,Xanthe,F,1,3328481,31202
31270,Xihan,F,1,3328482,31098
31271,Xinran,F,1,3328483,31140
31272,Xinze,M,1,3328484,31038
31273,Xiorra,F,1,3328485,31285
31274,Xubin,M,1,3328486,31108
31275,Yafi,M,1,3328487,31260
31276,Yagin,F,1,3328488,31086
31277,Yaldz,F,1,3328489,31129
31278,Yanes,M,1,3328490,31233
31279,Yaried,M,1,3328491,31093
31280,Yarra,F,1,3328492,31218
31281,Yashvin,F,1,3328493,31002
31282,Yating,F,1,3328494,31295
31283,Yatong,F,1,3328495,31177
31284,Yazdan,M,1,3328496,31068
31285,Yazin,M,1,3328497,31181
31286,Yedhesshwaran,M,1,3328498,31023
31287,Yeirah,F,1,3328499,31266
31288,Yogashree,F,1,3328500,31053
31289,Yoshan,M,1,3328501,31276
31290,Yosheya,M,1,3328502,31252
31291,Yossarian,M,1,3328503,31050
31292,Younouss,M,1,3328504,31234
31293,Yozge,F,1,3328505,31166
31294,Yule,M,1,3328506,31191
31295,Yunjia,F,1,3328507,31127
31296,Yusof,M,1,3328508,31251
31297,Yuzarsif,M,1,3328509,31273
31298,Zaak,M,1,3328510,31029
31299,Zaayan,M,1,3328511,31014
31300,Zabeen,F,1,3328512,31235
31301,Zaceo,M,1,3328513,31024
31302,Zacharii,M,1,3328514,31178
31303,Zacrhyn,M,1,3328515,31298
31304,Zahi,M,1,3328516,31039
31305,Zainulabedeen,M,1,3328517,31154
31306,Zalvadorro,M,1,3328518,31291
31307,Zamima,F,1,3328519,31212
31308,Zaraleigh,F,1,3328520,31045
31309,Zario,M,1,3328521,31306
31310,Zave,M,1,3328522,31179
31311,Zayanah,F,1,3328523,31163
31312,Zaydaan,M,1,3328524,31041
31313,Ze,M,1,3328525,31101
31314,Zebicus,M,1,3328526,31074
31315,Zeeanna,F,1,3328527,31160
31316,Zhaorong,F,1,3328528,31072
31317,Zhe,M,1,3328529,31290
31318,Zhilin,M,1,3328530,31103
31319,Zhour,F,1,3328531,31019
31320,Zi,F,1,3328532,31195
31321,Zico,M,1,3328533,31150
31322,Zilan,F,1,3328534,31332
31323,Zimaal,F,1,3328535,31204
31324,Zimifekachukwu,F,1,3328536,31052
31325,Zinnar,F,1,3328537,31249
31326,Ziqing,F,1,3328538,31237
31327,Zlatin,M,1,3328539,31122
31328,Zobia,F,1,3328540,31147
31329,Zoeidh,F,1,3328541,31022
31330,Zografia,F,1,3328542,31242
31331,Zoja,F,1,3328543,31174
31332,Zonira,F,1,3328544,31157
31333,Zsombor,M,1,3328545,31322
31334,Zubiya,F,1,3328546,31124
31335,Zulqarnain,M,1,3328547,31137
31336,Zuzana,F,1,3328548,31263
31337,Zynnell,F,1,3328549,31244
